listing_id,total_bookings,total_duration,avg_duration,min_duration,max_duration,num_of_short_stays,num_of_long_stays
21853.0,33,48,1.4545454545454546,1,4,33,0
27262.0,29,144,4.9655172413793105,2,7,29,0
30320.0,172,360,2.0930232558139537,1,4,172,0
30959.0,8,12,1.5,1,3,8,0
33945.0,78,540,6.923076923076923,3,10,54,24
40916.0,49,107,2.183673469387755,1,5,49,0
49489.0,140,289,2.0642857142857145,1,5,140,0
60394.0,34,331,9.735294117647058,5,13,2,32
62423.0,227,1336,5.88546255506608,2,9,211,16
70059.0,61,409,6.704918032786885,2,9,46,15
70310.0,29,203,7.0,5,8,21,8
72150.0,126,246,1.9523809523809523,1,4,126,0
82481.0,105,197,1.8761904761904762,1,5,105,0
84719.0,184,1263,6.864130434782608,2,10,133,51
86042.0,222,645,2.9054054054054053,1,6,222,0
100411.0,3,5,1.6666666666666667,1,2,3,0
114854.0,183,1306,7.136612021857924,2,10,104,79
133835.0,27,189,7.0,4,9,18,9
134340.0,56,391,6.982142857142857,3,9,40,16
136058.0,97,193,1.9896907216494846,1,5,97,0
154243.0,215,1485,6.906976744186046,2,10,150,65
155654.0,65,448,6.892307692307693,4,9,42,23
163429.0,8,16,2.0,1,4,8,0
167183.0,45,391,8.688888888888888,3,11,5,40
196197.0,468,3170,6.773504273504273,2,10,332,136
198296.0,82,324,3.951219512195122,2,6,82,0
199016.0,58,445,7.672413793103448,2,10,23,35
199201.0,209,816,3.9043062200956937,1,7,209,0
204570.0,105,307,2.9238095238095236,1,5,105,0
205199.0,361,2839,7.864265927977839,2,11,124,237
211444.0,221,1935,8.755656108597286,2,12,24,197
221017.0,60,123,2.05,1,4,60,0
225489.0,30,46,1.5333333333333334,1,3,30,0
229664.0,553,3787,6.848101265822785,2,10,401,152
233011.0,73,512,7.013698630136986,4,9,45,28
256004.0,214,293,1.3691588785046729,1,4,214,0
258713.0,77,368,4.779220779220779,3,8,76,1
260951.0,142,559,3.936619718309859,1,6,142,0
261878.0,661,3286,4.97125567322239,2,8,656,5
263748.0,153,628,4.104575163398692,2,6,153,0
270611.0,46,313,6.804347826086956,2,9,34,12
270954.0,25,103,4.12,2,6,25,0
270973.0,31,145,4.67741935483871,2,6,31,0
272279.0,243,959,3.9465020576131686,1,7,243,0
280733.0,70,256,3.657142857142857,2,6,70,0
281224.0,136,276,2.0294117647058822,1,4,136,0
287660.0,11,16,1.4545454545454546,1,2,11,0
289555.0,191,275,1.4397905759162304,1,4,191,0
306234.0,690,3416,4.95072463768116,1,8,685,5
308157.0,2,14,7.0,5,9,1,1
310333.0,181,1541,8.513812154696133,2,11,28,153
336672.0,198,399,2.015151515151515,1,6,198,0
336834.0,62,420,6.774193548387097,2,9,46,16
339144.0,148,738,4.986486486486487,2,8,147,1
339171.0,207,1029,4.971014492753623,2,7,207,0
342095.0,49,246,5.020408163265306,2,7,49,0
350321.0,288,2000,6.944444444444445,2,10,201,87
354838.0,38,89,2.3421052631578947,1,4,38,0
361053.0,289,1139,3.9411764705882355,1,7,289,0
361393.0,219,1504,6.867579908675799,2,9,149,70
363476.0,618,3620,5.857605177993528,2,9,581,37
371532.0,173,828,4.786127167630058,1,7,173,0
375472.0,150,440,2.933333333333333,1,6,150,0
376379.0,39,338,8.666666666666666,2,11,6,33
398450.0,350,2388,6.822857142857143,2,9,250,100
401423.0,577,5552,9.622183708838822,2,13,40,537
402588.0,242,502,2.074380165289256,1,5,242,0
404569.0,103,203,1.970873786407767,1,4,103,0
406341.0,210,823,3.919047619047619,2,7,210,0
414763.0,117,242,2.0683760683760686,1,4,117,0
429306.0,246,1251,5.085365853658536,2,8,244,2
449218.0,474,4594,9.691983122362869,2,13,23,451
456165.0,18,37,2.0555555555555554,1,4,18,0
459362.0,129,278,2.1550387596899223,1,4,129,0
462072.0,205,1025,5.0,2,7,205,0
469140.0,112,425,3.794642857142857,1,6,112,0
469231.0,75,166,2.2133333333333334,1,4,75,0
470132.0,53,501,9.452830188679245,2,12,4,49
471198.0,55,114,2.0727272727272728,1,4,55,0
471328.0,199,394,1.979899497487437,1,4,199,0
474719.0,253,1755,6.936758893280633,2,10,177,76
479718.0,26,160,6.153846153846154,3,9,25,1
484925.0,407,2023,4.9705159705159705,2,9,402,5
485570.0,30,217,7.233333333333333,6,9,18,12
491070.0,23,156,6.782608695652174,5,8,19,4
496416.0,8,31,3.875,3,5,8,0
496503.0,10,52,5.2,3,8,9,1
496561.0,23,114,4.956521739130435,3,7,23,0
498604.0,122,850,6.967213114754099,2,10,83,39
502779.0,87,437,5.022988505747127,2,8,85,2
502842.0,9,43,4.777777777777778,4,6,9,0
502918.0,177,1220,6.892655367231638,2,10,119,58
506956.0,698,3506,5.022922636103152,2,8,695,3
507614.0,48,241,5.020833333333333,3,7,48,0
510973.0,21,145,6.904761904761905,5,9,14,7
511705.0,1,1,1.0,1,1,1,0
514917.0,26,39,1.5,1,4,26,0
522563.0,116,254,2.189655172413793,1,5,116,0
524003.0,579,5069,8.75474956822107,2,13,66,513
526162.0,1,2,2.0,2,2,1,0
526513.0,863,1787,2.0706836616454227,1,5,863,0
531677.0,599,1201,2.005008347245409,1,5,599,0
536123.0,65,580,8.923076923076923,4,12,6,59
536197.0,33,165,5.0,3,7,33,0
540937.0,361,2488,6.89196675900277,2,11,254,107
544736.0,99,378,3.8181818181818183,2,6,99,0
552183.0,408,3553,8.708333333333334,2,12,57,351
560941.0,42,175,4.166666666666667,2,6,42,0
565152.0,261,1772,6.789272030651341,3,10,205,56
565235.0,60,599,9.983333333333333,7,13,1,59
567938.0,153,1231,8.045751633986928,3,12,40,113
568190.0,195,418,2.1435897435897435,1,5,195,0
571492.0,24,107,4.458333333333333,3,7,24,0
571876.0,435,2984,6.8597701149425285,2,10,308,127
576487.0,777,6819,8.776061776061775,2,12,89,688
578731.0,460,1781,3.871739130434783,2,7,460,0
588382.0,5,11,2.2,1,3,5,0
588518.0,83,413,4.975903614457831,2,8,80,3
590287.0,270,2327,8.618518518518519,2,11,36,234
590710.0,94,813,8.648936170212766,4,12,17,77
593916.0,233,1836,7.879828326180258,2,11,74,159
594298.0,581,1185,2.0395869191049916,1,5,581,0
595055.0,19,25,1.3157894736842106,1,3,19,0
598771.0,100,305,3.05,1,6,100,0
599134.0,7,15,2.142857142857143,1,4,7,0
605339.0,280,1109,3.960714285714286,1,7,280,0
608742.0,688,6028,8.761627906976743,2,12,74,614
610675.0,7,20,2.857142857142857,2,4,7,0
616027.0,74,148,2.0,1,4,74,0
618576.0,498,2471,4.961847389558233,2,8,495,3
625566.0,25,53,2.12,1,3,25,0
628394.0,85,185,2.176470588235294,1,4,85,0
631150.0,230,1125,4.891304347826087,2,8,228,2
631737.0,1,2,2.0,2,2,1,0
643471.0,48,63,1.3125,1,3,48,0
644656.0,4,9,2.25,1,4,4,0
644785.0,475,4625,9.736842105263158,2,13,20,455
653639.0,29,147,5.068965517241379,2,7,29,0
655514.0,5,10,2.0,1,4,5,0
663761.0,4,5,1.25,1,2,4,0
668753.0,81,557,6.8765432098765435,2,9,56,25
684564.0,171,366,2.1403508771929824,1,5,171,0
689099.0,15,22,1.4666666666666666,1,3,15,0
691025.0,59,398,6.745762711864407,2,9,42,17
695173.0,252,1255,4.98015873015873,2,8,251,1
696928.0,102,597,5.852941176470588,2,9,98,4
699974.0,84,586,6.976190476190476,5,9,58,26
702480.0,575,5497,9.56,2,13,43,532
704155.0,416,3651,8.776442307692308,2,12,47,369
709208.0,811,7834,9.659679408138102,2,13,45,766
709960.0,162,616,3.802469135802469,1,6,162,0
710156.0,194,402,2.0721649484536084,1,5,194,0
711554.0,430,4079,9.486046511627906,2,13,33,397
716292.0,112,429,3.830357142857143,1,6,112,0
717313.0,262,1289,4.919847328244275,2,7,262,0
718941.0,27,142,5.2592592592592595,3,7,27,0
721377.0,46,124,2.6956521739130435,1,5,46,0
723088.0,241,738,3.0622406639004147,1,6,241,0
724485.0,534,4139,7.750936329588015,2,10,181,353
726412.0,4,33,8.25,7,9,1,3
727374.0,603,2954,4.8988391376451075,2,8,598,5
727588.0,31,120,3.870967741935484,2,6,31,0
730502.0,95,475,5.0,3,7,95,0
733365.0,113,987,8.734513274336283,2,11,15,98
734053.0,16,144,9.0,7,10,1,15
745664.0,517,4507,8.717601547388782,2,12,70,447
747873.0,394,1921,4.875634517766497,2,8,391,3
748627.0,48,231,4.8125,2,7,48,0
748854.0,206,628,3.0485436893203883,1,6,206,0
749957.0,40,383,9.575,2,13,5,35
750257.0,23,44,1.9130434782608696,1,4,23,0
751527.0,103,528,5.12621359223301,2,7,103,0
751530.0,598,5780,9.665551839464882,2,12,35,563
752058.0,184,1609,8.744565217391305,2,11,17,167
752424.0,116,234,2.0172413793103448,1,5,116,0
754678.0,414,2004,4.840579710144928,2,8,413,1
755587.0,557,5420,9.730700179533214,2,14,27,530
758670.0,29,34,1.1724137931034482,1,2,29,0
760482.0,108,432,4.0,2,7,108,0
761159.0,625,6028,9.6448,2,13,42,583
763214.0,233,933,4.0042918454935625,1,8,232,1
767272.0,2,5,2.5,2,3,2,0
768311.0,285,2750,9.649122807017545,2,12,20,265
772646.0,302,1174,3.8874172185430464,1,7,302,0
780397.0,22,43,1.9545454545454546,1,3,22,0
780733.0,1,3,3.0,3,3,1,0
780743.0,30,180,6.0,4,8,29,1
784414.0,3,22,7.333333333333333,7,8,2,1
793618.0,494,1938,3.923076923076923,1,7,494,0
793622.0,46,94,2.0434782608695654,1,4,46,0
797030.0,336,2639,7.854166666666667,3,10,114,222
800755.0,436,2181,5.002293577981652,2,8,435,1
804681.0,1,2,2.0,2,2,1,0
807239.0,4,28,7.0,6,8,3,1
809874.0,97,288,2.9690721649484537,1,5,97,0
814870.0,217,1889,8.705069124423963,2,12,26,191
817184.0,365,755,2.0684931506849313,1,5,365,0
817848.0,272,790,2.9044117647058822,1,5,272,0
821860.0,475,3340,7.031578947368421,2,10,315,160
833871.0,309,2103,6.805825242718447,3,10,223,86
834562.0,290,1434,4.944827586206896,2,8,289,1
834675.0,192,1480,7.708333333333333,2,11,72,120
835333.0,422,860,2.037914691943128,1,5,422,0
838698.0,855,6709,7.846783625730994,2,11,274,581
838712.0,216,665,3.0787037037037037,1,6,216,0
840561.0,5,17,3.4,2,5,5,0
842078.0,39,170,4.358974358974359,2,7,39,0
846558.0,602,4716,7.833887043189368,2,11,208,394
847273.0,209,1039,4.971291866028708,2,8,208,1
848480.0,104,227,2.1826923076923075,1,4,104,0
862462.0,475,4148,8.732631578947368,2,12,50,425
862752.0,125,838,6.704,2,9,94,31
864488.0,563,4903,8.708703374777976,2,13,72,491
866381.0,40,383,9.575,3,12,4,36
867629.0,45,59,1.3111111111111111,1,3,45,0
871387.0,311,1235,3.9710610932475885,1,7,311,0
874029.0,94,646,6.872340425531915,2,10,63,31
874273.0,175,360,2.057142857142857,1,5,175,0
874842.0,4,16,4.0,2,5,4,0
886019.0,52,156,3.0,1,6,52,0
886724.0,18,115,6.388888888888889,3,9,15,3
888289.0,517,1571,3.0386847195357833,1,7,517,0
891946.0,6,38,6.333333333333333,3,8,5,1
892453.0,10,30,3.0,1,4,10,0
896209.0,101,707,7.0,5,10,68,33
896212.0,515,4979,9.667961165048544,2,13,35,480
903707.0,81,569,7.0246913580246915,3,10,55,26
904741.0,531,1078,2.030131826741996,1,5,531,0
904769.0,541,3692,6.824399260628466,2,10,383,158
904775.0,482,1025,2.1265560165975104,1,5,482,0
905315.0,503,4834,9.610337972166999,2,13,32,471
912425.0,76,383,5.0394736842105265,3,8,75,1
913536.0,13,30,2.3076923076923075,1,3,13,0
914057.0,224,444,1.9821428571428572,1,4,224,0
923140.0,195,935,4.794871794871795,2,7,195,0
925250.0,709,4144,5.844851904090268,2,9,659,50
925339.0,232,466,2.0086206896551726,1,4,232,0
933326.0,114,236,2.0701754385964914,1,5,114,0
938410.0,33,134,4.0606060606060606,2,6,33,0
940213.0,30,151,5.033333333333333,2,7,30,0
947552.0,64,128,2.0,1,4,64,0
948141.0,280,1081,3.8607142857142858,1,7,280,0
948963.0,211,657,3.1137440758293837,1,6,211,0
956538.0,84,419,4.988095238095238,2,8,83,1
958020.0,284,2181,7.679577464788732,2,11,114,170
974442.0,8,70,8.75,7,10,2,6
979312.0,1,1,1.0,1,1,1,0
983019.0,84,343,4.083333333333333,2,6,84,0
983410.0,603,4104,6.8059701492537314,2,10,429,174
1004858.0,30,94,3.1333333333333333,1,5,30,0
1021237.0,62,297,4.790322580645161,2,8,61,1
1037715.0,43,84,1.9534883720930232,1,4,43,0
1046994.0,46,221,4.804347826086956,2,7,46,0
1053180.0,364,1802,4.950549450549451,2,8,362,2
1053662.0,21,148,7.0476190476190474,6,9,15,6
1055724.0,35,234,6.685714285714286,2,10,25,10
1057560.0,322,668,2.0745341614906834,1,5,322,0
1065918.0,559,1168,2.0894454382826475,1,5,559,0
1067941.0,74,301,4.0675675675675675,2,6,74,0
1069174.0,332,1311,3.9487951807228914,2,6,332,0
1079119.0,49,250,5.1020408163265305,3,7,49,0
1082942.0,109,1073,9.844036697247706,2,12,6,103
1085217.0,31,56,1.8064516129032258,1,4,31,0
1085898.0,40,196,4.9,3,7,40,0
1086060.0,81,398,4.91358024691358,2,8,80,1
1086124.0,36,182,5.055555555555555,3,7,36,0
1087049.0,82,399,4.865853658536586,2,8,81,1
1092467.0,178,1216,6.831460674157303,2,9,127,51
1092967.0,99,217,2.191919191919192,1,4,99,0
1094063.0,347,2647,7.628242074927954,2,11,135,212
1106495.0,282,1949,6.911347517730497,2,10,197,85
1112289.0,89,181,2.033707865168539,1,4,89,0
1116076.0,85,572,6.729411764705882,2,9,62,23
1121429.0,347,2387,6.878962536023055,2,10,257,90
1126038.0,18,38,2.111111111111111,1,4,18,0
1130775.0,4,24,6.0,5,7,4,0
1130788.0,11,30,2.727272727272727,1,4,11,0
1133140.0,1,3,3.0,3,3,1,0
1146228.0,42,89,2.119047619047619,1,4,42,0
1154316.0,107,226,2.1121495327102804,1,5,107,0
1162707.0,148,848,5.72972972972973,2,8,146,2
1168731.0,50,477,9.54,3,12,4,46
1176241.0,10,62,6.2,3,9,9,1
1177492.0,961,8345,8.68366285119667,2,12,128,833
1177790.0,8,48,6.0,3,8,7,1
1208210.0,420,1262,3.0047619047619047,1,5,420,0
1209383.0,65,432,6.6461538461538465,2,9,50,15
1209661.0,452,957,2.1172566371681416,1,4,452,0
1214643.0,180,1412,7.844444444444444,2,11,58,122
1215055.0,289,1429,4.944636678200692,2,8,287,2
1216176.0,280,854,3.05,1,6,280,0
1220946.0,333,667,2.003003003003003,1,5,333,0
1238291.0,52,160,3.076923076923077,1,5,52,0
1245373.0,77,522,6.779220779220779,3,9,55,22
1248292.0,289,632,2.1868512110726646,1,5,289,0
1251520.0,70,140,2.0,1,4,70,0
1254955.0,48,92,1.9166666666666667,1,4,48,0
1256157.0,89,167,1.8764044943820224,1,5,89,0
1256570.0,128,1116,8.71875,2,13,16,112
1259830.0,356,1747,4.907303370786517,2,8,355,1
1263062.0,476,4141,8.699579831932773,2,11,56,420
1263329.0,468,4100,8.760683760683762,2,12,50,418
1266548.0,465,3221,6.926881720430107,2,10,323,142
1267730.0,316,647,2.0474683544303796,1,5,316,0
1271620.0,12,107,8.916666666666666,5,11,3,9
1272747.0,403,2758,6.843672456575683,2,10,291,112
1272844.0,163,331,2.0306748466257667,1,4,163,0
1273055.0,13,107,8.23076923076923,2,10,2,11
1275293.0,72,559,7.763888888888889,3,11,26,46
1281843.0,1,4,4.0,4,4,1,0
1284153.0,102,677,6.637254901960785,2,10,80,22
1286210.0,8,60,7.5,5,10,4,4
1296584.0,6,11,1.8333333333333333,1,3,6,0
1297217.0,502,1021,2.0338645418326693,1,5,502,0
1309325.0,151,284,1.880794701986755,1,4,151,0
1315027.0,11,77,7.0,5,10,8,3
1316794.0,139,292,2.1007194244604315,1,5,139,0
1320674.0,587,2914,4.964224872231687,1,9,584,3
1326972.0,15,28,1.8666666666666667,1,4,15,0
1330726.0,320,2187,6.834375,2,10,221,99
1336818.0,53,120,2.2641509433962264,1,4,53,0
1343630.0,74,672,9.08108108108108,3,11,7,67
1346747.0,94,628,6.680851063829787,2,9,75,19
1362092.0,321,657,2.046728971962617,1,5,321,0
1368303.0,272,2097,7.709558823529412,2,11,101,171
1372935.0,49,100,2.0408163265306123,1,5,49,0
1374299.0,562,5462,9.718861209964412,2,13,28,534
1380233.0,414,2835,6.8478260869565215,2,10,295,119
1395084.0,29,222,7.655172413793103,2,10,8,21
1408400.0,241,964,4.0,1,7,241,0
1426027.0,230,943,4.1,1,7,230,0
1427336.0,180,381,2.1166666666666667,1,4,180,0
1430003.0,174,673,3.867816091954023,1,7,174,0
1431541.0,133,546,4.105263157894737,1,6,133,0
1443639.0,58,134,2.310344827586207,1,4,58,0
1463482.0,301,899,2.9867109634551494,1,6,301,0
1470809.0,3,10,3.3333333333333335,3,4,3,0
1473278.0,47,185,3.9361702127659575,2,6,47,0
1473284.0,15,95,6.333333333333333,5,8,14,1
1484797.0,624,6050,9.695512820512821,2,14,37,587
1485339.0,16,32,2.0,1,3,16,0
1491263.0,20,35,1.75,1,4,20,0
1496117.0,195,1337,6.856410256410256,2,10,145,50
1499953.0,166,813,4.897590361445783,2,9,165,1
1500875.0,439,3015,6.867881548974943,2,10,320,119
1507595.0,48,333,6.9375,5,10,35,13
1522608.0,22,46,2.090909090909091,1,4,22,0
1523675.0,768,3032,3.9479166666666665,1,7,768,0
1529526.0,530,5089,9.60188679245283,2,12,35,495
1529540.0,94,815,8.670212765957446,4,11,16,78
1532354.0,234,1612,6.888888888888889,2,9,166,68
1547100.0,80,672,8.4,3,11,16,64
1568065.0,104,511,4.913461538461538,2,8,103,1
1569343.0,109,239,2.1926605504587156,1,5,109,0
1579108.0,218,2125,9.747706422018348,2,13,13,205
1593044.0,35,71,2.0285714285714285,1,4,35,0
1595592.0,2,6,3.0,3,3,2,0
1607436.0,50,75,1.5,1,4,50,0
1609815.0,241,2101,8.717842323651452,2,12,34,207
1615453.0,102,964,9.450980392156863,2,12,11,91
1621371.0,167,664,3.9760479041916166,1,7,167,0
1622564.0,185,751,4.059459459459459,1,7,185,0
1623202.0,99,286,2.888888888888889,1,6,99,0
1628485.0,213,289,1.3568075117370892,1,3,213,0
1630249.0,6,23,3.8333333333333335,2,5,6,0
1636170.0,80,321,4.0125,2,6,80,0
1639002.0,6,42,7.0,6,8,5,1
1639471.0,216,296,1.3703703703703705,1,4,216,0
1642412.0,143,707,4.944055944055944,2,8,141,2
1644183.0,59,230,3.8983050847457625,1,6,59,0
1644403.0,416,3628,8.721153846153847,2,12,54,362
1654320.0,66,319,4.833333333333333,2,7,66,0
1665067.0,21,87,4.142857142857143,2,6,21,0
1672696.0,125,365,2.92,1,6,125,0
1680271.0,515,2028,3.9378640776699028,1,7,515,0
1683393.0,311,2119,6.813504823151125,2,10,217,94
1691073.0,321,672,2.0934579439252334,1,4,321,0
1695083.0,325,661,2.0338461538461536,1,4,325,0
1698916.0,47,181,3.851063829787234,2,6,47,0
1708578.0,98,766,7.816326530612245,3,11,32,66
1716687.0,196,256,1.3061224489795917,1,4,196,0
1725819.0,2,13,6.5,6,7,2,0
1734269.0,229,1131,4.93886462882096,2,8,227,2
1737408.0,181,868,4.795580110497237,2,7,181,0
1742289.0,297,2016,6.787878787878788,2,10,219,78
1743425.0,305,926,3.036065573770492,1,6,305,0
1755242.0,646,1339,2.0727554179566563,1,5,646,0
1757983.0,60,182,3.033333333333333,1,5,60,0
1763683.0,409,2787,6.814180929095355,2,9,288,121
1765529.0,72,646,8.972222222222221,2,11,4,68
1766697.0,21,47,2.238095238095238,1,4,21,0
1774049.0,67,148,2.208955223880597,1,5,67,0
1779465.0,115,589,5.121739130434783,3,8,114,1
1788102.0,211,1233,5.843601895734597,2,9,202,9
1797544.0,31,127,4.096774193548387,2,6,31,0
1811287.0,386,751,1.9455958549222798,1,4,386,0
1811588.0,32,129,4.03125,2,6,32,0
1826249.0,378,1504,3.9788359788359786,2,7,378,0
1845240.0,384,2611,6.799479166666667,2,10,271,113
1846297.0,21,45,2.142857142857143,1,4,21,0
1854759.0,65,262,4.030769230769231,2,6,65,0
1858255.0,262,1277,4.874045801526718,2,9,261,1
1863038.0,174,684,3.9310344827586206,1,7,174,0
1865189.0,9,12,1.3333333333333333,1,2,9,0
1870392.0,168,223,1.3273809523809523,1,3,168,0
1900810.0,17,153,9.0,7,11,1,16
1901306.0,66,147,2.227272727272727,1,4,66,0
1910871.0,139,286,2.0575539568345325,1,5,139,0
1926546.0,16,43,2.6875,1,4,16,0
1927108.0,2,4,2.0,1,3,2,0
1928731.0,213,1038,4.873239436619718,2,7,213,0
1952753.0,145,1414,9.751724137931035,2,13,13,132
1956372.0,220,304,1.3818181818181818,1,5,220,0
1956571.0,16,138,8.625,3,11,3,13
1958786.0,27,55,2.037037037037037,1,4,27,0
1973442.0,201,1765,8.781094527363184,2,11,17,184
1990801.0,606,1231,2.0313531353135312,1,5,606,0
2001012.0,22,151,6.863636363636363,2,9,16,6
2025216.0,3,25,8.333333333333334,4,11,1,2
2052361.0,73,362,4.958904109589041,2,7,73,0
2052383.0,1,1,1.0,1,1,1,0
2054398.0,18,134,7.444444444444445,2,9,8,10
2062465.0,89,787,8.842696629213483,6,12,7,82
2064355.0,50,107,2.14,1,4,50,0
2064939.0,26,75,2.8846153846153846,1,4,26,0
2068722.0,37,74,2.0,1,4,37,0
2068792.0,54,116,2.1481481481481484,1,5,54,0
2068796.0,39,76,1.9487179487179487,1,4,39,0
2069026.0,43,88,2.046511627906977,1,4,43,0
2069270.0,79,370,4.6835443037974684,2,7,79,0
2070887.0,135,308,2.2814814814814817,1,5,135,0
2084773.0,65,132,2.0307692307692307,1,4,65,0
2087574.0,381,528,1.3858267716535433,1,4,381,0
2091654.0,6,16,2.6666666666666665,2,4,6,0
2096590.0,19,31,1.631578947368421,1,3,19,0
2096863.0,11,32,2.909090909090909,2,4,11,0
2100370.0,7,17,2.4285714285714284,1,3,7,0
2101315.0,55,106,1.9272727272727272,1,4,55,0
2117068.0,13,87,6.6923076923076925,4,8,9,4
2133917.0,421,847,2.01187648456057,1,5,421,0
2148876.0,26,77,2.9615384615384617,1,5,26,0
2179527.0,193,782,4.051813471502591,1,7,193,0
2180753.0,16,163,10.1875,9,12,0,16
2186049.0,29,80,2.7586206896551726,1,4,29,0
2188662.0,422,1272,3.014218009478673,1,6,422,0
2192321.0,53,371,7.0,4,9,35,18
2207960.0,162,971,5.993827160493828,2,8,148,14
2219385.0,48,335,6.979166666666667,4,9,31,17
2224238.0,407,3547,8.714987714987714,2,12,53,354
2235818.0,91,668,7.34065934065934,2,10,40,51
2247751.0,150,757,5.046666666666667,2,8,149,1
2254525.0,204,1784,8.745098039215685,2,12,19,185
2266094.0,50,145,2.9,1,5,50,0
2281129.0,26,59,2.269230769230769,1,4,26,0
2289744.0,355,732,2.0619718309859154,1,4,355,0
2294171.0,8,22,2.75,2,4,8,0
2299045.0,312,641,2.0544871794871793,1,5,312,0
2299339.0,466,4035,8.658798283261802,2,12,69,397
2302853.0,85,750,8.823529411764707,3,12,9,76
2305770.0,590,5742,9.732203389830508,2,14,32,558
2319136.0,73,304,4.164383561643835,2,6,73,0
2322698.0,133,672,5.052631578947368,2,8,132,1
2325516.0,52,366,7.038461538461538,2,10,33,19
2338390.0,38,73,1.9210526315789473,1,4,38,0
2342966.0,30,173,5.766666666666667,3,9,28,2
2355344.0,748,3682,4.922459893048129,2,8,745,3
2358924.0,13,25,1.9230769230769231,1,3,13,0
2362698.0,154,441,2.8636363636363638,1,7,154,0
2364463.0,548,3766,6.872262773722627,2,10,383,165
2388144.0,76,674,8.868421052631579,5,11,5,71
2416770.0,532,1089,2.0469924812030076,1,4,532,0
2452815.0,830,1691,2.0373493975903614,1,5,830,0
2463267.0,56,108,1.9285714285714286,1,4,56,0
2471370.0,477,991,2.0775681341719077,1,5,477,0
2488934.0,203,606,2.9852216748768474,1,5,203,0
2503991.0,43,88,2.046511627906977,1,4,43,0
2513822.0,489,4702,9.615541922290388,2,13,36,453
2520674.0,18,52,2.888888888888889,1,5,18,0
2520679.0,148,309,2.0878378378378377,1,6,148,0
2534822.0,125,850,6.8,2,9,86,39
2549655.0,14,25,1.7857142857142858,1,3,14,0
2551382.0,184,560,3.0434782608695654,1,7,184,0
2551440.0,350,2694,7.6971428571428575,2,10,129,221
2558321.0,322,656,2.0372670807453415,1,5,322,0
2579525.0,672,4585,6.822916666666667,2,10,487,185
2587493.0,40,159,3.975,1,6,40,0
2588548.0,161,342,2.124223602484472,1,5,161,0
2589141.0,55,112,2.036363636363636,1,4,55,0
2604097.0,7,12,1.7142857142857142,1,3,7,0
2604787.0,106,729,6.877358490566038,2,9,67,39
2618140.0,420,2062,4.90952380952381,2,7,420,0
2622839.0,376,1878,4.99468085106383,2,8,372,4
2630315.0,276,1386,5.021739130434782,2,8,272,4
2630840.0,391,1579,4.038363171355499,1,7,391,0
2632012.0,43,52,1.2093023255813953,1,2,43,0
2642944.0,3,19,6.333333333333333,5,7,3,0
2650925.0,695,3448,4.961151079136691,2,8,691,4
2652829.0,673,3302,4.906389301634473,2,8,668,5
2658189.0,1,1,1.0,1,1,1,0
2667852.0,16,150,9.375,8,11,0,16
2668122.0,23,195,8.478260869565217,2,11,4,19
2673648.0,133,667,5.015037593984962,2,8,131,2
2686592.0,53,314,5.9245283018867925,3,8,48,5
2698131.0,171,840,4.912280701754386,2,8,170,1
2706194.0,248,520,2.096774193548387,1,5,248,0
2711470.0,137,948,6.91970802919708,3,10,96,41
2725897.0,407,3549,8.71990171990172,2,11,52,355
2731786.0,317,2466,7.779179810725552,2,11,113,204
2736479.0,27,67,2.4814814814814814,1,5,27,0
2739623.0,533,2607,4.891181988742964,2,8,532,1
2744523.0,74,126,1.7027027027027026,1,4,74,0
2751269.0,403,3519,8.732009925558312,2,12,47,356
2753388.0,193,407,2.1088082901554404,1,5,193,0
2761815.0,15,74,4.933333333333334,2,6,15,0
2816920.0,164,1569,9.567073170731707,2,12,14,150
2820486.0,115,333,2.8956521739130436,1,5,115,0
2822037.0,76,746,9.81578947368421,3,12,2,74
2841806.0,453,2232,4.927152317880795,2,8,450,3
2844923.0,309,1512,4.893203883495145,2,9,308,1
2847041.0,96,373,3.8854166666666665,1,6,96,0
2862015.0,835,1160,1.3892215568862276,1,4,835,0
2895896.0,69,270,3.9130434782608696,1,7,69,0
2912133.0,207,1025,4.951690821256038,2,7,207,0
2920545.0,344,1684,4.895348837209302,1,9,341,3
2926676.0,54,218,4.037037037037037,2,6,54,0
2943509.0,24,49,2.0416666666666665,1,4,24,0
2943575.0,14,25,1.7857142857142858,1,3,14,0
2948623.0,104,937,9.009615384615385,3,13,14,90
2953049.0,168,812,4.833333333333333,2,8,166,2
2954743.0,9,15,1.6666666666666667,1,3,9,0
2965741.0,166,1291,7.77710843373494,2,10,60,106
2973483.0,189,255,1.3492063492063493,1,4,189,0
3004372.0,40,112,2.8,1,5,40,0
3012570.0,5,7,1.4,1,2,5,0
3012762.0,3,4,1.3333333333333333,1,2,3,0
3018510.0,12,23,1.9166666666666667,1,3,12,0
3028371.0,64,191,2.984375,1,6,64,0
3036157.0,108,316,2.925925925925926,1,6,108,0
3042518.0,575,5521,9.601739130434783,2,13,35,540
3045724.0,134,290,2.1641791044776117,1,5,134,0
3046856.0,66,140,2.121212121212121,1,5,66,0
3046879.0,303,639,2.108910891089109,1,5,303,0
3047780.0,20,44,2.2,1,4,20,0
3048220.0,5,11,2.2,1,4,5,0
3107033.0,2,3,1.5,1,2,2,0
3107136.0,4,15,3.75,3,5,4,0
3113226.0,85,674,7.929411764705883,2,11,29,56
3143400.0,527,1147,2.176470588235294,1,6,527,0
3143872.0,321,2802,8.728971962616823,2,12,36,285
3146468.0,604,1253,2.0745033112582782,1,5,604,0
3150635.0,247,968,3.919028340080972,1,7,247,0
3150921.0,107,718,6.710280373831775,2,9,80,27
3166047.0,375,1127,3.005333333333333,1,6,375,0
3175720.0,37,167,4.513513513513513,2,6,37,0
3179431.0,5,25,5.0,4,6,5,0
3179713.0,17,68,4.0,2,7,17,0
3180437.0,6,28,4.666666666666667,3,6,6,0
3180549.0,11,97,8.818181818181818,8,10,0,11
3180588.0,13,107,8.23076923076923,2,10,2,11
3187973.0,373,769,2.0616621983914207,1,5,373,0
3196382.0,6,9,1.5,1,2,6,0
3203777.0,6,12,2.0,1,3,6,0
3212027.0,185,742,4.010810810810811,1,6,185,0
3222550.0,64,135,2.109375,1,4,64,0
3224985.0,39,110,2.8205128205128207,1,4,39,0
3255468.0,85,364,4.2823529411764705,2,6,85,0
3264794.0,87,182,2.0919540229885056,1,4,87,0
3285554.0,53,463,8.735849056603774,3,11,6,47
3285747.0,378,808,2.1375661375661377,1,5,378,0
3288510.0,17,74,4.352941176470588,1,6,17,0
3294964.0,6,13,2.1666666666666665,1,3,6,0
3297333.0,80,325,4.0625,2,6,80,0
3306584.0,581,2880,4.95697074010327,2,8,577,4
3312444.0,11,27,2.4545454545454546,1,4,11,0
3318664.0,199,981,4.9296482412060305,2,8,196,3
3322399.0,107,287,2.682242990654206,1,5,107,0
3338631.0,72,429,5.958333333333333,2,8,67,5
3351904.0,177,1715,9.689265536723164,2,13,10,167
3356511.0,5,5,1.0,1,1,5,0
3362911.0,150,302,2.013333333333333,1,4,150,0
3368882.0,1,2,2.0,2,2,1,0
3374974.0,63,90,1.4285714285714286,1,4,63,0
3381733.0,18,78,4.333333333333333,3,6,18,0
3385580.0,7,19,2.7142857142857144,2,4,7,0
3389625.0,363,1809,4.983471074380165,2,8,360,3
3392806.0,86,189,2.197674418604651,1,6,86,0
3397465.0,992,4903,4.942540322580645,1,8,982,10
3402831.0,193,949,4.917098445595855,2,9,190,3
3409752.0,133,259,1.9473684210526316,1,5,133,0
3419248.0,80,156,1.95,1,4,80,0
3421523.0,1,1,1.0,1,1,1,0
3423709.0,262,1269,4.843511450381679,2,7,262,0
3425435.0,77,536,6.961038961038961,3,9,56,21
3428310.0,91,455,5.0,3,7,91,0
3428746.0,134,650,4.850746268656716,2,8,132,2
3428808.0,498,3433,6.893574297188755,2,10,347,151
3431705.0,966,4810,4.979296066252588,2,8,955,11
3435208.0,126,1115,8.84920634920635,4,12,15,111
3446903.0,12,21,1.75,1,3,12,0
3451661.0,26,103,3.9615384615384617,3,6,26,0
3455329.0,30,204,6.8,4,9,21,9
3457207.0,345,709,2.055072463768116,1,5,345,0
3461034.0,6,45,7.5,6,9,3,3
3477490.0,8,59,7.375,6,8,4,4
3489508.0,164,1102,6.719512195121951,2,9,115,49
3500141.0,320,3069,9.590625,2,14,19,301
3501674.0,138,534,3.869565217391304,1,6,138,0
3513150.0,85,512,6.023529411764706,4,8,80,5
3514869.0,118,919,7.788135593220339,4,11,44,74
3515468.0,131,1024,7.816793893129771,2,11,45,86
3517805.0,90,182,2.022222222222222,1,4,90,0
3517921.0,390,823,2.1102564102564103,1,6,390,0
3527783.0,90,715,7.944444444444445,3,11,19,71
3531042.0,134,186,1.3880597014925373,1,4,134,0
3552414.0,108,738,6.833333333333333,2,9,72,36
3584830.0,666,3301,4.956456456456457,2,8,660,6
3586833.0,62,248,4.0,1,6,62,0
3588117.0,471,2745,5.828025477707007,2,9,444,27
3589141.0,67,587,8.761194029850746,3,11,9,58
3590226.0,514,4512,8.778210116731518,2,12,56,458
3591352.0,24,54,2.25,1,4,24,0
3599402.0,27,43,1.5925925925925926,1,3,27,0
3604139.0,113,1083,9.584070796460177,3,12,8,105
3610905.0,56,116,2.0714285714285716,1,5,56,0
3631750.0,288,1398,4.854166666666667,2,8,287,1
3632796.0,70,89,1.2714285714285714,1,3,70,0
3634873.0,87,416,4.781609195402299,2,8,86,1
3641547.0,1,1,1.0,1,1,1,0
3654455.0,65,321,4.938461538461539,3,8,63,2
3659371.0,4,9,2.25,1,4,4,0
3680191.0,435,3834,8.813793103448276,2,12,55,380
3680650.0,529,2138,4.041587901701323,1,7,529,0
3681753.0,208,436,2.0961538461538463,1,5,208,0
3681786.0,186,394,2.118279569892473,1,5,186,0
3704577.0,175,857,4.897142857142857,1,7,175,0
3712285.0,10,30,3.0,1,5,10,0
3717049.0,154,917,5.954545454545454,2,9,145,9
3722238.0,151,318,2.1059602649006623,1,5,151,0
3727205.0,830,5710,6.879518072289157,2,10,592,238
3727225.0,40,260,6.5,2,9,30,10
3729343.0,58,515,8.879310344827585,3,11,7,51
3731234.0,120,170,1.4166666666666667,1,3,120,0
3738662.0,32,100,3.125,1,6,32,0
3742728.0,315,663,2.104761904761905,1,5,315,0
3753438.0,3,24,8.0,8,8,0,3
3756051.0,3,5,1.6666666666666667,1,2,3,0
3759135.0,445,3108,6.984269662921348,2,10,298,147
3759217.0,85,587,6.905882352941177,3,10,60,25
3762974.0,3,6,2.0,1,3,3,0
3763652.0,57,126,2.210526315789474,1,5,57,0
3764496.0,18,36,2.0,1,3,18,0
3770848.0,153,444,2.9019607843137254,1,6,153,0
3772268.0,3,8,2.6666666666666665,2,3,3,0
3776849.0,275,1852,6.734545454545454,2,10,206,69
3782713.0,5,6,1.2,1,2,5,0
3786394.0,6,50,8.333333333333334,8,9,0,6
3798844.0,31,104,3.3548387096774195,1,5,31,0
3816076.0,118,706,5.983050847457627,2,9,106,12
3819043.0,216,895,4.143518518518518,1,7,216,0
3819941.0,27,64,2.3703703703703702,1,4,27,0
3824546.0,4,30,7.5,7,8,2,2
3825317.0,14,28,2.0,1,3,14,0
3826572.0,113,1091,9.654867256637168,2,12,9,104
3831850.0,237,1144,4.827004219409282,2,8,234,3
3832141.0,11,85,7.7272727272727275,6,10,4,7
3832234.0,8,19,2.375,1,4,8,0
3833696.0,25,147,5.88,4,8,24,1
3842078.0,3,20,6.666666666666667,6,7,3,0
3849729.0,193,565,2.9274611398963732,1,6,193,0
3850756.0,251,341,1.3585657370517927,1,4,251,0
3853827.0,590,1226,2.077966101694915,1,5,590,0
3855338.0,6,6,1.0,1,1,6,0
3857504.0,355,726,2.045070422535211,1,5,355,0
3858506.0,41,246,6.0,2,9,36,5
3885520.0,286,1926,6.734265734265734,2,10,216,70
3901968.0,188,387,2.0585106382978724,1,5,188,0
3909843.0,14,20,1.4285714285714286,1,3,14,0
3913946.0,324,1643,5.070987654320987,2,8,319,5
3940117.0,45,401,8.911111111111111,3,12,6,39
3944509.0,105,711,6.771428571428571,3,10,79,26
3945176.0,16,35,2.1875,1,4,16,0
3973113.0,134,417,3.111940298507463,1,5,134,0
3975171.0,220,669,3.040909090909091,1,6,220,0
3985609.0,596,4074,6.8355704697986575,2,10,427,169
4001706.0,1,3,3.0,3,3,1,0
4036586.0,129,752,5.829457364341085,2,9,117,12
4038339.0,691,6035,8.73371924746744,2,12,81,610
4055217.0,52,152,2.923076923076923,1,6,52,0
4067702.0,31,89,2.870967741935484,1,5,31,0
4072032.0,42,334,7.9523809523809526,4,11,17,25
4075286.0,162,944,5.827160493827161,2,8,154,8
4082994.0,54,325,6.018518518518518,3,8,49,5
4083002.0,68,398,5.852941176470588,2,8,66,2
4094400.0,215,2069,9.623255813953488,2,13,12,203
4102498.0,51,353,6.921568627450981,3,9,38,13
4109879.0,403,821,2.0372208436724564,1,5,403,0
4110229.0,311,650,2.090032154340836,1,4,311,0
4119683.0,172,859,4.994186046511628,2,7,172,0
4132363.0,679,3357,4.944035346097202,1,9,672,7
4138973.0,8,45,5.625,4,7,8,0
4155781.0,6,10,1.6666666666666667,1,2,6,0
4158564.0,1,7,7.0,7,7,1,0
4160649.0,389,2697,6.933161953727506,2,10,263,126
4160750.0,95,748,7.873684210526315,4,10,29,66
4175883.0,57,522,9.157894736842104,2,13,6,51
4176704.0,312,2119,6.791666666666667,2,10,227,85
4176994.0,326,2218,6.803680981595092,2,9,234,92
4178088.0,234,1374,5.871794871794871,2,9,220,14
4189810.0,63,93,1.4761904761904763,1,4,63,0
4189994.0,80,399,4.9875,3,7,80,0
4193005.0,4,15,3.75,2,5,4,0
4199872.0,114,899,7.885964912280702,2,10,37,77
4201199.0,126,239,1.8968253968253967,1,5,126,0
4202733.0,55,114,2.0727272727272728,1,4,55,0
4209759.0,227,478,2.105726872246696,1,5,227,0
4216775.0,66,512,7.757575757575758,2,10,25,41
4230273.0,32,132,4.125,3,5,32,0
4230554.0,164,336,2.048780487804878,1,4,164,0
4241100.0,56,111,1.9821428571428572,1,5,56,0
4241259.0,7,14,2.0,1,3,7,0
4245658.0,85,829,9.75294117647059,3,12,5,80
4246787.0,234,1616,6.905982905982906,2,10,154,80
4253959.0,3,20,6.666666666666667,6,7,3,0
4263173.0,42,336,8.0,6,11,14,28
4266974.0,75,242,3.2266666666666666,1,5,75,0
4290579.0,55,105,1.9090909090909092,1,4,55,0
4295344.0,715,2783,3.8923076923076922,1,7,715,0
4308225.0,332,1666,5.018072289156627,2,8,324,8
4316495.0,117,808,6.905982905982906,2,9,85,32
4337324.0,14,125,8.928571428571429,7,11,1,13
4342918.0,4,11,2.75,1,4,4,0
4367064.0,86,272,3.1627906976744184,1,5,86,0
4376685.0,82,335,4.085365853658536,1,6,82,0
4383859.0,368,767,2.0842391304347827,1,5,368,0
4390763.0,98,211,2.1530612244897958,1,4,98,0
4394265.0,3,8,2.6666666666666665,2,4,3,0
4394370.0,43,253,5.883720930232558,4,8,42,1
4394882.0,29,166,5.724137931034483,2,9,25,4
4399187.0,92,903,9.815217391304348,3,13,4,88
4407551.0,25,147,5.88,4,8,23,2
4411068.0,67,145,2.1641791044776117,1,4,67,0
4414146.0,255,753,2.9529411764705884,1,6,255,0
4414411.0,169,1175,6.952662721893491,2,10,120,49
4418512.0,30,240,8.0,3,11,6,24
4421901.0,565,2787,4.932743362831858,1,8,563,2
4442918.0,14,90,6.428571428571429,3,8,13,1
4443443.0,18,38,2.111111111111111,1,4,18,0
4453537.0,107,410,3.8317757009345796,1,6,107,0
4463531.0,200,1572,7.86,2,10,69,131
4473361.0,33,100,3.0303030303030303,1,6,33,0
4483457.0,118,587,4.97457627118644,2,7,118,0
4491361.0,310,3008,9.703225806451613,2,13,12,298
4496392.0,408,836,2.049019607843137,1,5,408,0
4521465.0,121,598,4.9421487603305785,2,8,120,1
4523822.0,326,696,2.1349693251533743,1,5,326,0
4595967.0,320,2204,6.8875,2,10,226,94
4596183.0,384,2628,6.84375,2,10,278,106
4596225.0,360,2472,6.866666666666666,2,11,246,114
4596254.0,283,1911,6.752650176678445,2,10,208,75
4596316.0,329,2243,6.817629179331307,2,10,242,87
4600543.0,7,10,1.4285714285714286,1,2,7,0
4604059.0,28,64,2.2857142857142856,1,5,28,0
4619721.0,237,1619,6.831223628691983,2,9,164,73
4649686.0,33,43,1.303030303030303,1,3,33,0
4649848.0,149,280,1.8791946308724832,1,5,149,0
4652573.0,70,143,2.0428571428571427,1,4,70,0
4655244.0,57,129,2.263157894736842,1,5,57,0
4659571.0,175,232,1.3257142857142856,1,3,175,0
4664979.0,3,8,2.6666666666666665,1,4,3,0
4670971.0,13,99,7.615384615384615,2,9,3,10
4675684.0,89,336,3.7752808988764044,2,7,89,0
4679716.0,43,85,1.9767441860465116,1,4,43,0
4683787.0,99,203,2.0505050505050506,1,4,99,0
4684786.0,1,1,1.0,1,1,1,0
4687759.0,503,2516,5.001988071570577,2,8,500,3
4714001.0,17,34,2.0,1,3,17,0
4718091.0,42,211,5.023809523809524,3,7,42,0
4718699.0,162,1124,6.938271604938271,3,10,112,50
4723540.0,156,221,1.4166666666666667,1,4,156,0
4728228.0,1,2,2.0,2,2,1,0
4728260.0,176,365,2.0738636363636362,1,5,176,0
4748673.0,51,349,6.8431372549019605,2,9,36,15
4755562.0,71,144,2.028169014084507,1,5,71,0
4766077.0,359,2823,7.8635097493036215,2,11,121,238
4767419.0,30,216,7.2,3,9,16,14
4772019.0,326,1608,4.932515337423313,2,8,324,2
4780178.0,7,16,2.2857142857142856,1,4,7,0
4789460.0,111,448,4.036036036036036,1,7,111,0
4798571.0,34,137,4.029411764705882,2,6,34,0
4799714.0,41,90,2.1951219512195124,1,4,41,0
4812872.0,41,83,2.024390243902439,1,4,41,0
4815680.0,129,280,2.1705426356589146,1,5,129,0
4818802.0,52,342,6.576923076923077,2,9,41,11
4819958.0,138,944,6.840579710144928,2,10,102,36
4849860.0,136,1299,9.551470588235293,2,12,11,125
4854921.0,184,1780,9.673913043478262,2,13,15,169
4879291.0,30,232,7.733333333333333,3,10,11,19
4891262.0,481,2336,4.856548856548857,2,8,479,2
4905237.0,191,1486,7.780104712041885,2,11,71,120
4906204.0,6,20,3.3333333333333335,2,6,6,0
4936409.0,48,110,2.2916666666666665,1,5,48,0
4939649.0,403,2015,5.0,2,8,400,3
4947004.0,412,1642,3.9854368932038833,1,7,412,0
4949149.0,30,90,3.0,1,6,30,0
4963162.0,92,185,2.010869565217391,1,5,92,0
4989893.0,47,103,2.1914893617021276,1,4,47,0
4994724.0,60,532,8.866666666666667,4,11,3,57
5009543.0,7,18,2.5714285714285716,1,4,7,0
5012393.0,199,1740,8.743718592964823,2,12,24,175
5025556.0,831,8015,9.645006016847173,2,13,59,772
5029402.0,137,1190,8.686131386861314,2,11,18,119
5062060.0,154,1068,6.935064935064935,2,9,104,50
5063329.0,322,2816,8.745341614906833,2,12,35,287
5071690.0,168,813,4.839285714285714,2,8,167,1
5097623.0,233,1581,6.785407725321888,2,10,165,68
5109767.0,94,834,8.872340425531915,3,12,8,86
5130753.0,187,400,2.1390374331550803,1,5,187,0
5155333.0,72,356,4.944444444444445,2,7,72,0
5159286.0,262,787,3.00381679389313,1,5,262,0
5177584.0,68,592,8.705882352941176,2,11,10,58
5181111.0,316,928,2.9367088607594938,1,5,316,0
5188935.0,298,894,3.0,1,6,298,0
5192121.0,6,17,2.8333333333333335,2,3,6,0
5196621.0,263,2563,9.745247148288973,2,12,13,250
5197442.0,72,145,2.013888888888889,1,4,72,0
5264948.0,530,1105,2.0849056603773586,1,5,530,0
5264999.0,501,1035,2.065868263473054,1,5,501,0
5266430.0,475,2357,4.962105263157895,2,8,474,1
5266480.0,351,711,2.0256410256410255,1,4,351,0
5278933.0,225,904,4.017777777777778,1,7,225,0
5285533.0,210,2005,9.547619047619047,2,13,14,196
5292745.0,1,3,3.0,3,3,1,0
5299516.0,43,124,2.883720930232558,1,5,43,0
5310107.0,296,1188,4.013513513513513,1,7,296,0
5312932.0,335,2325,6.940298507462686,2,10,230,105
5313039.0,280,1949,6.960714285714285,2,9,191,89
5313142.0,312,2170,6.955128205128205,2,9,205,107
5313221.0,341,2301,6.747800586510264,2,10,255,86
5313252.0,289,1971,6.820069204152249,2,10,199,90
5327846.0,23,113,4.913043478260869,3,6,23,0
5343327.0,11,19,1.7272727272727273,1,3,11,0
5344630.0,367,1831,4.989100817438692,2,8,363,4
5353419.0,43,93,2.1627906976744184,1,5,43,0
5371540.0,319,1528,4.789968652037618,2,8,315,4
5372333.0,2,4,2.0,1,3,2,0
5373240.0,8,26,3.25,2,5,8,0
5379424.0,1,2,2.0,2,2,1,0
5398163.0,8,11,1.375,1,3,8,0
5428088.0,281,1927,6.857651245551601,2,9,203,78
5429605.0,145,301,2.075862068965517,1,5,145,0
5431622.0,23,48,2.0869565217391304,1,4,23,0
5437526.0,41,345,8.414634146341463,3,12,7,34
5448860.0,100,196,1.96,1,4,100,0
5458016.0,107,618,5.775700934579439,2,8,103,4
5464071.0,5,36,7.2,6,8,3,2
5466021.0,332,1659,4.996987951807229,2,8,327,5
5476645.0,131,659,5.030534351145038,2,8,130,1
5484923.0,1,1,1.0,1,1,1,0
5486086.0,48,98,2.0416666666666665,1,4,48,0
5508232.0,41,114,2.7804878048780486,1,6,41,0
5519763.0,38,75,1.9736842105263157,1,4,38,0
5529302.0,101,310,3.0693069306930694,1,6,101,0
5544738.0,322,653,2.027950310559006,1,5,322,0
5552409.0,282,2685,9.52127659574468,2,13,20,262
5563493.0,32,72,2.25,1,4,32,0
5564929.0,110,953,8.663636363636364,2,12,11,99
5567395.0,23,69,3.0,1,4,23,0
5583981.0,45,184,4.088888888888889,2,6,45,0
5602310.0,111,1086,9.783783783783784,2,12,3,108
5611639.0,87,192,2.206896551724138,1,4,87,0
5622755.0,194,936,4.824742268041237,2,9,193,1
5630901.0,3,11,3.6666666666666665,3,5,3,0
5652131.0,8,19,2.375,2,3,8,0
5654095.0,250,508,2.032,1,5,250,0
5654704.0,341,2325,6.818181818181818,2,10,255,86
5659065.0,76,455,5.9868421052631575,2,9,67,9
5662266.0,19,60,3.1578947368421053,2,4,19,0
5672272.0,230,2000,8.695652173913043,2,11,27,203
5676228.0,119,359,3.0168067226890756,1,6,119,0
5683244.0,118,586,4.966101694915254,2,7,118,0
5691640.0,23,92,4.0,3,5,23,0
5699523.0,43,55,1.2790697674418605,1,2,43,0
5699593.0,276,1352,4.898550724637682,2,7,276,0
5707431.0,196,428,2.183673469387755,1,5,196,0
5710721.0,25,130,5.2,3,7,25,0
5715713.0,109,230,2.110091743119266,1,6,109,0
5722694.0,109,154,1.4128440366972477,1,3,109,0
5732674.0,743,3675,4.946164199192463,2,8,738,5
5735879.0,208,1017,4.889423076923077,3,8,207,1
5744553.0,218,1514,6.944954128440367,2,10,151,67
5745302.0,211,1445,6.848341232227488,2,10,145,66
5748034.0,63,134,2.126984126984127,1,5,63,0
5748366.0,1,2,2.0,2,2,1,0
5748546.0,230,326,1.4173913043478261,1,4,230,0
5749070.0,80,401,5.0125,2,8,79,1
5765659.0,345,2662,7.715942028985507,2,10,137,208
5783504.0,123,592,4.813008130081301,2,7,123,0
5787650.0,105,922,8.780952380952382,2,11,12,93
5788192.0,538,1614,3.0,1,7,538,0
5793527.0,50,387,7.74,3,10,17,33
5817222.0,429,1283,2.9906759906759905,1,6,429,0
5821340.0,175,861,4.92,2,7,175,0
5829509.0,1,3,3.0,3,3,1,0
5829524.0,19,60,3.1578947368421053,1,5,19,0
5836616.0,53,171,3.2264150943396226,1,5,53,0
5846936.0,116,468,4.0344827586206895,1,6,116,0
5847292.0,26,31,1.1923076923076923,1,3,26,0
5847367.0,137,687,5.014598540145985,2,8,135,2
5854074.0,119,1154,9.697478991596638,2,14,9,110
5860795.0,160,324,2.025,1,4,160,0
5872562.0,173,1054,6.092485549132948,2,9,154,19
5876946.0,63,86,1.3650793650793651,1,3,63,0
5879722.0,42,92,2.1904761904761907,1,5,42,0
5897565.0,17,22,1.2941176470588236,1,3,17,0
5917909.0,4,9,2.25,2,3,4,0
5938004.0,51,253,4.96078431372549,2,7,51,0
5943899.0,89,277,3.1123595505617976,1,6,89,0
5952349.0,279,1946,6.974910394265233,3,10,192,87
5962564.0,261,548,2.099616858237548,1,5,261,0
5976224.0,29,35,1.206896551724138,1,2,29,0
5989683.0,66,140,2.121212121212121,1,4,66,0
6008336.0,251,2240,8.92430278884462,2,12,24,227
6021986.0,407,1668,4.098280098280099,2,7,407,0
6027759.0,2,4,2.0,2,2,2,0
6037342.0,34,134,3.9411764705882355,2,6,34,0
6039659.0,201,801,3.985074626865672,1,7,201,0
6041881.0,449,913,2.0334075723830733,1,5,449,0
6042990.0,230,1124,4.886956521739131,2,7,230,0
6064808.0,559,5334,9.542039355992845,2,13,40,519
6067662.0,91,127,1.3956043956043955,1,3,91,0
6067959.0,108,647,5.9907407407407405,2,9,101,7
6069036.0,495,3409,6.886868686868687,2,11,352,143
6070267.0,329,1639,4.981762917933131,2,7,329,0
6083007.0,200,1003,5.015,2,7,200,0
6094591.0,115,997,8.669565217391304,2,11,15,100
6101477.0,567,1172,2.067019400352734,1,5,567,0
6110713.0,19,37,1.9473684210526316,1,4,19,0
6114620.0,272,561,2.0625,1,5,272,0
6123814.0,104,507,4.875,3,7,104,0
6125281.0,366,1797,4.909836065573771,2,8,365,1
6125903.0,166,1136,6.843373493975903,2,10,130,36
6131459.0,23,155,6.739130434782608,4,9,16,7
6145084.0,252,2187,8.678571428571429,2,12,29,223
6148073.0,67,202,3.014925373134328,1,5,67,0
6158230.0,80,164,2.05,1,5,80,0
6159391.0,5,6,1.2,1,2,5,0
6159615.0,12,38,3.1666666666666665,1,5,12,0
6159802.0,17,22,1.2941176470588236,1,3,17,0
6160263.0,56,328,5.857142857142857,2,8,51,5
6161577.0,229,890,3.88646288209607,1,7,229,0
6163186.0,193,385,1.994818652849741,1,5,193,0
6168837.0,171,1523,8.90643274853801,3,11,13,158
6182538.0,139,553,3.9784172661870505,2,7,139,0
6183158.0,303,616,2.033003300330033,1,4,303,0
6188369.0,3,11,3.6666666666666665,2,6,3,0
6193291.0,201,410,2.0398009950248754,1,5,201,0
6194899.0,24,186,7.75,6,10,10,14
6194911.0,110,748,6.8,3,9,81,29
6199834.0,411,1223,2.975669099756691,1,6,411,0
6206946.0,2,4,2.0,1,3,2,0
6215979.0,7,9,1.2857142857142858,1,2,7,0
6222877.0,333,2297,6.897897897897898,2,9,230,103
6229698.0,88,758,8.613636363636363,2,11,11,77
6230119.0,14,112,8.0,6,10,5,9
6233675.0,146,1014,6.945205479452055,2,9,100,46
6238580.0,281,2722,9.686832740213523,3,13,15,266
6240267.0,3,8,2.6666666666666665,2,3,3,0
6241150.0,614,2996,4.879478827361564,2,8,613,1
6241519.0,103,798,7.747572815533981,3,12,38,65
6263965.0,336,1651,4.913690476190476,2,8,334,2
6276040.0,345,3326,9.640579710144927,2,13,23,322
6279864.0,45,236,5.2444444444444445,3,7,45,0
6283743.0,748,4458,5.959893048128342,2,9,703,45
6287069.0,787,4607,5.853875476493012,2,9,747,40
6287397.0,780,1064,1.3641025641025641,1,4,780,0
6299647.0,36,248,6.888888888888889,3,10,24,12
6303708.0,10,30,3.0,2,4,10,0
6307542.0,156,1368,8.76923076923077,2,12,21,135
6312107.0,207,1005,4.855072463768116,2,7,207,0
6332990.0,221,1479,6.6923076923076925,2,9,171,50
6333703.0,89,187,2.101123595505618,1,5,89,0
6343738.0,64,507,7.921875,3,11,23,41
6344685.0,186,383,2.0591397849462365,1,4,186,0
6358574.0,3,14,4.666666666666667,4,5,3,0
6367361.0,8,28,3.5,3,4,8,0
6372321.0,172,1652,9.604651162790697,2,13,8,164
6382107.0,49,109,2.2244897959183674,1,4,49,0
6383348.0,17,131,7.705882352941177,2,9,5,12
6387909.0,356,1403,3.941011235955056,1,7,356,0
6393155.0,45,395,8.777777777777779,3,11,4,41
6396516.0,397,1981,4.98992443324937,2,8,395,2
6397813.0,412,878,2.1310679611650487,1,5,412,0
6402075.0,98,484,4.938775510204081,3,8,97,1
6406712.0,453,1336,2.9492273730684326,1,6,453,0
6410739.0,2,8,4.0,4,4,2,0
6420159.0,99,146,1.4747474747474747,1,4,99,0
6423991.0,2,6,3.0,2,4,2,0
6435818.0,374,2547,6.810160427807487,2,9,262,112
6442730.0,506,1040,2.0553359683794468,1,5,506,0
6444366.0,1,2,2.0,2,2,1,0
6466621.0,161,1127,7.0,2,10,105,56
6468915.0,177,1681,9.497175141242938,2,12,18,159
6470318.0,518,4570,8.822393822393822,2,12,58,460
6477859.0,52,158,3.0384615384615383,1,6,52,0
6485563.0,156,1516,9.717948717948717,3,13,12,144
6485621.0,4,12,3.0,2,4,4,0
6507502.0,385,1874,4.867532467532468,2,8,382,3
6513276.0,436,2144,4.91743119266055,1,8,435,1
6532332.0,411,1647,4.007299270072993,1,8,410,1
6541133.0,40,122,3.05,1,6,40,0
6542642.0,524,2572,4.908396946564886,2,8,522,2
6548167.0,45,103,2.2888888888888888,1,4,45,0
6549680.0,105,715,6.809523809523809,2,10,78,27
6554344.0,105,221,2.104761904761905,1,5,105,0
6557919.0,75,511,6.8133333333333335,2,9,54,21
6563064.0,423,2944,6.959810874704492,2,10,288,135
6564043.0,53,316,5.962264150943396,4,8,50,3
6568756.0,222,1130,5.09009009009009,2,8,221,1
6574016.0,1,3,3.0,3,3,1,0
6599454.0,91,716,7.868131868131868,4,11,31,60
6607202.0,32,38,1.1875,1,2,32,0
6615853.0,237,1204,5.080168776371308,2,8,235,2
6618384.0,151,736,4.874172185430464,2,7,151,0
6621738.0,260,536,2.0615384615384613,1,5,260,0
6633231.0,40,269,6.725,2,9,32,8
6637689.0,748,1032,1.3796791443850267,1,4,748,0
6650003.0,65,133,2.046153846153846,1,4,65,0
6661646.0,336,681,2.0267857142857144,1,5,336,0
6663211.0,45,305,6.777777777777778,3,9,34,11
6670853.0,2,3,1.5,1,2,2,0
6707949.0,206,1001,4.859223300970874,2,7,206,0
6715953.0,153,451,2.947712418300654,1,5,153,0
6719521.0,10,27,2.7,1,5,10,0
6720443.0,654,1373,2.099388379204893,1,5,654,0
6725282.0,59,127,2.152542372881356,1,4,59,0
6725564.0,332,2588,7.795180722891566,2,10,113,219
6765383.0,9,23,2.5555555555555554,2,3,9,0
6769374.0,415,837,2.016867469879518,1,4,415,0
6769979.0,21,56,2.6666666666666665,1,4,21,0
6771783.0,32,44,1.375,1,3,32,0
6816582.0,1,1,1.0,1,1,1,0
6826083.0,241,2367,9.821576763485478,2,13,11,230
6827442.0,562,4934,8.779359430604982,2,11,62,500
6830986.0,286,2793,9.765734265734265,2,12,9,277
6833266.0,88,114,1.2954545454545454,1,3,88,0
6840314.0,43,63,1.4651162790697674,1,4,43,0
6840662.0,7,50,7.142857142857143,6,8,5,2
6850682.0,67,469,7.0,3,10,46,21
6858202.0,380,1877,4.939473684210526,2,8,378,2
6861360.0,330,2556,7.745454545454545,2,11,121,209
6867439.0,1,3,3.0,3,3,1,0
6875721.0,25,199,7.96,4,11,9,16
6881456.0,187,1587,8.48663101604278,2,12,32,155
6885070.0,9,20,2.2222222222222223,1,3,9,0
6899760.0,567,2815,4.964726631393298,2,8,564,3
6906836.0,39,338,8.666666666666666,5,11,4,35
6908609.0,457,2231,4.8818380743982495,2,8,453,4
6910714.0,115,776,6.747826086956522,2,10,81,34
6933109.0,225,449,1.9955555555555555,1,4,225,0
6933242.0,183,1778,9.71584699453552,3,13,8,175
6957018.0,112,153,1.3660714285714286,1,3,112,0
6961269.0,658,4534,6.890577507598784,2,10,455,203
6969504.0,17,49,2.8823529411764706,1,4,17,0
6971162.0,506,3468,6.853754940711463,2,10,358,148
6982366.0,17,57,3.3529411764705883,1,5,17,0
6982668.0,49,61,1.2448979591836735,1,2,49,0
6985914.0,196,1690,8.622448979591837,2,12,24,172
6991988.0,29,239,8.241379310344827,7,11,8,21
6999084.0,54,154,2.8518518518518516,1,5,54,0
7010582.0,136,182,1.338235294117647,1,3,136,0
7012659.0,60,125,2.0833333333333335,1,4,60,0
7013090.0,39,87,2.230769230769231,1,4,39,0
7014889.0,274,563,2.0547445255474455,1,5,274,0
7014906.0,37,255,6.891891891891892,4,9,30,7
7015202.0,47,93,1.9787234042553192,1,5,47,0
7015422.0,1,8,8.0,8,8,0,1
7015650.0,3,20,6.666666666666667,6,8,2,1
7017814.0,5,8,1.6,1,2,5,0
7020500.0,76,149,1.9605263157894737,1,4,76,0
7028912.0,198,271,1.3686868686868687,1,4,198,0
7041758.0,1,2,2.0,2,2,1,0
7047537.0,73,156,2.136986301369863,1,4,73,0
7061159.0,57,218,3.824561403508772,1,6,57,0
7069975.0,32,44,1.375,1,3,32,0
7070725.0,6,7,1.1666666666666667,1,2,6,0
7072197.0,54,234,4.333333333333333,2,7,54,0
7108690.0,20,59,2.95,2,4,20,0
7111834.0,200,1756,8.78,2,12,22,178
7119614.0,79,109,1.379746835443038,1,3,79,0
7120227.0,189,1629,8.619047619047619,2,11,27,162
7143136.0,116,458,3.9482758620689653,2,6,116,0
7143210.0,327,2862,8.752293577981652,2,12,46,281
7148125.0,15,25,1.6666666666666667,1,3,15,0
7168023.0,12,51,4.25,2,6,12,0
7169803.0,5,10,2.0,1,3,5,0
7174517.0,3,3,1.0,1,1,3,0
7185251.0,4,6,1.5,1,2,4,0
7195684.0,3,7,2.3333333333333335,2,3,3,0
7201076.0,514,1052,2.046692607003891,1,6,514,0
7204039.0,167,367,2.197604790419162,1,5,167,0
7209432.0,18,55,3.0555555555555554,1,5,18,0
7211619.0,34,82,2.411764705882353,1,6,34,0
7214366.0,726,1519,2.0922865013774103,1,5,726,0
7214749.0,174,1507,8.660919540229886,2,12,24,150
7233990.0,162,341,2.1049382716049383,1,5,162,0
7252091.0,97,377,3.88659793814433,2,6,97,0
7257713.0,39,279,7.153846153846154,4,9,25,14
7275493.0,9,18,2.0,1,4,9,0
7278537.0,51,439,8.607843137254902,2,11,6,45
7285676.0,355,1050,2.9577464788732395,1,6,355,0
7291511.0,1,3,3.0,3,3,1,0
7299665.0,44,387,8.795454545454545,3,11,5,39
7300168.0,137,274,2.0,1,4,137,0
7314378.0,287,1152,4.013937282229965,1,7,287,0
7334350.0,175,1201,6.862857142857143,2,9,119,56
7334578.0,31,86,2.774193548387097,1,5,31,0
7343758.0,114,554,4.859649122807017,2,7,114,0
7346971.0,1,2,2.0,2,2,1,0
7352618.0,159,1108,6.968553459119497,2,11,101,58
7353011.0,4,28,7.0,5,8,2,2
7359580.0,107,225,2.102803738317757,1,5,107,0
7359826.0,24,47,1.9583333333333333,1,3,24,0
7362688.0,5,11,2.2,1,4,5,0
7379890.0,18,29,1.6111111111111112,1,3,18,0
7397805.0,1,3,3.0,3,3,1,0
7406773.0,5,16,3.2,2,4,5,0
7417715.0,32,255,7.96875,6,10,14,18
7427956.0,2,2,1.0,1,1,2,0
7432987.0,389,793,2.038560411311054,1,5,389,0
7434672.0,662,5865,8.859516616314199,2,12,72,590
7445971.0,32,180,5.625,4,8,31,1
7453640.0,261,1325,5.076628352490421,2,8,257,4
7457792.0,30,225,7.5,3,10,14,16
7465105.0,422,871,2.0639810426540284,1,5,422,0
7479982.0,150,1003,6.6866666666666665,2,9,116,34
7487035.0,5,14,2.8,1,4,5,0
7496237.0,89,767,8.617977528089888,2,12,17,72
7497713.0,737,1036,1.4056987788331072,1,4,737,0
7505759.0,7,11,1.5714285714285714,1,2,7,0
7506567.0,94,280,2.978723404255319,1,5,94,0
7512486.0,161,318,1.9751552795031055,1,4,161,0
7547992.0,280,582,2.0785714285714287,1,5,280,0
7559058.0,561,4369,7.787878787878788,2,11,195,366
7571127.0,520,2104,4.046153846153846,1,7,520,0
7582198.0,211,1432,6.786729857819905,2,10,155,56
7598513.0,7,18,2.5714285714285716,2,4,7,0
7606746.0,57,137,2.4035087719298245,1,5,57,0
7624956.0,9,11,1.2222222222222223,1,2,9,0
7629370.0,22,100,4.545454545454546,3,6,22,0
7629943.0,129,524,4.062015503875969,2,7,129,0
7641247.0,306,2136,6.980392156862745,2,10,208,98
7641420.0,399,2772,6.947368421052632,3,10,270,129
7650492.0,8,29,3.625,2,5,8,0
7659665.0,67,195,2.91044776119403,1,5,67,0
7660473.0,207,2026,9.78743961352657,3,13,12,195
7660689.0,233,1151,4.939914163090129,2,8,232,1
7668220.0,48,98,2.0416666666666665,1,4,48,0
7673910.0,8,47,5.875,3,7,8,0
7677127.0,31,214,6.903225806451613,3,9,20,11
7685623.0,15,28,1.8666666666666667,1,3,15,0
7689476.0,721,1027,1.4244105409153953,1,5,721,0
7691143.0,520,4996,9.607692307692307,2,12,38,482
7691488.0,94,207,2.202127659574468,1,4,94,0
7695434.0,73,105,1.4383561643835616,1,4,73,0
7695494.0,14,19,1.3571428571428572,1,3,14,0
7701883.0,276,603,2.1847826086956523,1,5,276,0
7723765.0,181,913,5.044198895027624,2,7,181,0
7727522.0,11,18,1.6363636363636365,1,3,11,0
7730071.0,115,225,1.9565217391304348,1,4,115,0
7731909.0,152,588,3.8684210526315788,2,7,152,0
7732757.0,354,729,2.059322033898305,1,5,354,0
7740638.0,36,143,3.9722222222222223,2,6,36,0
7745816.0,6,8,1.3333333333333333,1,2,6,0
7753419.0,47,137,2.9148936170212765,1,5,47,0
7770648.0,457,968,2.1181619256017505,1,5,457,0
7783777.0,959,3813,3.9760166840458813,1,7,959,0
7786679.0,70,91,1.3,1,4,70,0
7795852.0,55,125,2.272727272727273,1,5,55,0
7797002.0,4,5,1.25,1,2,4,0
7806633.0,25,167,6.68,5,9,21,4
7812224.0,59,131,2.2203389830508473,1,5,59,0
7812823.0,180,872,4.844444444444444,2,8,178,2
7813405.0,278,854,3.0719424460431655,1,6,278,0
7818234.0,239,1637,6.849372384937238,2,10,166,73
7822974.0,60,234,3.9,2,6,60,0
7834234.0,6,10,1.6666666666666667,1,3,6,0
7841877.0,315,2782,8.831746031746032,2,12,33,282
7845373.0,171,514,3.0058479532163744,1,5,171,0
7847068.0,330,696,2.109090909090909,1,5,330,0
7851316.0,290,897,3.093103448275862,1,6,290,0
7855175.0,4,11,2.75,2,3,4,0
7855853.0,1,2,2.0,2,2,1,0
7859388.0,456,3182,6.978070175438597,2,10,306,150
7864511.0,192,1328,6.916666666666667,2,9,135,57
7871285.0,331,2550,7.7039274924471295,2,10,126,205
7897158.0,364,2153,5.914835164835165,2,9,342,22
7899729.0,2,3,1.5,1,2,2,0
7907302.0,10,28,2.8,2,4,10,0
7952687.0,31,90,2.903225806451613,1,4,31,0
7977144.0,19,173,9.105263157894736,6,11,2,17
7994589.0,27,63,2.3333333333333335,1,4,27,0
8024476.0,294,610,2.074829931972789,1,4,294,0
8026146.0,107,830,7.757009345794392,2,10,37,70
8026892.0,390,1947,4.992307692307692,2,8,388,2
8029633.0,16,105,6.5625,5,9,12,4
8055704.0,450,624,1.3866666666666667,1,4,450,0
8056019.0,6,16,2.6666666666666665,1,6,6,0
8056210.0,210,827,3.9380952380952383,1,7,210,0
8062212.0,568,2245,3.9524647887323945,1,7,568,0
8068242.0,7,21,3.0,2,4,7,0
8075920.0,12,24,2.0,1,3,12,0
8077894.0,327,1280,3.914373088685015,1,7,327,0
8078020.0,20,42,2.1,1,4,20,0
8088759.0,1,4,4.0,4,4,1,0
8111201.0,14,94,6.714285714285714,5,9,11,3
8123562.0,6,17,2.8333333333333335,1,4,6,0
8128423.0,211,852,4.037914691943128,1,7,211,0
8137242.0,446,3918,8.784753363228699,2,12,52,394
8147896.0,212,2079,9.806603773584905,2,13,7,205
8150001.0,475,973,2.048421052631579,1,5,475,0
8155821.0,118,253,2.1440677966101696,1,5,118,0
8158709.0,284,1395,4.911971830985915,2,8,283,1
8163154.0,10,21,2.1,1,3,10,0
8165824.0,66,574,8.696969696969697,2,12,8,58
8171420.0,21,194,9.238095238095237,7,11,1,20
8179336.0,322,2204,6.84472049689441,2,10,230,92
8201621.0,7,13,1.8571428571428572,1,4,7,0
8202660.0,24,101,4.208333333333333,3,6,24,0
8203469.0,4,5,1.25,1,2,4,0
8221248.0,168,839,4.994047619047619,2,8,167,1
8231834.0,23,38,1.6521739130434783,1,3,23,0
8231932.0,41,78,1.9024390243902438,1,4,41,0
8247865.0,59,478,8.101694915254237,4,10,10,49
8267919.0,59,394,6.677966101694915,2,9,45,14
8271858.0,5,7,1.4,1,3,5,0
8310672.0,142,423,2.9788732394366195,1,6,142,0
8322450.0,84,811,9.654761904761905,2,12,5,79
8325731.0,70,343,4.9,2,7,70,0
8331406.0,144,704,4.888888888888889,1,8,142,2
8345256.0,47,143,3.0425531914893615,1,6,47,0
8350653.0,338,480,1.4201183431952662,1,4,338,0
8356032.0,1,1,1.0,1,1,1,0
8368543.0,55,126,2.290909090909091,1,5,55,0
8385825.0,289,398,1.3771626297577855,1,4,289,0
8389063.0,30,80,2.6666666666666665,1,6,30,0
8394827.0,343,712,2.075801749271137,1,5,343,0
8394957.0,415,3679,8.865060240963855,2,12,49,366
8399290.0,443,2208,4.984198645598194,2,8,441,2
8418514.0,226,1965,8.694690265486726,2,11,30,196
8422607.0,279,1923,6.89247311827957,3,10,198,81
8438464.0,187,1632,8.727272727272727,2,12,25,162
8454596.0,135,523,3.8740740740740742,2,7,135,0
8455978.0,89,185,2.0786516853932584,1,4,89,0
8469941.0,139,704,5.0647482014388485,2,8,138,1
8470560.0,134,280,2.08955223880597,1,4,134,0
8470935.0,218,1505,6.9036697247706424,2,10,148,70
8498718.0,94,464,4.9361702127659575,2,7,94,0
8517585.0,329,1610,4.8936170212765955,2,7,329,0
8519462.0,3,6,2.0,1,3,3,0
8520533.0,9,20,2.2222222222222223,1,4,9,0
8528953.0,76,366,4.815789473684211,2,7,76,0
8546315.0,356,3466,9.735955056179776,2,13,20,336
8549390.0,14,31,2.2142857142857144,1,4,14,0
8550478.0,458,1386,3.0262008733624453,1,6,458,0
8551279.0,180,247,1.3722222222222222,1,4,180,0
8563507.0,37,101,2.72972972972973,1,4,37,0
8567406.0,303,2360,7.788778877887789,3,11,115,188
8569433.0,124,482,3.8870967741935485,2,6,124,0
8574490.0,108,427,3.9537037037037037,1,6,108,0
8579373.0,433,916,2.115473441108545,1,5,433,0
8592552.0,2,6,3.0,3,3,2,0
8594460.0,145,1298,8.951724137931034,3,12,9,136
8607519.0,318,1874,5.8930817610062896,2,8,302,16
8627059.0,284,1376,4.845070422535211,2,8,283,1
8627585.0,99,128,1.292929292929293,1,3,99,0
8634850.0,127,520,4.094488188976378,2,7,127,0
8641766.0,122,962,7.885245901639344,2,11,40,82
8652516.0,131,934,7.129770992366412,3,10,81,50
8657610.0,37,369,9.972972972972974,8,12,0,37
8657858.0,143,448,3.132867132867133,1,6,143,0
8663494.0,168,824,4.904761904761905,2,7,168,0
8666776.0,173,1496,8.647398843930636,2,11,19,154
8668278.0,457,3110,6.805251641137856,2,10,337,120
8678502.0,30,67,2.2333333333333334,1,5,30,0
8695926.0,137,698,5.094890510948905,2,7,137,0
8708735.0,67,136,2.029850746268657,1,5,67,0
8713274.0,73,221,3.0273972602739727,1,5,73,0
8719352.0,337,1308,3.8813056379821957,1,7,337,0
8728948.0,297,2609,8.784511784511784,2,11,25,272
8740647.0,186,921,4.951612903225806,2,7,186,0
8752740.0,73,627,8.58904109589041,3,11,10,63
8755195.0,148,321,2.168918918918919,1,5,148,0
8755504.0,248,2166,8.733870967741936,2,12,27,221
8767366.0,372,2898,7.790322580645161,2,11,141,231
8768739.0,35,94,2.6857142857142855,1,5,35,0
8769145.0,289,2465,8.529411764705882,2,12,47,242
8804545.0,74,508,6.864864864864865,2,9,49,25
8806684.0,113,1096,9.699115044247788,3,13,6,107
8811202.0,128,253,1.9765625,1,5,128,0
8824752.0,296,2063,6.969594594594595,2,9,198,98
8838482.0,26,29,1.1153846153846154,1,2,26,0
8844082.0,321,993,3.0934579439252334,1,7,321,0
8857122.0,84,567,6.75,2,10,59,25
8858054.0,38,118,3.1052631578947367,1,5,38,0
8881201.0,5,13,2.6,1,4,5,0
8881869.0,318,2187,6.877358490566038,2,10,224,94
8883924.0,384,2644,6.885416666666667,2,9,284,100
8893602.0,230,1137,4.943478260869565,2,8,226,4
8894850.0,212,1062,5.009433962264151,2,8,210,2
8895560.0,101,719,7.118811881188119,4,10,67,34
8895796.0,46,176,3.8260869565217392,2,6,46,0
8902683.0,17,33,1.9411764705882353,1,4,17,0
8902895.0,27,191,7.074074074074074,5,9,19,8
8904822.0,76,716,9.421052631578947,2,12,9,67
8907994.0,339,3335,9.837758112094395,2,13,13,326
8914957.0,159,801,5.037735849056604,2,8,158,1
8915060.0,3,8,2.6666666666666665,2,3,3,0
8919942.0,224,1529,6.825892857142857,2,10,166,58
8928899.0,14,20,1.4285714285714286,1,3,14,0
8931977.0,93,465,5.0,2,7,93,0
8938319.0,15,120,8.0,7,9,5,10
8946786.0,73,235,3.219178082191781,1,5,73,0
8965165.0,54,103,1.9074074074074074,1,4,54,0
8966105.0,94,264,2.8085106382978724,1,5,94,0
8975384.0,258,1020,3.953488372093023,1,6,258,0
8979120.0,24,35,1.4583333333333333,1,4,24,0
8982912.0,126,385,3.0555555555555554,1,6,126,0
8999236.0,123,1201,9.764227642276422,5,12,8,115
9002603.0,3,5,1.6666666666666667,1,2,3,0
9017416.0,1,4,4.0,4,4,1,0
9045230.0,478,2391,5.002092050209205,2,8,474,4
9084945.0,5,11,2.2,1,4,5,0
9087646.0,572,5585,9.763986013986013,2,13,27,545
9108730.0,32,215,6.71875,2,9,22,10
9109924.0,4,8,2.0,1,3,4,0
9113325.0,277,2153,7.772563176895307,3,10,101,176
9127476.0,170,358,2.1058823529411765,1,5,170,0
9128910.0,908,1900,2.092511013215859,1,5,908,0
9141653.0,535,2663,4.977570093457944,2,8,534,1
9142639.0,1,2,2.0,2,2,1,0
9150620.0,17,33,1.9411764705882353,1,5,17,0
9163023.0,59,124,2.1016949152542375,1,4,59,0
9176077.0,23,161,7.0,5,8,17,6
9177813.0,10,28,2.8,2,4,10,0
9178630.0,38,287,7.552631578947368,3,11,14,24
9182042.0,443,925,2.0880361173814896,1,5,443,0
9203875.0,252,2422,9.61111111111111,2,13,14,238
9204879.0,8,18,2.25,1,4,8,0
9206258.0,342,2365,6.915204678362573,2,10,235,107
9206552.0,172,880,5.116279069767442,3,8,170,2
9206737.0,19,55,2.8947368421052633,2,4,19,0
9209376.0,313,2736,8.741214057507987,2,12,36,277
9209461.0,17,136,8.0,6,9,4,13
9212877.0,142,943,6.640845070422535,2,9,104,38
9215075.0,161,488,3.031055900621118,1,6,161,0
9236168.0,185,1624,8.778378378378378,3,11,21,164
9268665.0,17,44,2.588235294117647,1,4,17,0
9274906.0,29,52,1.793103448275862,1,3,29,0
9290081.0,312,1533,4.913461538461538,2,8,310,2
9291794.0,367,742,2.0217983651226157,1,4,367,0
9291989.0,690,6108,8.852173913043478,2,12,79,611
9294088.0,181,891,4.922651933701657,2,7,181,0
9310534.0,135,666,4.933333333333334,2,7,135,0
9322148.0,149,733,4.919463087248322,2,7,149,0
9324140.0,322,1584,4.919254658385094,2,8,321,1
9337716.0,685,4716,6.884671532846715,2,10,490,195
9365719.0,502,3948,7.864541832669323,2,11,155,347
9380659.0,10,29,2.9,1,4,10,0
9385154.0,628,3136,4.993630573248407,2,9,620,8
9408050.0,24,171,7.125,5,9,14,10
9421378.0,144,195,1.3541666666666667,1,3,144,0
9428334.0,513,1042,2.0311890838206628,1,5,513,0
9446656.0,272,1087,3.9963235294117645,1,7,272,0
9447094.0,471,2319,4.923566878980892,1,8,470,1
9454217.0,104,405,3.894230769230769,2,6,104,0
9460773.0,309,2101,6.799352750809062,2,10,213,96
9471586.0,567,5481,9.666666666666666,2,13,35,532
9473403.0,78,226,2.8974358974358974,1,5,78,0
9473474.0,78,246,3.1538461538461537,1,6,78,0
9477197.0,310,901,2.9064516129032256,1,6,310,0
9486927.0,7,12,1.7142857142857142,1,3,7,0
9487802.0,19,59,3.1052631578947367,1,5,19,0
9489398.0,163,506,3.104294478527607,1,6,163,0
9493091.0,89,422,4.741573033707865,1,7,89,0
9504207.0,46,88,1.9130434782608696,1,4,46,0
9504857.0,152,753,4.953947368421052,2,8,151,1
9506096.0,180,688,3.8222222222222224,1,7,180,0
9510598.0,135,658,4.874074074074074,2,7,135,0
9525227.0,105,525,5.0,2,7,105,0
9537747.0,738,4353,5.8983739837398375,2,9,685,53
9541663.0,148,723,4.885135135135135,2,8,147,1
9548700.0,79,383,4.848101265822785,2,7,79,0
9548843.0,244,1197,4.905737704918033,1,8,243,1
9549784.0,448,3903,8.712053571428571,2,12,55,393
9575680.0,153,1471,9.61437908496732,2,12,10,143
9581698.0,231,1596,6.909090909090909,2,9,165,66
9600924.0,331,2944,8.894259818731118,2,13,31,300
9606598.0,238,703,2.953781512605042,1,5,238,0
9608049.0,80,237,2.9625,1,5,80,0
9608728.0,8,9,1.125,1,2,8,0
9609003.0,54,163,3.0185185185185186,2,5,54,0
9619045.0,75,209,2.7866666666666666,1,5,75,0
9639977.0,138,679,4.920289855072464,2,7,138,0
9642700.0,420,871,2.073809523809524,1,5,420,0
9643833.0,4,22,5.5,4,6,4,0
9646543.0,138,278,2.0144927536231885,1,4,138,0
9658630.0,16,20,1.25,1,3,16,0
9659461.0,488,1435,2.9405737704918034,1,6,488,0
9666029.0,179,1730,9.664804469273744,2,13,11,168
9708445.0,493,4251,8.622718052738337,2,12,67,426
9711346.0,388,1130,2.9123711340206184,1,6,388,0
9718738.0,413,3984,9.646489104116222,2,13,26,387
9721913.0,409,1632,3.9902200488997557,1,7,409,0
9722861.0,266,371,1.394736842105263,1,4,266,0
9733941.0,4,11,2.75,2,4,4,0
9745267.0,81,473,5.839506172839506,2,9,76,5
9746164.0,166,1578,9.506024096385541,2,13,14,152
9752728.0,120,599,4.991666666666666,2,7,120,0
9753808.0,1,1,1.0,1,1,1,0
9767399.0,460,2287,4.971739130434782,2,8,457,3
9767406.0,333,1295,3.888888888888889,1,7,333,0
9770085.0,248,1244,5.016129032258065,2,8,247,1
9770854.0,251,2416,9.625498007968128,2,12,12,239
9774594.0,134,403,3.0074626865671643,1,6,134,0
9798653.0,225,890,3.9555555555555557,1,7,225,0
9800010.0,1,1,1.0,1,1,1,0
9804644.0,2,7,3.5,3,4,2,0
9808033.0,112,435,3.8839285714285716,2,7,112,0
9811609.0,510,1080,2.1176470588235294,1,5,510,0
9830513.0,133,412,3.0977443609022557,1,5,133,0
9833524.0,10,17,1.7,1,3,10,0
9844087.0,150,746,4.973333333333334,2,8,147,3
9851949.0,106,427,4.028301886792453,1,7,106,0
9861979.0,137,1341,9.788321167883211,2,13,6,131
9862245.0,204,1382,6.7745098039215685,2,10,142,62
9876310.0,429,3783,8.818181818181818,2,12,41,388
9877244.0,373,755,2.0241286863270775,1,5,373,0
9880406.0,251,1204,4.796812749003984,2,7,251,0
9883101.0,422,867,2.0545023696682465,1,4,422,0
9883116.0,2,7,3.5,2,5,2,0
9894564.0,2,4,2.0,2,2,2,0
9894805.0,13,26,2.0,1,4,13,0
9911639.0,30,60,2.0,1,3,30,0
9935338.0,21,61,2.9047619047619047,2,4,21,0
9940226.0,454,957,2.107929515418502,1,5,454,0
9941810.0,6,12,2.0,1,4,6,0
9948875.0,111,560,5.045045045045045,3,7,111,0
9958511.0,253,1254,4.956521739130435,2,8,251,2
9959387.0,556,2774,4.989208633093525,2,8,552,4
9965402.0,230,1128,4.904347826086957,2,7,230,0
9970367.0,108,544,5.037037037037037,2,7,108,0
9974417.0,182,572,3.142857142857143,1,6,182,0
9977208.0,145,560,3.8620689655172415,2,7,145,0
9982157.0,435,2986,6.864367816091954,2,10,309,126
9982683.0,426,3720,8.732394366197184,2,12,51,375
10005860.0,131,273,2.0839694656488548,1,5,131,0
10008553.0,240,500,2.0833333333333335,1,5,240,0
10017799.0,12,85,7.083333333333333,6,9,8,4
10027906.0,151,321,2.1258278145695364,1,5,151,0
10045648.0,258,2498,9.682170542635658,2,12,18,240
10048277.0,131,521,3.9770992366412212,1,7,131,0
10052073.0,105,318,3.0285714285714285,1,5,105,0
10070266.0,7,16,2.2857142857142856,1,3,7,0
10081378.0,12,83,6.916666666666667,5,8,9,3
10127086.0,56,174,3.107142857142857,1,6,56,0
10130390.0,342,1392,4.0701754385964914,1,7,342,0
10130785.0,406,2806,6.911330049261084,2,10,275,131
10144509.0,18,155,8.61111111111111,4,11,3,15
10175363.0,441,1275,2.891156462585034,1,6,441,0
10188217.0,60,461,7.683333333333334,2,11,24,36
10188918.0,143,719,5.027972027972028,2,8,142,1
10192147.0,181,1584,8.751381215469614,2,12,25,156
10201245.0,1,3,3.0,3,3,1,0
10238470.0,64,140,2.1875,1,5,64,0
10257772.0,39,195,5.0,3,7,39,0
10271608.0,495,2453,4.955555555555556,2,8,493,2
10275785.0,6,27,4.5,3,6,6,0
10277662.0,4,15,3.75,3,4,4,0
10286663.0,132,1294,9.803030303030303,2,12,3,129
10292503.0,217,653,3.0092165898617513,1,6,217,0
10307340.0,36,181,5.027777777777778,2,7,36,0
10311386.0,30,121,4.033333333333333,2,6,30,0
10325584.0,43,419,9.744186046511627,3,12,2,41
10326736.0,126,1105,8.76984126984127,2,11,13,113
10327338.0,155,1054,6.8,2,9,108,47
10349116.0,487,3806,7.815195071868583,2,11,166,321
10354786.0,368,1779,4.834239130434782,2,7,368,0
10362376.0,238,715,3.004201680672269,1,7,238,0
10374154.0,213,1665,7.816901408450704,2,11,75,138
10374268.0,79,112,1.4177215189873418,1,3,79,0
10382889.0,5,44,8.8,8,10,0,5
10396549.0,382,777,2.0340314136125652,1,5,382,0
10396624.0,359,2474,6.891364902506964,2,10,244,115
10398681.0,2,2,1.0,1,1,2,0
10400201.0,653,1996,3.0566615620214397,1,6,653,0
10409426.0,65,550,8.461538461538462,2,12,8,57
10410002.0,101,140,1.386138613861386,1,3,101,0
10445067.0,194,1341,6.912371134020619,2,10,134,60
10447814.0,149,302,2.0268456375838926,1,5,149,0
10464745.0,467,4067,8.708779443254818,2,12,57,410
10465938.0,64,245,3.828125,2,6,64,0
10473625.0,127,1204,9.48031496062992,2,13,11,116
10482630.0,22,110,5.0,2,6,22,0
10484025.0,94,465,4.946808510638298,2,7,94,0
10488687.0,24,50,2.0833333333333335,1,4,24,0
10490005.0,22,39,1.7727272727272727,1,3,22,0
10492944.0,26,78,3.0,2,5,26,0
10493296.0,26,56,2.1538461538461537,1,4,26,0
10509732.0,2,7,3.5,3,4,2,0
10511300.0,219,1940,8.858447488584474,2,12,19,200
10513581.0,4,22,5.5,5,7,4,0
10524194.0,207,2009,9.705314009661835,2,13,13,194
10536601.0,12,23,1.9166666666666667,1,3,12,0
10539504.0,11,14,1.2727272727272727,1,4,11,0
10543466.0,192,591,3.078125,1,5,192,0
10563232.0,32,58,1.8125,1,4,32,0
10579286.0,356,1792,5.033707865168539,2,8,355,1
10586228.0,5,11,2.2,1,3,5,0
10586558.0,7,59,8.428571428571429,7,10,1,6
10588092.0,104,207,1.9903846153846154,1,5,104,0
10594739.0,27,82,3.037037037037037,1,6,27,0
10603975.0,401,3844,9.586034912718205,2,13,33,368
10640179.0,109,147,1.348623853211009,1,4,109,0
10654958.0,36,68,1.8888888888888888,1,4,36,0
10673551.0,79,234,2.962025316455696,1,5,79,0
10676283.0,695,1421,2.0446043165467627,1,5,695,0
10676887.0,169,1138,6.733727810650888,2,9,123,46
10677284.0,573,1219,2.1273996509598603,1,6,573,0
10681179.0,189,381,2.015873015873016,1,5,189,0
10681391.0,13,81,6.230769230769231,3,8,12,1
10692450.0,190,1829,9.626315789473685,2,13,12,178
10694787.0,78,105,1.3461538461538463,1,3,78,0
10699150.0,63,79,1.253968253968254,1,3,63,0
10699176.0,131,1151,8.786259541984732,2,12,11,120
10722467.0,202,809,4.0049504950495045,1,7,202,0
10751436.0,24,123,5.125,3,7,24,0
10764720.0,49,69,1.4081632653061225,1,3,49,0
10778858.0,7,60,8.571428571428571,7,10,1,6
10789641.0,133,519,3.9022556390977443,2,6,133,0
10806105.0,244,2135,8.75,2,12,34,210
10807501.0,65,127,1.9538461538461538,1,4,65,0
10808869.0,2,12,6.0,5,7,2,0
10817455.0,70,342,4.885714285714286,2,7,70,0
10848457.0,333,694,2.084084084084084,1,6,333,0
10849742.0,189,1818,9.619047619047619,2,13,12,177
10854277.0,33,67,2.0303030303030303,1,5,33,0
10854901.0,33,77,2.3333333333333335,1,4,33,0
10855140.0,61,131,2.1475409836065573,1,4,61,0
10855267.0,26,55,2.1153846153846154,1,4,26,0
10865731.0,166,1134,6.831325301204819,2,10,115,51
10871793.0,280,876,3.1285714285714286,1,6,280,0
10890756.0,324,2207,6.811728395061729,2,10,226,98
10898803.0,690,3445,4.992753623188406,2,8,686,4
10899865.0,123,162,1.3170731707317074,1,4,123,0
10913494.0,2,5,2.5,2,3,2,0
10913564.0,1,5,5.0,5,5,1,0
10913935.0,4,7,1.75,1,2,4,0
10914136.0,3,5,1.6666666666666667,1,3,3,0
10914190.0,2,4,2.0,1,3,2,0
10914226.0,3,4,1.3333333333333333,1,2,3,0
10914345.0,5,10,2.0,1,3,5,0
10916521.0,153,590,3.8562091503267975,1,6,153,0
10926925.0,39,351,9.0,6,12,3,36
10960810.0,2,2,1.0,1,1,2,0
10988872.0,38,182,4.7894736842105265,3,7,38,0
10989934.0,295,1508,5.111864406779661,2,8,294,1
11001575.0,179,724,4.044692737430168,1,7,179,0
11003874.0,31,39,1.2580645161290323,1,3,31,0
11028671.0,216,882,4.083333333333333,1,7,216,0
11036538.0,302,2917,9.658940397350994,2,12,17,285
11049959.0,7,13,1.8571428571428572,1,3,7,0
11052224.0,219,456,2.0821917808219177,1,5,219,0
11054582.0,243,998,4.106995884773663,1,7,243,0
11056834.0,277,606,2.187725631768953,1,5,277,0
11077428.0,320,698,2.18125,1,5,320,0
11079684.0,142,194,1.3661971830985915,1,4,142,0
11101932.0,15,48,3.2,2,5,15,0
11101978.0,206,985,4.781553398058253,2,8,205,1
11102304.0,7,53,7.571428571428571,7,8,3,4
11107198.0,167,1645,9.850299401197605,2,12,6,161
11111075.0,142,692,4.873239436619718,2,8,140,2
11112289.0,313,969,3.0958466453674123,1,6,313,0
11112633.0,2,2,1.0,1,1,2,0
11112982.0,129,1125,8.720930232558139,2,11,10,119
11132020.0,10,23,2.3,1,4,10,0
11136190.0,167,1292,7.736526946107785,2,11,55,112
11137204.0,626,3088,4.932907348242812,2,9,621,5
11141442.0,8,52,6.5,3,8,6,2
11146161.0,371,1468,3.9568733153638815,1,7,371,0
11152505.0,171,827,4.83625730994152,2,8,170,1
11159527.0,52,112,2.1538461538461537,1,5,52,0
11167872.0,22,150,6.818181818181818,5,9,18,4
11195878.0,208,849,4.081730769230769,2,7,208,0
11203682.0,3,8,2.6666666666666665,2,3,3,0
11205538.0,232,1140,4.913793103448276,2,7,232,0
11209161.0,354,2789,7.878531073446328,2,11,112,242
11216715.0,230,933,4.056521739130435,1,7,230,0
11236137.0,59,277,4.694915254237288,2,7,59,0
11240529.0,201,1184,5.890547263681592,3,8,194,7
11248646.0,163,977,5.993865030674846,2,8,150,13
11251920.0,152,908,5.973684210526316,2,9,144,8
11251956.0,171,1020,5.964912280701754,2,9,161,10
11260503.0,185,738,3.9891891891891893,1,6,185,0
11272735.0,249,2149,8.630522088353414,2,12,32,217
11275057.0,270,1071,3.966666666666667,1,7,270,0
11286775.0,464,2222,4.788793103448276,2,8,462,2
11291438.0,427,885,2.072599531615925,1,5,427,0
11311237.0,305,1508,4.944262295081967,2,8,304,1
11312612.0,263,1326,5.0418250950570345,2,8,262,1
11313107.0,398,858,2.1557788944723617,1,5,398,0
11319108.0,8,28,3.5,2,4,8,0
11338228.0,13,71,5.461538461538462,4,7,13,0
11349671.0,1,8,8.0,8,8,0,1
11365268.0,89,117,1.3146067415730338,1,4,89,0
11375664.0,2,6,3.0,3,3,2,0
11381729.0,241,346,1.4356846473029046,1,4,241,0
11383704.0,2,5,2.5,2,3,2,0
11386800.0,19,25,1.3157894736842106,1,2,19,0
11389273.0,200,1005,5.025,2,7,200,0
11395168.0,10,28,2.8,1,4,10,0
11403148.0,475,4639,9.766315789473683,2,13,27,448
11403317.0,74,235,3.175675675675676,1,6,74,0
11412697.0,64,450,7.03125,2,9,41,23
11426903.0,14,26,1.8571428571428572,1,3,14,0
11429939.0,32,62,1.9375,1,4,32,0
11431074.0,124,1061,8.556451612903226,2,12,24,100
11431731.0,42,86,2.0476190476190474,1,5,42,0
11435882.0,222,1082,4.873873873873874,2,8,220,2
11438317.0,17,126,7.411764705882353,6,10,10,7
11438763.0,5,14,2.8,2,5,5,0
11439210.0,9,22,2.4444444444444446,1,4,9,0
11439843.0,27,108,4.0,2,6,27,0
11447114.0,25,52,2.08,1,4,25,0
11447315.0,38,81,2.1315789473684212,1,4,38,0
11447914.0,5,14,2.8,1,4,5,0
11452943.0,10,24,2.4,1,4,10,0
11455398.0,94,180,1.9148936170212767,1,3,94,0
11456350.0,189,1789,9.465608465608465,2,12,14,175
11458328.0,246,1198,4.869918699186992,2,7,246,0
11459814.0,55,278,5.054545454545455,2,7,55,0
11477359.0,251,2413,9.613545816733067,2,12,14,237
11490064.0,303,636,2.099009900990099,1,5,303,0
11490939.0,405,836,2.0641975308641975,1,6,405,0
11496032.0,90,630,7.0,4,10,66,24
11499830.0,396,3901,9.8510101010101,2,13,16,380
11504109.0,45,57,1.2666666666666666,1,3,45,0
11505677.0,5,12,2.4,1,4,5,0
11536525.0,51,106,2.0784313725490198,1,4,51,0
11538250.0,73,500,6.8493150684931505,5,9,51,22
11542772.0,6,12,2.0,1,4,6,0
11549545.0,18,34,1.8888888888888888,1,3,18,0
11550179.0,6,12,2.0,1,3,6,0
11559470.0,12,39,3.25,2,5,12,0
11559474.0,3,3,1.0,1,1,3,0
11559952.0,279,2645,9.480286738351255,2,12,18,261
11559962.0,23,51,2.217391304347826,1,4,23,0
11562618.0,5,17,3.4,2,4,5,0
11563903.0,3,7,2.3333333333333335,2,3,3,0
11565071.0,3,8,2.6666666666666665,2,3,3,0
11566709.0,21,39,1.8571428571428572,1,4,21,0
11566981.0,20,43,2.15,1,4,20,0
11567559.0,7,15,2.142857142857143,1,4,7,0
11597128.0,140,566,4.042857142857143,2,7,140,0
11604027.0,225,465,2.066666666666667,1,5,225,0
11605661.0,83,171,2.0602409638554215,1,5,83,0
11611126.0,112,236,2.107142857142857,1,4,112,0
11614090.0,461,4382,9.505422993492408,2,12,39,422
11615877.0,144,414,2.875,1,6,144,0
11630593.0,174,847,4.867816091954023,2,9,171,3
11636119.0,25,81,3.24,1,6,25,0
11638814.0,155,767,4.948387096774193,2,7,155,0
11646666.0,66,653,9.893939393939394,3,13,2,64
11648578.0,5,6,1.2,1,2,5,0
11652585.0,9,19,2.111111111111111,1,4,9,0
11653281.0,263,1812,6.889733840304182,2,10,183,80
11657029.0,283,1951,6.893992932862191,3,11,202,81
11663087.0,178,1035,5.814606741573034,2,9,171,7
11664645.0,1,1,1.0,1,1,1,0
11665672.0,1,3,3.0,3,3,1,0
11670774.0,87,423,4.862068965517241,2,7,87,0
11691209.0,158,343,2.170886075949367,1,5,158,0
11691822.0,264,1823,6.90530303030303,2,10,180,84
11695043.0,49,153,3.122448979591837,1,5,49,0
11699457.0,252,1251,4.964285714285714,2,8,251,1
11700283.0,95,289,3.042105263157895,1,5,95,0
11709497.0,329,674,2.048632218844985,1,5,329,0
11729040.0,56,447,7.982142857142857,2,11,21,35
11731014.0,118,586,4.966101694915254,2,8,117,1
11736254.0,1,3,3.0,3,3,1,0
11779940.0,36,251,6.972222222222222,2,10,22,14
11780499.0,58,239,4.120689655172414,2,6,58,0
11788151.0,400,3494,8.735,2,12,52,348
11800815.0,217,1055,4.861751152073733,2,8,214,3
11821517.0,132,401,3.037878787878788,1,6,132,0
11823861.0,209,1663,7.956937799043062,2,11,63,146
11839044.0,421,3615,8.586698337292162,2,12,65,356
11841192.0,28,51,1.8214285714285714,1,3,28,0
11843115.0,25,55,2.2,1,4,25,0
11857115.0,109,232,2.128440366972477,1,4,109,0
11857429.0,183,1745,9.53551912568306,2,12,9,174
11860214.0,57,179,3.1403508771929824,1,6,57,0
11880078.0,664,5866,8.83433734939759,2,12,72,592
11882206.0,264,1278,4.840909090909091,2,8,263,1
11883556.0,45,95,2.111111111111111,1,4,45,0
11883563.0,47,99,2.106382978723404,1,4,47,0
11883878.0,18,36,2.0,1,4,18,0
11897825.0,62,238,3.838709677419355,2,6,62,0
11899423.0,108,538,4.981481481481482,2,7,108,0
11901130.0,14,113,8.071428571428571,6,9,2,12
11903795.0,163,800,4.9079754601226995,2,9,162,1
11922831.0,557,5340,9.587073608617594,2,13,37,520
11939172.0,5,12,2.4,2,3,5,0
11940718.0,46,330,7.173913043478261,5,10,32,14
11942195.0,130,509,3.9153846153846152,1,7,130,0
11960516.0,50,81,1.62,1,4,50,0
11960575.0,180,521,2.8944444444444444,1,6,180,0
11964300.0,102,493,4.833333333333333,2,8,101,1
11966069.0,29,198,6.827586206896552,3,9,22,7
11975069.0,10,29,2.9,1,4,10,0
11979262.0,154,1460,9.480519480519481,2,13,13,141
11981223.0,297,2579,8.683501683501683,2,12,36,261
11990713.0,531,2607,4.909604519774011,2,8,530,1
12004814.0,32,66,2.0625,1,4,32,0
12007794.0,41,283,6.902439024390244,2,9,26,15
12008311.0,55,364,6.618181818181818,2,11,39,16
12016380.0,5,16,3.2,2,4,5,0
12016892.0,297,1174,3.952861952861953,1,8,296,1
12023315.0,4,32,8.0,7,9,1,3
12038136.0,397,3458,8.710327455919396,2,12,55,342
12039296.0,7,12,1.7142857142857142,1,3,7,0
12050771.0,25,52,2.08,1,3,25,0
12059826.0,57,393,6.894736842105263,4,9,36,21
12063127.0,375,3631,9.682666666666666,2,13,24,351
12064892.0,753,6540,8.685258964143426,2,12,100,653
12066653.0,250,978,3.912,1,7,250,0
12079235.0,32,46,1.4375,1,3,32,0
12086094.0,47,132,2.8085106382978724,1,5,47,0
12104645.0,179,698,3.899441340782123,1,7,179,0
12107436.0,211,437,2.071090047393365,1,5,211,0
12122321.0,21,67,3.1904761904761907,2,5,21,0
12126453.0,408,3141,7.698529411764706,2,10,151,257
12131708.0,233,2239,9.609442060085836,2,13,19,214
12165789.0,144,677,4.701388888888889,2,7,144,0
12178970.0,12,25,2.0833333333333335,1,3,12,0
12179521.0,87,776,8.919540229885058,2,11,7,80
12182711.0,588,5668,9.639455782312925,2,13,34,554
12187235.0,75,639,8.52,2,12,12,63
12193432.0,39,267,6.846153846153846,2,8,27,12
12204859.0,138,695,5.036231884057971,2,8,137,1
12207693.0,442,4293,9.712669683257918,2,13,23,419
12222312.0,353,2421,6.858356940509915,2,9,247,106
12226249.0,14,38,2.7142857142857144,1,4,14,0
12229807.0,18,43,2.388888888888889,1,4,18,0
12249897.0,198,389,1.9646464646464648,1,5,198,0
12253380.0,9,60,6.666666666666667,5,9,7,2
12261797.0,3,5,1.6666666666666667,1,2,3,0
12265240.0,423,2078,4.912529550827423,2,8,419,4
12266573.0,24,157,6.541666666666667,2,9,18,6
12271450.0,238,496,2.0840336134453783,1,5,238,0
12274487.0,119,594,4.991596638655462,2,7,119,0
12283551.0,247,2117,8.570850202429149,2,11,39,208
12304349.0,123,1078,8.764227642276422,2,11,11,112
12314861.0,8,25,3.125,2,4,8,0
12321786.0,100,223,2.23,1,4,100,0
12328273.0,27,86,3.185185185185185,1,5,27,0
12333241.0,619,6045,9.765751211631663,2,13,36,583
12339162.0,34,66,1.9411764705882353,1,4,34,0
12339653.0,1,1,1.0,1,1,1,0
12355841.0,27,56,2.074074074074074,1,5,27,0
12356737.0,32,247,7.71875,3,11,14,18
12357602.0,17,37,2.176470588235294,1,3,17,0
12381883.0,124,248,2.0,1,5,124,0
12403422.0,128,407,3.1796875,1,5,128,0
12403592.0,4,10,2.5,2,3,4,0
12406799.0,101,303,3.0,1,5,101,0
12407578.0,49,334,6.816326530612245,2,9,34,15
12416706.0,80,119,1.4875,1,3,80,0
12427549.0,36,255,7.083333333333333,5,10,23,13
12436970.0,2,5,2.5,1,4,2,0
12450785.0,31,149,4.806451612903226,3,7,31,0
12461768.0,60,174,2.9,1,6,60,0
12463633.0,96,487,5.072916666666667,2,8,95,1
12476660.0,358,2440,6.815642458100559,2,10,258,100
12477603.0,111,153,1.3783783783783783,1,3,111,0
12489380.0,105,1015,9.666666666666666,2,12,6,99
12490526.0,40,259,6.475,2,9,34,6
12491911.0,271,1351,4.985239852398524,2,8,268,3
12492955.0,49,158,3.2244897959183674,1,6,49,0
12502738.0,441,1354,3.070294784580499,1,6,441,0
12504525.0,207,2017,9.743961352657005,2,14,11,196
12505599.0,341,1700,4.9853372434017595,2,9,340,1
12509802.0,371,1135,3.059299191374663,1,6,371,0
12510995.0,556,2784,5.0071942446043165,2,8,553,3
12518667.0,264,782,2.962121212121212,1,6,264,0
12525342.0,7,56,8.0,6,9,2,5
12527248.0,8,38,4.75,3,6,8,0
12528444.0,4,6,1.5,1,2,4,0
12531224.0,11,50,4.545454545454546,3,6,11,0
12541475.0,152,729,4.796052631578948,2,8,151,1
12549584.0,9,60,6.666666666666667,5,8,8,1
12560440.0,2,5,2.5,2,3,2,0
12560698.0,258,1268,4.9147286821705425,2,8,257,1
12562240.0,466,3154,6.76824034334764,2,10,344,122
12567906.0,9,19,2.111111111111111,1,4,9,0
12567922.0,12,29,2.4166666666666665,1,4,12,0
12577119.0,1,1,1.0,1,1,1,0
12583411.0,6,15,2.5,2,3,6,0
12584296.0,289,2572,8.899653979238755,2,12,22,267
12600216.0,2,5,2.5,2,3,2,0
12612983.0,41,128,3.1219512195121952,1,5,41,0
12620921.0,361,2858,7.916897506925208,2,11,93,268
12621927.0,237,928,3.9156118143459917,1,7,237,0
12639647.0,42,407,9.69047619047619,2,13,2,40
12643066.0,16,28,1.75,1,4,16,0
12645083.0,54,522,9.666666666666666,2,12,3,51
12658913.0,91,446,4.9010989010989015,3,8,90,1
12661885.0,14,65,4.642857142857143,3,7,14,0
12662793.0,418,3662,8.760765550239235,2,12,47,371
12665787.0,86,680,7.906976744186046,3,10,24,62
12671158.0,60,76,1.2666666666666666,1,3,60,0
12689332.0,18,39,2.1666666666666665,1,4,18,0
12692422.0,19,37,1.9473684210526316,1,5,19,0
12692563.0,34,77,2.264705882352941,1,5,34,0
12694501.0,114,345,3.026315789473684,1,5,114,0
12697260.0,4,29,7.25,5,9,2,2
12697537.0,4,6,1.5,1,2,4,0
12699820.0,16,63,3.9375,2,6,16,0
12703101.0,23,186,8.08695652173913,6,10,7,16
12717553.0,503,4359,8.666003976143141,2,12,58,445
12722089.0,195,1512,7.753846153846154,3,10,73,122
12745724.0,358,3438,9.603351955307263,2,13,26,332
12746811.0,199,433,2.1758793969849246,1,5,199,0
12747373.0,2,10,5.0,4,6,2,0
12751825.0,1,3,3.0,3,3,1,0
12760838.0,481,3748,7.792099792099792,2,11,179,302
12765287.0,29,109,3.7586206896551726,2,5,29,0
12768534.0,25,50,2.0,1,4,25,0
12768748.0,31,290,9.35483870967742,4,12,4,27
12774424.0,1,1,1.0,1,1,1,0
12775631.0,10,54,5.4,4,6,10,0
12776265.0,16,35,2.1875,1,4,16,0
12787637.0,146,581,3.9794520547945207,1,7,146,0
12787732.0,44,293,6.659090909090909,2,9,30,14
12808440.0,1,4,4.0,4,4,1,0
12818500.0,15,20,1.3333333333333333,1,3,15,0
12827491.0,243,504,2.074074074074074,1,4,243,0
12831457.0,47,151,3.2127659574468086,1,5,47,0
12837757.0,10,30,3.0,1,4,10,0
12838356.0,68,142,2.088235294117647,1,5,68,0
12846037.0,1,4,4.0,4,4,1,0
12846439.0,3,26,8.666666666666666,8,10,0,3
12848664.0,29,64,2.206896551724138,1,5,29,0
12849077.0,172,355,2.063953488372093,1,5,172,0
12851319.0,30,203,6.766666666666667,2,9,21,9
12858718.0,331,2233,6.746223564954683,2,10,226,105
12864326.0,111,1061,9.558558558558559,3,13,10,101
12865030.0,6,19,3.1666666666666665,2,5,6,0
12867848.0,85,246,2.8941176470588235,1,5,85,0
12877129.0,242,1660,6.859504132231405,2,10,174,68
12878761.0,417,2850,6.83453237410072,2,11,307,110
12889722.0,462,4033,8.729437229437229,2,12,57,405
12891724.0,409,1244,3.041564792176039,1,7,409,0
12893692.0,108,234,2.1666666666666665,1,5,108,0
12895434.0,112,542,4.839285714285714,2,8,111,1
12899328.0,4,11,2.75,2,3,4,0
12900188.0,42,118,2.8095238095238093,2,5,42,0
12901000.0,332,1321,3.9789156626506026,1,7,332,0
12903625.0,269,1309,4.866171003717472,1,8,267,2
12908786.0,257,1243,4.836575875486381,2,8,256,1
12909846.0,166,652,3.927710843373494,1,7,166,0
12913295.0,502,4837,9.635458167330677,2,13,34,468
12923641.0,28,120,4.285714285714286,2,7,28,0
12931756.0,186,1786,9.602150537634408,2,12,17,169
12938485.0,97,180,1.8556701030927836,1,4,97,0
12948824.0,578,2852,4.9342560553633215,2,9,571,7
12976607.0,315,1538,4.882539682539683,2,8,311,4
12977841.0,8,18,2.25,1,3,8,0
12978217.0,74,158,2.135135135135135,1,4,74,0
12980598.0,418,2084,4.985645933014354,2,9,416,2
12985524.0,485,3282,6.7670103092783505,2,10,360,125
12986397.0,85,669,7.870588235294117,3,10,21,64
12993828.0,74,748,10.108108108108109,4,12,1,73
12999503.0,11,26,2.3636363636363638,1,3,11,0
13015874.0,310,2440,7.870967741935484,2,11,94,216
13017262.0,204,292,1.4313725490196079,1,4,204,0
13024612.0,21,35,1.6666666666666667,1,4,21,0
13025295.0,17,22,1.2941176470588236,1,3,17,0
13035089.0,92,547,5.945652173913044,3,9,88,4
13035913.0,115,156,1.3565217391304347,1,4,115,0
13039289.0,114,863,7.5701754385964914,2,10,38,76
13044632.0,75,366,4.88,2,7,75,0
13045577.0,1,4,4.0,4,4,1,0
13050448.0,245,532,2.1714285714285713,1,4,245,0
13052309.0,142,1254,8.830985915492958,2,11,7,135
13060669.0,4,9,2.25,1,4,4,0
13075348.0,12,21,1.75,1,3,12,0
13086140.0,181,859,4.745856353591161,2,8,179,2
13105446.0,119,357,3.0,1,6,119,0
13110148.0,242,723,2.987603305785124,1,6,242,0
13118231.0,376,783,2.0824468085106385,1,5,376,0
13121121.0,287,576,2.0069686411149825,1,4,287,0
13123584.0,179,358,2.0,1,5,179,0
13127836.0,234,2270,9.7008547008547,2,13,12,222
13134354.0,490,992,2.024489795918367,1,5,490,0
13134531.0,19,58,3.0526315789473686,2,5,19,0
13143126.0,7,18,2.5714285714285716,2,4,7,0
13145534.0,463,627,1.3542116630669547,1,4,463,0
13153436.0,486,1934,3.9794238683127574,1,7,486,0
13158018.0,29,203,7.0,4,9,21,8
13161745.0,1,3,3.0,3,3,1,0
13169260.0,72,360,5.0,3,8,71,1
13185158.0,365,3459,9.476712328767123,2,13,34,331
13186430.0,155,786,5.070967741935484,2,8,152,3
13188948.0,154,765,4.967532467532467,2,7,154,0
13190733.0,431,881,2.0440835266821344,1,5,431,0
13191838.0,27,217,8.037037037037036,6,10,6,21
13195012.0,78,603,7.730769230769231,2,11,29,49
13196992.0,133,665,5.0,3,8,132,1
13198453.0,4,29,7.25,6,9,2,2
13198517.0,69,148,2.1449275362318843,1,5,69,0
13219456.0,42,86,2.0476190476190474,1,4,42,0
13235163.0,2,5,2.5,2,3,2,0
13245102.0,137,290,2.116788321167883,1,5,137,0
13246572.0,1,3,3.0,3,3,1,0
13246767.0,59,584,9.898305084745763,7,12,4,55
13259870.0,2,7,3.5,2,5,2,0
13261461.0,78,458,5.871794871794871,2,8,67,11
13276334.0,49,333,6.795918367346939,5,9,37,12
13276589.0,356,3418,9.601123595505618,2,13,23,333
13278583.0,13,35,2.6923076923076925,1,4,13,0
13289455.0,1,2,2.0,2,2,1,0
13294421.0,98,688,7.020408163265306,2,10,69,29
13296222.0,146,418,2.863013698630137,1,5,146,0
13297510.0,73,227,3.1095890410958904,1,5,73,0
13303553.0,175,380,2.1714285714285713,1,5,175,0
13304153.0,140,412,2.942857142857143,1,6,140,0
13304944.0,392,1179,3.00765306122449,1,6,392,0
13305230.0,101,792,7.841584158415841,2,11,37,64
13310071.0,41,331,8.073170731707316,6,10,13,28
13312806.0,63,486,7.714285714285714,2,10,17,46
13314760.0,19,26,1.368421052631579,1,3,19,0
13314868.0,72,504,7.0,3,9,48,24
13315485.0,356,1771,4.974719101123595,2,7,356,0
13319516.0,5,14,2.8,2,4,5,0
13320183.0,65,625,9.615384615384615,2,12,5,60
13323993.0,370,761,2.056756756756757,1,5,370,0
13328359.0,122,838,6.868852459016393,2,10,84,38
13337047.0,187,1265,6.764705882352941,2,9,136,51
13337867.0,11,32,2.909090909090909,1,4,11,0
13338429.0,441,3451,7.825396825396825,2,11,148,293
13340206.0,48,112,2.3333333333333335,1,4,48,0
13341044.0,356,780,2.191011235955056,1,5,356,0
13342949.0,7,12,1.7142857142857142,1,3,7,0
13344457.0,9,15,1.6666666666666667,1,3,9,0
13344738.0,66,204,3.090909090909091,1,5,66,0
13346561.0,234,445,1.9017094017094016,1,4,234,0
13349627.0,14,86,6.142857142857143,3,9,10,4
13351413.0,29,58,2.0,1,4,29,0
13351781.0,8,16,2.0,1,3,8,0
13358233.0,24,206,8.583333333333334,3,10,3,21
13361113.0,47,355,7.553191489361702,2,10,16,31
13367445.0,1,3,3.0,3,3,1,0
13369571.0,4,7,1.75,1,3,4,0
13382280.0,67,184,2.746268656716418,1,5,67,0
13382357.0,50,234,4.68,2,7,50,0
13384154.0,317,629,1.9842271293375395,1,5,317,0
13388921.0,60,177,2.95,1,5,60,0
13390324.0,7,14,2.0,1,3,7,0
13392242.0,137,562,4.102189781021898,1,7,137,0
13403703.0,118,920,7.796610169491525,2,11,47,71
13404513.0,145,864,5.958620689655173,2,8,132,13
13409388.0,751,3786,5.041278295605859,2,8,746,5
13409702.0,488,2414,4.94672131147541,2,8,483,5
13414026.0,4,10,2.5,2,4,4,0
13414771.0,83,563,6.783132530120482,3,11,59,24
13415329.0,1,1,1.0,1,1,1,0
13425790.0,1,2,2.0,2,2,1,0
13427441.0,18,43,2.388888888888889,1,4,18,0
13429687.0,65,317,4.876923076923077,2,7,65,0
13430048.0,5,18,3.6,1,5,5,0
13434343.0,5,28,5.6,4,6,5,0
13440784.0,4,5,1.25,1,2,4,0
13443391.0,89,690,7.752808988764045,3,11,33,56
13448255.0,46,92,2.0,1,5,46,0
13451556.0,298,620,2.0805369127516777,1,6,298,0
13461584.0,48,142,2.9583333333333335,1,5,48,0
13464977.0,239,1181,4.941422594142259,2,8,237,2
13468543.0,3,10,3.3333333333333335,2,4,3,0
13475160.0,124,1204,9.709677419354838,2,12,10,114
13476393.0,33,95,2.878787878787879,1,5,33,0
13481512.0,18,53,2.9444444444444446,1,5,18,0
13485485.0,379,751,1.9815303430079156,1,5,379,0
13490666.0,184,378,2.0543478260869565,1,5,184,0
13491442.0,10,33,3.3,2,5,10,0
13494666.0,202,1941,9.608910891089108,2,13,16,186
13499497.0,4,8,2.0,1,3,4,0
13499800.0,167,655,3.9221556886227544,1,6,167,0
13502753.0,55,378,6.872727272727273,4,9,39,16
13509563.0,334,684,2.0479041916167664,1,4,334,0
13520236.0,4,9,2.25,1,3,4,0
13520856.0,86,334,3.883720930232558,1,7,86,0
13521641.0,421,1650,3.9192399049881237,1,7,421,0
13521853.0,61,167,2.737704918032787,1,5,61,0
13525030.0,592,4595,7.761824324324325,2,12,226,366
13528420.0,7,11,1.5714285714285714,1,2,7,0
13529031.0,12,67,5.583333333333333,4,7,12,0
13529348.0,42,404,9.619047619047619,3,12,3,39
13535942.0,134,181,1.3507462686567164,1,3,134,0
13536292.0,94,134,1.425531914893617,1,3,94,0
13536623.0,70,88,1.2571428571428571,1,3,70,0
13536899.0,149,208,1.395973154362416,1,3,149,0
13543366.0,9,11,1.2222222222222223,1,3,9,0
13553080.0,905,8750,9.668508287292818,2,13,54,851
13555382.0,1,2,2.0,2,2,1,0
13570287.0,491,2408,4.904276985743381,2,8,487,4
13576483.0,53,504,9.50943396226415,2,12,4,49
13582987.0,217,643,2.9631336405529956,1,5,217,0
13595845.0,19,125,6.578947368421052,2,9,12,7
13598783.0,61,586,9.60655737704918,5,13,5,56
13603163.0,29,213,7.344827586206897,5,11,17,12
13603658.0,98,951,9.704081632653061,3,12,5,93
13605037.0,20,38,1.9,1,4,20,0
13610432.0,112,236,2.107142857142857,1,5,112,0
13611167.0,16,54,3.375,2,5,16,0
13615700.0,135,675,5.0,3,7,135,0
13621444.0,12,26,2.1666666666666665,1,3,12,0
13621619.0,277,579,2.0902527075812274,1,5,277,0
13621887.0,71,497,7.0,3,9,48,23
13627260.0,1,3,3.0,3,3,1,0
13628361.0,231,483,2.090909090909091,1,5,231,0
13632109.0,539,4653,8.63265306122449,2,12,71,468
13644911.0,75,701,9.346666666666666,2,12,8,67
13651213.0,9,34,3.7777777777777777,3,4,9,0
13651618.0,58,507,8.741379310344827,2,11,5,53
13653047.0,48,193,4.020833333333333,1,7,48,0
13653401.0,1,2,2.0,2,2,1,0
13669166.0,2,6,3.0,3,3,2,0
13671856.0,160,1417,8.85625,2,11,14,146
13673598.0,1,2,2.0,2,2,1,0
13684287.0,265,550,2.0754716981132075,1,5,265,0
13690664.0,213,1058,4.967136150234742,2,8,211,2
13694719.0,222,1532,6.900900900900901,2,10,153,69
13707810.0,309,2107,6.818770226537217,2,9,221,88
13710484.0,1,1,1.0,1,1,1,0
13717754.0,324,3152,9.728395061728396,3,13,14,310
13719990.0,1,4,4.0,4,4,1,0
13721711.0,277,569,2.0541516245487363,1,5,277,0
13731183.0,306,1481,4.839869281045751,2,8,303,3
13739130.0,2,2,1.0,1,1,2,0
13739424.0,75,590,7.866666666666666,3,10,21,54
13740681.0,1,1,1.0,1,1,1,0
13744404.0,239,955,3.99581589958159,1,6,239,0
13744447.0,9,17,1.8888888888888888,1,3,9,0
13744939.0,6,14,2.3333333333333335,1,4,6,0
13745016.0,9,27,3.0,1,5,9,0
13748657.0,84,643,7.654761904761905,2,10,30,54
13749560.0,98,396,4.040816326530612,1,6,98,0
13755327.0,105,196,1.8666666666666667,1,5,105,0
13756367.0,133,668,5.022556390977444,2,8,132,1
13766522.0,3,25,8.333333333333334,7,10,1,2
13767275.0,8,59,7.375,4,10,3,5
13772944.0,29,144,4.9655172413793105,3,7,29,0
13773689.0,340,1654,4.864705882352941,2,8,338,2
13774384.0,210,1977,9.414285714285715,2,12,20,190
13774719.0,75,389,5.1866666666666665,3,7,75,0
13794371.0,1,5,5.0,5,5,1,0
13800259.0,10,32,3.2,2,4,10,0
13812118.0,408,2088,5.117647058823529,2,9,404,4
13813140.0,44,357,8.113636363636363,6,11,11,33
13814652.0,5,8,1.6,1,3,5,0
13818564.0,133,283,2.1278195488721803,1,5,133,0
13818780.0,46,58,1.2608695652173914,1,4,46,0
13824992.0,158,796,5.037974683544304,2,8,157,1
13825644.0,2,6,3.0,3,3,2,0
13828104.0,3,5,1.6666666666666667,1,3,3,0
13832164.0,5,9,1.8,1,3,5,0
13837989.0,164,1282,7.817073170731708,2,11,55,109
13841899.0,24,135,5.625,3,8,23,1
13842245.0,856,8181,9.557242990654206,2,14,65,791
13843004.0,137,1201,8.766423357664234,3,12,18,119
13850986.0,19,24,1.263157894736842,1,2,19,0
13854377.0,5,13,2.6,1,4,5,0
13854508.0,286,859,3.0034965034965033,1,6,286,0
13858821.0,107,952,8.897196261682243,2,12,15,92
13860105.0,1,1,1.0,1,1,1,0
13860850.0,11,14,1.2727272727272727,1,3,11,0
13870115.0,10,33,3.3,2,4,10,0
13871896.0,10,20,2.0,1,4,10,0
13874631.0,199,997,5.010050251256281,2,8,198,1
13874765.0,235,471,2.0042553191489363,1,4,235,0
13875461.0,49,139,2.836734693877551,1,5,49,0
13876189.0,9,21,2.3333333333333335,1,4,9,0
13876561.0,12,97,8.083333333333334,6,9,4,8
13876975.0,4,30,7.5,7,8,2,2
13877247.0,9,17,1.8888888888888888,1,3,9,0
13885525.0,58,541,9.327586206896552,2,13,3,55
13887108.0,27,140,5.185185185185185,3,7,27,0
13887762.0,179,408,2.2793296089385473,1,5,179,0
13890217.0,70,153,2.1857142857142855,1,4,70,0
13890249.0,338,2336,6.911242603550296,3,10,243,95
13893039.0,31,66,2.129032258064516,1,5,31,0
13897281.0,2,14,7.0,6,8,1,1
13897721.0,497,1980,3.9839034205231387,2,7,497,0
13898235.0,9,64,7.111111111111111,5,8,6,3
13898710.0,195,986,5.056410256410256,2,8,193,2
13906219.0,110,545,4.954545454545454,2,8,108,2
13907969.0,2,5,2.5,2,3,2,0
13912611.0,411,2412,5.868613138686132,2,8,396,15
13914313.0,23,29,1.2608695652173914,1,3,23,0
13916899.0,424,881,2.077830188679245,1,5,424,0
13919907.0,52,363,6.980769230769231,3,9,37,15
13921775.0,369,1831,4.9620596205962055,2,8,368,1
13923066.0,9,29,3.2222222222222223,2,5,9,0
13927392.0,298,899,3.0167785234899327,1,6,298,0
13932435.0,18,31,1.7222222222222223,1,4,18,0
13934525.0,1,1,1.0,1,1,1,0
13938008.0,32,43,1.34375,1,3,32,0
13939021.0,1,2,2.0,2,2,1,0
13942955.0,468,2349,5.019230769230769,2,8,467,1
13951605.0,325,3175,9.76923076923077,2,13,20,305
13959072.0,7,10,1.4285714285714286,1,2,7,0
13966094.0,271,1340,4.944649446494465,2,8,269,2
13968622.0,3,4,1.3333333333333333,1,2,3,0
13972503.0,360,491,1.363888888888889,1,4,360,0
13973118.0,3,4,1.3333333333333333,1,2,3,0
13977595.0,115,1087,9.452173913043477,2,12,11,104
13985137.0,17,24,1.411764705882353,1,3,17,0
13988505.0,164,1384,8.439024390243903,2,12,30,134
13994451.0,14,28,2.0,1,4,14,0
14001689.0,165,494,2.993939393939394,1,5,165,0
14012779.0,142,1355,9.54225352112676,2,13,10,132
14013601.0,150,717,4.78,2,7,150,0
14018934.0,74,708,9.567567567567568,2,12,8,66
14034839.0,69,689,9.985507246376812,5,13,2,67
14045259.0,431,916,2.125290023201856,1,5,431,0
14053253.0,17,32,1.8823529411764706,1,4,17,0
14060811.0,604,5792,9.589403973509933,2,13,46,558
14062629.0,337,715,2.121661721068249,1,5,337,0
14063187.0,3,7,2.3333333333333335,1,3,3,0
14065549.0,33,324,9.818181818181818,2,12,2,31
14067350.0,27,49,1.8148148148148149,1,4,27,0
14078965.0,36,119,3.3055555555555554,1,5,36,0
14081186.0,641,2572,4.0124804992199685,1,7,641,0
14083122.0,201,806,4.009950248756219,1,6,201,0
14088980.0,182,379,2.0824175824175826,1,5,182,0
14090362.0,321,1587,4.94392523364486,2,8,319,2
14092230.0,3,3,1.0,1,1,3,0
14102785.0,438,4180,9.54337899543379,2,13,29,409
14107434.0,41,391,9.536585365853659,3,13,3,38
14113692.0,32,88,2.75,1,5,32,0
14117432.0,153,1456,9.516339869281046,2,13,13,140
14120252.0,60,168,2.8,1,5,60,0
14128387.0,483,2381,4.929606625258799,2,8,480,3
14132118.0,110,750,6.818181818181818,3,9,79,31
14133870.0,79,397,5.025316455696203,3,8,78,1
14134323.0,77,583,7.571428571428571,3,10,37,40
14142056.0,35,211,6.0285714285714285,4,7,35,0
14146230.0,383,1531,3.9973890339425586,1,7,383,0
14146634.0,624,3107,4.979166666666667,1,8,620,4
14156890.0,34,125,3.676470588235294,1,6,34,0
14163067.0,299,1471,4.919732441471572,1,8,296,3
14164411.0,34,97,2.8529411764705883,1,5,34,0
14170111.0,225,1993,8.857777777777779,3,12,23,202
14173004.0,212,1056,4.981132075471698,2,8,210,2
14191094.0,20,61,3.05,1,5,20,0
14194511.0,39,246,6.3076923076923075,3,8,33,6
14208866.0,525,5004,9.531428571428572,2,13,37,488
14213541.0,47,108,2.297872340425532,1,4,47,0
14226639.0,6,44,7.333333333333333,3,9,1,5
14234095.0,392,827,2.1096938775510203,1,5,392,0
14247182.0,305,2654,8.701639344262295,2,12,37,268
14249577.0,134,805,6.007462686567164,2,8,121,13
14249782.0,75,105,1.4,1,4,75,0
14263628.0,166,1568,9.44578313253012,2,12,13,153
14265550.0,5,14,2.8,2,3,5,0
14269186.0,2,5,2.5,2,3,2,0
14270475.0,57,285,5.0,2,7,57,0
14274304.0,74,170,2.2972972972972974,1,5,74,0
14275773.0,351,1715,4.886039886039886,1,7,351,0
14279398.0,535,2650,4.953271028037383,2,8,531,4
14279801.0,317,1899,5.990536277602524,2,9,295,22
14283168.0,111,318,2.864864864864865,1,5,111,0
14286122.0,136,271,1.9926470588235294,1,5,136,0
14287680.0,578,5708,9.875432525951558,2,13,22,556
14294462.0,30,212,7.066666666666666,5,10,20,10
14297436.0,348,1685,4.841954022988506,2,8,347,1
14307925.0,36,349,9.694444444444445,5,12,3,33
14308894.0,1,5,5.0,5,5,1,0
14310728.0,18,118,6.555555555555555,3,9,12,6
14316940.0,2,8,4.0,3,5,2,0
14326460.0,21,174,8.285714285714286,4,10,5,16
14327937.0,29,140,4.827586206896552,3,7,29,0
14328391.0,248,781,3.149193548387097,1,6,248,0
14332712.0,186,1280,6.881720430107527,2,9,133,53
14333096.0,1,1,1.0,1,1,1,0
14333322.0,76,509,6.697368421052632,3,10,59,17
14333551.0,23,83,3.608695652173913,2,5,23,0
14355410.0,260,1296,4.984615384615385,2,8,259,1
14359675.0,35,173,4.942857142857143,3,7,35,0
14369740.0,1,3,3.0,3,3,1,0
14372320.0,376,3622,9.632978723404255,3,13,22,354
14374562.0,223,422,1.8923766816143497,1,4,223,0
14377807.0,65,446,6.861538461538461,3,9,46,19
14383186.0,220,2128,9.672727272727272,2,13,12,208
14396794.0,134,656,4.895522388059701,2,8,133,1
14401965.0,22,61,2.772727272727273,1,5,22,0
14414976.0,168,339,2.017857142857143,1,5,168,0
14418694.0,233,477,2.0472103004291844,1,5,233,0
14421409.0,298,413,1.3859060402684564,1,5,298,0
14421923.0,207,309,1.4927536231884058,1,4,207,0
14433356.0,49,345,7.040816326530612,5,10,31,18
14436432.0,106,140,1.320754716981132,1,3,106,0
14447133.0,38,76,2.0,1,3,38,0
14458953.0,231,474,2.051948051948052,1,5,231,0
14458976.0,31,101,3.2580645161290325,1,4,31,0
14471486.0,290,903,3.113793103448276,1,6,290,0
14471852.0,248,2391,9.641129032258064,2,12,13,235
14472643.0,31,54,1.7419354838709677,1,3,31,0
14476523.0,18,130,7.222222222222222,2,9,6,12
14480333.0,36,78,2.1666666666666665,1,4,36,0
14480359.0,300,1479,4.93,1,8,297,3
14485245.0,507,2474,4.879684418145956,1,8,504,3
14485893.0,106,517,4.877358490566038,2,7,106,0
14488156.0,227,667,2.9383259911894273,1,6,227,0
14494899.0,159,1554,9.773584905660377,2,13,8,151
14497321.0,114,466,4.087719298245614,2,7,114,0
14500505.0,141,695,4.929078014184397,2,8,140,1
14504553.0,155,1353,8.729032258064516,2,11,17,138
14517924.0,151,1346,8.913907284768213,5,12,14,137
14528371.0,287,854,2.975609756097561,1,6,287,0
14528986.0,96,819,8.53125,2,11,11,85
14531657.0,1,3,3.0,3,3,1,0
14533431.0,15,43,2.8666666666666667,2,4,15,0
14548682.0,242,725,2.9958677685950414,1,6,242,0
14559931.0,6,9,1.5,1,2,6,0
14565087.0,3,5,1.6666666666666667,1,2,3,0
14570831.0,102,310,3.0392156862745097,1,5,102,0
14572595.0,8,15,1.875,1,3,8,0
14574259.0,14,41,2.9285714285714284,1,4,14,0
14579567.0,336,1026,3.0535714285714284,1,6,336,0
14598996.0,83,741,8.927710843373495,4,11,9,74
14605769.0,429,2118,4.937062937062937,2,8,426,3
14608291.0,448,2206,4.924107142857143,2,8,445,3
14620811.0,63,493,7.825396825396825,2,10,26,37
14620999.0,85,426,5.011764705882353,3,7,85,0
14627849.0,143,301,2.104895104895105,1,5,143,0
14628922.0,4,4,1.0,1,1,4,0
14652492.0,153,441,2.8823529411764706,1,6,153,0
14660403.0,122,171,1.401639344262295,1,3,122,0
14664791.0,17,36,2.1176470588235294,1,3,17,0
14667336.0,67,508,7.582089552238806,2,10,25,42
14671825.0,182,733,4.027472527472527,1,6,182,0
14672909.0,1,4,4.0,4,4,1,0
14676028.0,698,6744,9.66189111747851,2,14,49,649
14681869.0,34,86,2.5294117647058822,1,4,34,0
14704409.0,208,1447,6.956730769230769,2,9,140,68
14708647.0,57,117,2.0526315789473686,1,4,57,0
14712529.0,407,2019,4.96068796068796,2,8,406,1
14723895.0,223,1101,4.937219730941704,2,7,223,0
14725360.0,111,226,2.036036036036036,1,4,111,0
14725803.0,105,307,2.9238095238095236,1,5,105,0
14730017.0,22,158,7.181818181818182,6,9,14,8
14735348.0,216,656,3.037037037037037,1,6,216,0
14745319.0,137,687,5.014598540145985,2,8,135,2
14749490.0,92,720,7.826086956521739,2,10,30,62
14751089.0,477,1932,4.050314465408805,1,7,477,0
14777687.0,83,790,9.518072289156626,3,12,4,79
14778159.0,439,3444,7.8451025056947605,2,11,149,290
14783890.0,6,58,9.666666666666666,8,11,0,6
14795776.0,445,3434,7.71685393258427,2,11,165,280
14806012.0,52,104,2.0,1,4,52,0
14818761.0,8,75,9.375,8,10,0,8
14819428.0,179,362,2.022346368715084,1,4,179,0
14819993.0,4,39,9.75,9,10,0,4
14821034.0,4,27,6.75,3,10,2,2
14822187.0,5,45,9.0,8,11,0,5
14830043.0,46,94,2.0434782608695654,1,4,46,0
14833034.0,103,877,8.514563106796116,2,11,14,89
14835141.0,14,29,2.0714285714285716,1,4,14,0
14850472.0,311,1515,4.871382636655949,2,8,308,3
14854074.0,235,934,3.974468085106383,1,7,235,0
14854217.0,53,250,4.716981132075472,2,7,53,0
14860669.0,429,861,2.006993006993007,1,5,429,0
14863261.0,1,3,3.0,3,3,1,0
14865208.0,422,2105,4.988151658767772,2,8,418,4
14869725.0,311,633,2.035369774919614,1,6,311,0
14882965.0,226,2183,9.65929203539823,2,12,11,215
14883172.0,15,26,1.7333333333333334,1,4,15,0
14890676.0,6,16,2.6666666666666665,2,4,6,0
14890698.0,117,363,3.1025641025641026,1,5,117,0
14906089.0,398,1977,4.967336683417085,2,8,397,1
14913490.0,12,87,7.25,6,10,8,4
14927666.0,1,6,6.0,6,6,1,0
14930772.0,308,2080,6.753246753246753,2,10,237,71
14941906.0,221,1731,7.832579185520362,2,11,74,147
14943319.0,401,810,2.0199501246882794,1,4,401,0
14948586.0,70,589,8.414285714285715,2,11,11,59
14957137.0,192,381,1.984375,1,4,192,0
14987359.0,2,4,2.0,1,3,2,0
14994623.0,126,384,3.0476190476190474,1,5,126,0
14997405.0,83,415,5.0,2,8,82,1
15001584.0,60,88,1.4666666666666666,1,3,60,0
15005208.0,40,270,6.75,3,10,30,10
15014198.0,236,697,2.9533898305084745,1,5,236,0
15017291.0,41,391,9.536585365853659,4,13,3,38
15019684.0,428,896,2.0934579439252334,1,5,428,0
15026011.0,100,492,4.92,2,8,99,1
15029864.0,64,556,8.6875,2,11,4,60
15033500.0,2,3,1.5,1,2,2,0
15036212.0,379,3278,8.649076517150396,2,12,50,329
15042485.0,362,763,2.1077348066298343,1,5,362,0
15046716.0,638,897,1.4059561128526645,1,4,638,0
15048152.0,8,27,3.375,2,5,8,0
15048358.0,5,37,7.4,5,8,1,4
15048657.0,7,12,1.7142857142857142,1,3,7,0
15091421.0,222,2102,9.468468468468469,2,13,19,203
15094144.0,47,317,6.74468085106383,4,10,35,12
15122503.0,9,11,1.2222222222222223,1,2,9,0
15126500.0,34,113,3.323529411764706,1,6,34,0
15127417.0,32,251,7.84375,2,10,9,23
15128601.0,55,114,2.0727272727272728,1,4,55,0
15141334.0,343,2366,6.8979591836734695,2,10,252,91
15143840.0,284,1939,6.827464788732394,2,10,197,87
15152754.0,131,1289,9.83969465648855,3,12,5,126
15154657.0,18,74,4.111111111111111,3,7,18,0
15156675.0,6,12,2.0,1,3,6,0
15159063.0,4,32,8.0,6,10,2,2
15172673.0,165,1563,9.472727272727273,2,13,16,149
15173717.0,264,1296,4.909090909090909,2,8,263,1
15190369.0,181,897,4.955801104972376,2,8,180,1
15201755.0,68,84,1.2352941176470589,1,3,68,0
15205912.0,215,448,2.083720930232558,1,5,215,0
15206279.0,57,489,8.578947368421053,2,11,8,49
15206368.0,19,30,1.5789473684210527,1,3,19,0
15210164.0,323,1579,4.8885448916408665,2,7,323,0
15211983.0,121,823,6.801652892561983,3,9,89,32
15212560.0,119,176,1.4789915966386555,1,4,119,0
15213476.0,245,333,1.3591836734693878,1,4,245,0
15214261.0,450,3110,6.911111111111111,2,10,305,145
15223758.0,359,1441,4.013927576601671,1,7,359,0
15226560.0,2,7,3.5,3,4,2,0
15229880.0,496,1015,2.0463709677419355,1,5,496,0
15231742.0,410,2012,4.907317073170732,2,7,410,0
15247674.0,188,570,3.0319148936170213,1,6,188,0
15249110.0,233,2271,9.746781115879829,2,12,12,221
15250700.0,522,5075,9.722222222222221,2,14,35,487
15269734.0,2,4,2.0,2,2,2,0
15291983.0,30,32,1.0666666666666667,1,2,30,0
15293222.0,9,14,1.5555555555555556,1,3,9,0
15294801.0,71,635,8.943661971830986,3,12,8,63
15312020.0,5,9,1.8,1,3,5,0
15323656.0,446,2189,4.908071748878924,2,8,445,1
15325421.0,235,480,2.0425531914893615,1,5,235,0
15326621.0,39,77,1.9743589743589745,1,4,39,0
15327978.0,117,1020,8.717948717948717,2,11,14,103
15340379.0,15,42,2.8,1,5,15,0
15341960.0,15,17,1.1333333333333333,1,2,15,0
15343140.0,21,46,2.1904761904761907,1,5,21,0
15347456.0,251,351,1.3984063745019921,1,4,251,0
15349913.0,254,353,1.389763779527559,1,3,254,0
15353038.0,362,1432,3.955801104972376,1,7,362,0
15356355.0,1,3,3.0,3,3,1,0
15366300.0,204,1035,5.073529411764706,2,8,201,3
15369374.0,17,88,5.176470588235294,4,7,17,0
15377196.0,137,671,4.897810218978102,3,8,136,1
15387976.0,6,41,6.833333333333333,4,9,4,2
15391441.0,112,985,8.794642857142858,3,11,12,100
15397031.0,66,132,2.0,1,4,66,0
15397990.0,7,21,3.0,2,4,7,0
15405680.0,12,26,2.1666666666666665,1,5,12,0
15407681.0,260,1040,4.0,1,7,260,0
15415682.0,314,1249,3.977707006369427,1,6,314,0
15427585.0,11,39,3.5454545454545454,2,5,11,0
15428073.0,100,204,2.04,1,5,100,0
15429065.0,172,1522,8.848837209302326,2,12,18,154
15442540.0,188,930,4.946808510638298,2,8,187,1
15444374.0,75,145,1.9333333333333333,1,4,75,0
15445749.0,110,556,5.054545454545455,2,8,109,1
15445910.0,179,911,5.089385474860335,3,8,178,1
15456285.0,1,4,4.0,4,4,1,0
15464903.0,4,29,7.25,5,8,1,3
15465539.0,83,562,6.771084337349397,2,10,61,22
15467007.0,200,592,2.96,1,6,200,0
15471882.0,159,1372,8.628930817610064,2,12,23,136
15472850.0,6,13,2.1666666666666665,2,3,6,0
15476135.0,211,2071,9.815165876777252,2,13,12,199
15487784.0,246,505,2.0528455284552845,1,5,246,0
15490428.0,16,19,1.1875,1,2,16,0
15491094.0,119,470,3.9495798319327733,1,7,119,0
15494420.0,7,15,2.142857142857143,1,3,7,0
15498951.0,101,881,8.722772277227723,3,12,15,86
15507824.0,36,79,2.1944444444444446,1,5,36,0
15510022.0,85,163,1.9176470588235295,1,4,85,0
15510318.0,84,634,7.5476190476190474,2,10,27,57
15514855.0,302,2037,6.745033112582782,2,10,224,78
15518354.0,75,156,2.08,1,5,75,0
15521521.0,472,4594,9.733050847457626,2,13,26,446
15539713.0,38,262,6.894736842105263,3,9,26,12
15543238.0,425,873,2.0541176470588236,1,5,425,0
15558149.0,185,914,4.940540540540541,1,8,184,1
15558429.0,11,32,2.909090909090909,1,4,11,0
15562768.0,562,2261,4.023131672597865,1,7,562,0
15566594.0,274,562,2.051094890510949,1,5,274,0
15576015.0,3,8,2.6666666666666665,2,3,3,0
15577787.0,298,2006,6.731543624161074,2,10,227,71
15605778.0,184,1792,9.73913043478261,2,12,12,172
15607646.0,1,3,3.0,3,3,1,0
15609190.0,658,5717,8.688449848024316,2,12,83,575
15612603.0,39,76,1.9487179487179487,1,4,39,0
15629900.0,8,14,1.75,1,3,8,0
15637260.0,106,830,7.830188679245283,2,10,33,73
15643107.0,1,3,3.0,3,3,1,0
15645521.0,181,381,2.1049723756906076,1,5,181,0
15649818.0,44,336,7.636363636363637,2,10,15,29
15651554.0,392,2671,6.813775510204081,2,10,288,104
15652156.0,451,2245,4.977827050997782,2,8,450,1
15656460.0,82,778,9.487804878048781,2,13,7,75
15661778.0,120,250,2.0833333333333335,1,4,120,0
15668601.0,133,635,4.774436090225564,2,7,133,0
15676953.0,96,660,6.875,2,9,64,32
15677633.0,78,382,4.897435897435898,2,7,78,0
15682743.0,404,3138,7.767326732673268,2,11,148,256
15699859.0,157,598,3.8089171974522293,1,6,157,0
15713797.0,7,24,3.4285714285714284,2,5,7,0
15717342.0,4,29,7.25,7,8,3,1
15719217.0,255,1273,4.992156862745098,2,8,252,3
15724662.0,8,18,2.25,1,3,8,0
15728951.0,343,1024,2.9854227405247813,1,6,343,0
15729234.0,1,1,1.0,1,1,1,0
15738053.0,49,461,9.408163265306122,3,12,4,45
15749137.0,263,1294,4.920152091254753,2,8,261,2
15757008.0,55,268,4.872727272727273,2,7,55,0
15763467.0,68,72,1.0588235294117647,1,2,68,0
15764378.0,1,4,4.0,4,4,1,0
15767962.0,24,184,7.666666666666667,3,11,13,11
15771158.0,267,2573,9.636704119850187,2,12,22,245
15772040.0,67,341,5.08955223880597,2,8,66,1
15779528.0,20,58,2.9,1,5,20,0
15782455.0,78,548,7.0256410256410255,3,10,45,33
15793210.0,533,1599,3.0,1,6,533,0
15795367.0,171,815,4.766081871345029,2,8,170,1
15795938.0,173,352,2.0346820809248554,1,5,173,0
15798049.0,43,286,6.651162790697675,4,10,35,8
15798089.0,21,105,5.0,2,7,21,0
15814017.0,11,95,8.636363636363637,3,12,2,9
15825062.0,157,316,2.0127388535031847,1,5,157,0
15827156.0,323,972,3.0092879256965945,1,6,323,0
15831933.0,46,221,4.804347826086956,2,7,46,0
15831975.0,1,3,3.0,3,3,1,0
15836230.0,280,1951,6.9678571428571425,3,10,189,91
15841192.0,655,3235,4.938931297709924,1,8,651,4
15841225.0,143,300,2.097902097902098,1,5,143,0
15842767.0,58,331,5.706896551724138,2,8,57,1
15847136.0,117,1117,9.547008547008547,3,13,9,108
15852941.0,200,1910,9.55,2,13,14,186
15857341.0,1,4,4.0,4,4,1,0
15862047.0,10,17,1.7,1,3,10,0
15862742.0,5,9,1.8,1,3,5,0
15864256.0,2,5,2.5,1,4,2,0
15868228.0,151,323,2.1390728476821192,1,5,151,0
15891791.0,72,276,3.8333333333333335,1,6,72,0
15895803.0,100,702,7.02,3,9,63,37
15899424.0,166,638,3.8433734939759034,1,6,166,0
15905678.0,3,6,2.0,1,3,3,0
15910901.0,294,622,2.1156462585034013,1,6,294,0
15912938.0,287,854,2.975609756097561,1,6,287,0
15916793.0,1,5,5.0,5,5,1,0
15922934.0,17,35,2.0588235294117645,1,4,17,0
15923933.0,6,11,1.8333333333333333,1,4,6,0
15925772.0,22,130,5.909090909090909,4,8,21,1
15928713.0,19,38,2.0,1,4,19,0
15935395.0,69,136,1.9710144927536233,1,4,69,0
15960496.0,21,109,5.190476190476191,4,7,21,0
15964159.0,30,67,2.2333333333333334,1,4,30,0
15976805.0,5,15,3.0,1,5,5,0
15984990.0,127,375,2.952755905511811,1,6,127,0
15995740.0,178,544,3.056179775280899,1,6,178,0
16014357.0,154,1483,9.62987012987013,3,12,12,142
16015893.0,255,757,2.9686274509803923,1,6,255,0
16023495.0,208,425,2.043269230769231,1,5,208,0
16024004.0,183,360,1.9672131147540983,1,4,183,0
16024977.0,5,20,4.0,2,6,5,0
16025206.0,23,42,1.826086956521739,1,4,23,0
16036174.0,421,858,2.0380047505938244,1,5,421,0
16037846.0,466,1421,3.0493562231759657,1,7,466,0
16038153.0,132,647,4.901515151515151,2,7,132,0
16038916.0,74,349,4.716216216216216,2,8,73,1
16040928.0,348,1348,3.8735632183908044,1,7,348,0
16051714.0,335,1310,3.91044776119403,1,6,335,0
16058604.0,7,15,2.142857142857143,1,4,7,0
16060077.0,37,101,2.72972972972973,1,4,37,0
16064559.0,278,1105,3.9748201438848922,1,7,278,0
16092627.0,144,297,2.0625,1,5,144,0
16093076.0,2,2,1.0,1,1,2,0
16093397.0,21,34,1.619047619047619,1,3,21,0
16120196.0,6,13,2.1666666666666665,1,3,6,0
16122961.0,191,1315,6.884816753926701,2,10,137,54
16134982.0,341,1367,4.008797653958944,2,7,341,0
16141034.0,64,508,7.9375,2,11,17,47
16144069.0,564,3876,6.872340425531915,2,10,408,156
16144315.0,518,3528,6.8108108108108105,2,10,371,147
16144380.0,472,4544,9.627118644067796,2,13,31,441
16146904.0,260,536,2.0615384615384613,1,5,260,0
16151975.0,34,109,3.2058823529411766,1,6,34,0
16152197.0,74,222,3.0,1,5,74,0
16153065.0,150,1291,8.606666666666667,2,11,20,130
16160117.0,93,478,5.139784946236559,2,8,92,1
16162030.0,111,542,4.882882882882883,2,7,111,0
16168583.0,1,1,1.0,1,1,1,0
16169133.0,290,2857,9.851724137931035,3,12,13,277
16174382.0,1,1,1.0,1,1,1,0
16175274.0,268,748,2.791044776119403,1,6,268,0
16183675.0,390,1178,3.0205128205128204,1,6,390,0
16184158.0,13,29,2.230769230769231,1,4,13,0
16184652.0,6,16,2.6666666666666665,2,3,6,0
16184849.0,3,7,2.3333333333333335,1,4,3,0
16186831.0,14,108,7.714285714285714,6,9,4,10
16188541.0,367,2542,6.926430517711172,2,10,251,116
16203444.0,152,219,1.4407894736842106,1,4,152,0
16204437.0,130,181,1.3923076923076922,1,4,130,0
16204754.0,31,297,9.580645161290322,5,12,3,28
16211620.0,436,2962,6.793577981651376,2,10,328,108
16217850.0,180,1222,6.788888888888889,2,10,131,49
16223848.0,7,19,2.7142857142857144,2,4,7,0
16224141.0,8,13,1.625,1,3,8,0
16224901.0,238,1655,6.953781512605042,2,10,162,76
16227154.0,129,390,3.0232558139534884,1,6,129,0
16234394.0,13,36,2.769230769230769,1,6,13,0
16236943.0,273,561,2.0549450549450547,1,5,273,0
16238362.0,1,5,5.0,5,5,1,0
16240425.0,26,135,5.1923076923076925,4,7,26,0
16253187.0,206,1013,4.91747572815534,2,7,206,0
16253767.0,20,38,1.9,1,4,20,0
16257041.0,18,35,1.9444444444444444,1,4,18,0
16257091.0,99,867,8.757575757575758,3,12,11,88
16262260.0,120,166,1.3833333333333333,1,4,120,0
16262670.0,121,173,1.4297520661157024,1,4,121,0
16263103.0,755,7315,9.688741721854305,2,13,40,715
16264717.0,1,4,4.0,4,4,1,0
16268858.0,202,1005,4.975247524752476,2,8,200,2
16278854.0,850,5751,6.765882352941176,2,10,611,239
16282155.0,68,411,6.044117647058823,3,9,61,7
16286152.0,86,190,2.2093023255813953,1,5,86,0
16286535.0,316,955,3.0221518987341773,1,6,316,0
16286591.0,347,3325,9.5821325648415,2,13,23,324
16287504.0,51,68,1.3333333333333333,1,3,51,0
16297481.0,178,1698,9.539325842696629,2,13,14,164
16300463.0,1,4,4.0,4,4,1,0
16301517.0,121,253,2.090909090909091,1,5,121,0
16305644.0,5,13,2.6,2,3,5,0
16309168.0,52,150,2.8846153846153846,1,5,52,0
16309813.0,472,956,2.0254237288135593,1,5,472,0
16310571.0,274,2625,9.58029197080292,2,12,21,253
16320249.0,110,307,2.790909090909091,1,5,110,0
16320318.0,44,319,7.25,5,9,27,17
16320740.0,6,39,6.5,4,8,4,2
16332853.0,16,76,4.75,2,6,16,0
16334929.0,99,773,7.808080808080808,2,11,31,68
16335316.0,114,566,4.964912280701754,3,8,111,3
16342266.0,261,530,2.0306513409961684,1,5,261,0
16347537.0,438,3019,6.892694063926941,2,10,303,135
16347812.0,62,243,3.9193548387096775,1,6,62,0
16356985.0,218,477,2.188073394495413,1,5,218,0
16358501.0,192,391,2.0364583333333335,1,5,192,0
16358569.0,19,34,1.7894736842105263,1,3,19,0
16359511.0,45,258,5.733333333333333,2,7,45,0
16361123.0,55,389,7.072727272727272,4,9,37,18
16361789.0,263,535,2.0342205323193916,1,4,263,0
16376241.0,345,1055,3.0579710144927534,1,6,345,0
16380523.0,57,165,2.8947368421052633,1,7,57,0
16386018.0,173,366,2.115606936416185,1,4,173,0
16388098.0,25,161,6.44,2,8,19,6
16389873.0,1,5,5.0,5,5,1,0
16390482.0,3,3,1.0,1,1,3,0
16400408.0,171,837,4.894736842105263,2,8,170,1
16419818.0,250,2394,9.576,2,12,19,231
16420622.0,3,21,7.0,7,7,3,0
16423991.0,105,145,1.380952380952381,1,3,105,0
16444826.0,54,118,2.185185185185185,1,4,54,0
16446376.0,266,1299,4.883458646616542,2,8,263,3
16447010.0,137,957,6.985401459854015,2,9,89,48
16449303.0,66,334,5.0606060606060606,2,7,66,0
16450507.0,360,741,2.058333333333333,1,5,360,0
16450987.0,140,1313,9.378571428571428,2,13,12,128
16451687.0,426,2955,6.936619718309859,2,10,300,126
16451814.0,324,976,3.0123456790123457,1,6,324,0
16460104.0,55,327,5.945454545454545,3,8,50,5
16464086.0,204,816,4.0,2,7,204,0
16464496.0,451,938,2.079822616407982,1,5,451,0
16465447.0,41,96,2.341463414634146,1,4,41,0
16466310.0,114,242,2.1228070175438596,1,5,114,0
16473889.0,208,1643,7.899038461538462,2,11,68,140
16476063.0,239,1864,7.799163179916318,3,11,81,158
16477740.0,438,4204,9.598173515981735,2,13,29,409
16478353.0,376,2528,6.723404255319149,2,10,265,111
16484263.0,30,199,6.633333333333334,3,10,25,5
16485327.0,13,26,2.0,1,3,13,0
16489890.0,184,558,3.032608695652174,1,5,184,0
16490785.0,210,803,3.823809523809524,1,7,210,0
16513508.0,52,256,4.923076923076923,3,8,51,1
16515995.0,216,1477,6.837962962962963,2,9,160,56
16517267.0,16,21,1.3125,1,3,16,0
16517730.0,2,4,2.0,2,2,2,0
16518383.0,318,644,2.0251572327044025,1,5,318,0
16542257.0,104,146,1.4038461538461537,1,4,104,0
16543166.0,284,589,2.073943661971831,1,5,284,0
16545701.0,15,43,2.8666666666666667,1,4,15,0
16550718.0,22,27,1.2272727272727273,1,2,22,0
16551779.0,313,2459,7.856230031948882,2,11,99,214
16552438.0,459,1427,3.1089324618736383,1,6,459,0
16567166.0,28,40,1.4285714285714286,1,3,28,0
16568261.0,411,3969,9.656934306569344,2,13,23,388
16568683.0,56,383,6.839285714285714,4,9,41,15
16569168.0,52,360,6.923076923076923,3,10,35,17
16569915.0,485,978,2.0164948453608247,1,5,485,0
16572986.0,61,85,1.3934426229508197,1,4,61,0
16581172.0,85,239,2.8117647058823527,1,5,85,0
16596657.0,133,1051,7.902255639097745,2,10,45,88
16646591.0,83,250,3.0120481927710845,1,5,83,0
16656383.0,186,244,1.3118279569892473,1,3,186,0
16657013.0,3,6,2.0,1,3,3,0
16657871.0,246,1662,6.7560975609756095,2,10,189,57
16669645.0,6,38,6.333333333333333,5,8,5,1
16670554.0,322,1611,5.003105590062112,1,8,321,1
16674281.0,22,60,2.727272727272727,1,4,22,0
16675905.0,830,1740,2.0963855421686746,1,5,830,0
16687146.0,310,921,2.970967741935484,1,6,310,0
16697242.0,19,44,2.3157894736842106,1,4,19,0
16697507.0,544,5259,9.667279411764707,2,13,35,509
16700580.0,173,1344,7.76878612716763,2,10,63,110
16704257.0,78,224,2.871794871794872,1,5,78,0
16705343.0,311,1520,4.887459807073955,2,8,309,2
16705772.0,3,4,1.3333333333333333,1,2,3,0
16730052.0,38,194,5.105263157894737,2,7,38,0
16734138.0,388,1902,4.902061855670103,2,8,384,4
16734324.0,37,74,2.0,1,4,37,0
16736997.0,74,219,2.9594594594594597,1,6,74,0
16754837.0,112,997,8.901785714285714,2,12,13,99
16755527.0,70,535,7.642857142857143,2,10,29,41
16763469.0,97,126,1.2989690721649485,1,3,97,0
16765385.0,88,182,2.0681818181818183,1,4,88,0
16768677.0,4,8,2.0,1,3,4,0
16768927.0,214,845,3.9485981308411215,1,6,214,0
16780685.0,140,715,5.107142857142857,2,8,139,1
16823818.0,1,7,7.0,7,7,1,0
16855096.0,1,2,2.0,2,2,1,0
16856290.0,108,541,5.0092592592592595,2,7,108,0
16856445.0,380,775,2.039473684210526,1,5,380,0
16865230.0,97,204,2.1030927835051547,1,5,97,0
16867707.0,216,1472,6.814814814814815,2,9,150,66
16868660.0,46,267,5.804347826086956,2,9,44,2
16869068.0,381,3333,8.748031496062993,2,12,48,333
16870313.0,2,4,2.0,1,3,2,0
16875193.0,41,131,3.1951219512195124,1,5,41,0
16876870.0,166,818,4.927710843373494,1,7,166,0
16882494.0,404,3884,9.613861386138614,2,13,26,378
16894247.0,87,428,4.919540229885057,2,7,87,0
16895303.0,111,547,4.927927927927928,3,8,110,1
16906233.0,147,1016,6.91156462585034,4,11,109,38
16907268.0,323,676,2.0928792569659445,1,5,323,0
16908402.0,3,8,2.6666666666666665,2,3,3,0
16909270.0,474,954,2.0126582278481013,1,5,474,0
16913574.0,294,1699,5.77891156462585,2,9,278,16
16914890.0,142,301,2.119718309859155,1,5,142,0
16924691.0,263,1305,4.961977186311787,2,8,261,2
16928117.0,119,819,6.882352941176471,2,10,84,35
16928503.0,133,637,4.7894736842105265,2,8,131,2
16930839.0,12,66,5.5,2,7,12,0
16936208.0,12,26,2.1666666666666665,1,4,12,0
16936400.0,1,3,3.0,3,3,1,0
16937465.0,79,176,2.2278481012658227,1,4,79,0
16940671.0,30,65,2.1666666666666665,1,4,30,0
16940985.0,259,2232,8.617760617760618,2,12,29,230
16942481.0,114,329,2.8859649122807016,1,5,114,0
16943785.0,54,371,6.87037037037037,2,10,37,17
16944475.0,64,88,1.375,1,3,64,0
16949857.0,241,2316,9.609958506224066,2,13,17,224
16961066.0,9,18,2.0,1,3,9,0
16967680.0,127,1220,9.606299212598426,2,13,8,119
16970252.0,48,326,6.791666666666667,5,9,41,7
16970352.0,176,530,3.0113636363636362,1,6,176,0
16971324.0,16,99,6.1875,2,8,13,3
16973227.0,70,142,2.0285714285714285,1,4,70,0
16978213.0,95,193,2.031578947368421,1,5,95,0
16988556.0,249,2389,9.594377510040161,2,12,21,228
16989663.0,69,284,4.115942028985507,1,6,69,0
16993980.0,328,1603,4.887195121951219,2,8,326,2
17003123.0,375,743,1.9813333333333334,1,5,375,0
17003185.0,6,20,3.3333333333333335,1,5,6,0
17006923.0,1,7,7.0,7,7,1,0
17019062.0,5,14,2.8,1,4,5,0
17019510.0,11,20,1.8181818181818181,1,4,11,0
17020361.0,61,120,1.9672131147540983,1,5,61,0
17021343.0,108,554,5.12962962962963,3,8,106,2
17027238.0,438,3030,6.917808219178082,2,10,295,143
17027532.0,73,152,2.0821917808219177,1,5,73,0
17030232.0,260,541,2.080769230769231,1,5,260,0
17032306.0,299,1174,3.9264214046822743,1,7,299,0
17032903.0,49,250,5.1020408163265305,2,8,48,1
17041453.0,223,1917,8.596412556053812,2,11,34,189
17041622.0,583,5617,9.634648370497427,2,13,39,544
17042354.0,565,5457,9.658407079646018,2,14,38,527
17047018.0,417,1218,2.920863309352518,1,6,417,0
17051223.0,161,795,4.937888198757764,2,9,158,3
17071309.0,257,1024,3.9844357976653697,1,8,256,1
17101617.0,322,3045,9.456521739130435,2,12,21,301
17107343.0,62,416,6.709677419354839,4,9,49,13
17121956.0,116,1109,9.560344827586206,2,12,9,107
17123595.0,1,3,3.0,3,3,1,0
17128102.0,41,123,3.0,1,5,41,0
17133030.0,228,469,2.057017543859649,1,5,228,0
17135724.0,85,803,9.447058823529412,5,12,7,78
17150691.0,14,127,9.071428571428571,8,11,0,14
17152296.0,504,4868,9.658730158730158,2,13,31,473
17152449.0,3,3,1.0,1,1,3,0
17166723.0,503,4401,8.749502982107355,2,12,60,443
17168215.0,186,1779,9.564516129032258,2,12,13,173
17174817.0,394,1564,3.969543147208122,1,7,394,0
17182264.0,337,674,2.0,1,5,337,0
17182431.0,3,6,2.0,1,3,3,0
17182598.0,18,39,2.1666666666666665,1,3,18,0
17186053.0,468,4571,9.767094017094017,2,13,28,440
17186188.0,1,2,2.0,2,2,1,0
17186613.0,391,3769,9.639386189258312,2,12,25,366
17197503.0,242,512,2.115702479338843,1,5,242,0
17205668.0,163,824,5.0552147239263805,2,7,163,0
17209498.0,201,424,2.109452736318408,1,5,201,0
17210137.0,10,17,1.7,1,3,10,0
17215188.0,119,593,4.983193277310924,2,7,119,0
17216563.0,84,737,8.773809523809524,3,12,12,72
17220116.0,231,1126,4.874458874458875,2,8,230,1
17233769.0,15,111,7.4,6,9,8,7
17234035.0,31,92,2.967741935483871,2,5,31,0
17235126.0,5,5,1.0,1,1,5,0
17236501.0,21,93,4.428571428571429,3,6,21,0
17243915.0,281,1409,5.01423487544484,2,8,278,3
17244583.0,286,2472,8.643356643356643,2,12,37,249
17244916.0,343,1732,5.049562682215743,2,8,342,1
17244920.0,30,92,3.066666666666667,1,4,30,0
17247562.0,232,477,2.0560344827586206,1,5,232,0
17259719.0,17,34,2.0,1,4,17,0
17262555.0,499,2455,4.919839679358717,2,8,495,4
17262735.0,524,2598,4.958015267175573,2,8,520,4
17266861.0,264,2600,9.848484848484848,2,13,13,251
17273434.0,78,374,4.794871794871795,2,8,77,1
17274144.0,252,769,3.0515873015873014,1,6,252,0
17277394.0,319,2479,7.77115987460815,2,10,111,208
17281679.0,115,769,6.6869565217391305,2,9,85,30
17281972.0,343,724,2.110787172011662,1,5,343,0
17285106.0,120,486,4.05,1,6,120,0
17290793.0,272,2603,9.569852941176471,2,13,19,253
17299085.0,62,538,8.67741935483871,3,12,10,52
17306054.0,28,181,6.464285714285714,3,9,22,6
17307472.0,375,758,2.021333333333333,1,5,375,0
17309009.0,5,14,2.8,2,5,5,0
17324637.0,217,461,2.1244239631336406,1,5,217,0
17326165.0,71,656,9.23943661971831,2,12,8,63
17327586.0,190,1823,9.594736842105263,2,13,15,175
17328265.0,6,18,3.0,2,5,6,0
17329473.0,321,2179,6.788161993769471,2,10,233,88
17335270.0,167,836,5.005988023952096,2,7,167,0
17342908.0,409,2004,4.899755501222494,2,8,408,1
17350984.0,37,365,9.864864864864865,8,12,0,37
17354554.0,32,245,7.65625,3,10,13,19
17362722.0,103,308,2.9902912621359223,1,5,103,0
17367026.0,8,18,2.25,1,3,8,0
17375880.0,35,80,2.2857142857142856,1,5,35,0
17378294.0,187,575,3.0748663101604277,1,5,187,0
17382462.0,28,200,7.142857142857143,5,9,19,9
17385124.0,99,202,2.04040404040404,1,4,99,0
17385452.0,10,68,6.8,5,8,7,3
17399586.0,56,524,9.357142857142858,2,12,4,52
17411473.0,18,169,9.38888888888889,4,12,1,17
17418353.0,271,582,2.1476014760147604,1,4,271,0
17432436.0,217,2090,9.631336405529954,2,12,9,208
17453051.0,356,1750,4.915730337078652,2,8,355,1
17454279.0,159,481,3.0251572327044025,1,6,159,0
17455886.0,14,94,6.714285714285714,5,8,11,3
17455901.0,281,1369,4.871886120996441,2,8,277,4
17455908.0,78,606,7.769230769230769,2,10,25,53
17460765.0,98,868,8.857142857142858,2,11,6,92
17469547.0,25,104,4.16,2,6,25,0
17476489.0,1,2,2.0,2,2,1,0
17478076.0,445,3425,7.696629213483146,2,11,156,289
17478689.0,39,121,3.1025641025641026,1,5,39,0
17480108.0,3,6,2.0,1,3,3,0
17488720.0,20,50,2.5,1,5,20,0
17494323.0,15,30,2.0,1,4,15,0
17497401.0,34,130,3.823529411764706,2,6,34,0
17502428.0,44,84,1.9090909090909092,1,4,44,0
17505787.0,226,1094,4.84070796460177,2,8,225,1
17508461.0,2,8,4.0,3,5,2,0
17517955.0,74,298,4.027027027027027,1,7,74,0
17527525.0,240,940,3.9166666666666665,1,8,239,1
17529455.0,75,154,2.0533333333333332,1,5,75,0
17529859.0,306,1562,5.104575163398692,2,8,305,1
17531132.0,298,2326,7.805369127516778,2,11,98,200
17535577.0,257,1276,4.964980544747082,2,8,254,3
17541183.0,230,2205,9.58695652173913,2,12,19,211
17542914.0,283,1382,4.88339222614841,2,7,283,0
17553971.0,219,1088,4.968036529680365,2,7,219,0
17559373.0,19,96,5.052631578947368,3,7,19,0
17567666.0,1,2,2.0,2,2,1,0
17571687.0,67,652,9.73134328358209,2,12,4,63
17573532.0,308,2999,9.737012987012987,2,13,12,296
17580285.0,608,5833,9.59375,2,13,44,564
17581243.0,147,1038,7.061224489795919,2,10,96,51
17587681.0,164,495,3.018292682926829,1,6,164,0
17596402.0,46,323,7.021739130434782,5,10,30,16
17597559.0,82,409,4.987804878048781,2,7,82,0
17598320.0,16,20,1.25,1,2,16,0
17599456.0,182,546,3.0,1,5,182,0
17599686.0,81,123,1.5185185185185186,1,4,81,0
17608738.0,271,1350,4.981549815498155,2,9,267,4
17614795.0,96,196,2.0416666666666665,1,4,96,0
17615538.0,33,67,2.0303030303030303,1,4,33,0
17618461.0,232,472,2.0344827586206895,1,5,232,0
17619720.0,211,440,2.085308056872038,1,5,211,0
17620369.0,64,504,7.875,5,10,20,44
17621675.0,31,59,1.903225806451613,1,4,31,0
17629864.0,450,920,2.0444444444444443,1,5,450,0
17632114.0,27,197,7.296296296296297,5,10,15,12
17645452.0,426,912,2.140845070422535,1,4,426,0
17645632.0,144,443,3.076388888888889,1,6,144,0
17651708.0,3,4,1.3333333333333333,1,2,3,0
17651985.0,21,30,1.4285714285714286,1,3,21,0
17660501.0,267,799,2.99250936329588,1,5,267,0
17662147.0,20,122,6.1,2,9,16,4
17662475.0,126,370,2.9365079365079363,1,6,126,0
17676026.0,38,260,6.842105263157895,3,9,25,13
17676478.0,33,231,7.0,3,10,22,11
17676506.0,2,3,1.5,1,2,2,0
17679480.0,130,1223,9.407692307692308,3,13,15,115
17681067.0,222,2136,9.621621621621621,2,12,16,206
17681447.0,181,1402,7.745856353591161,2,10,59,122
17685180.0,207,1438,6.946859903381642,2,10,140,67
17692661.0,43,106,2.4651162790697674,1,5,43,0
17695435.0,31,101,3.2580645161290325,1,5,31,0
17696312.0,54,107,1.9814814814814814,1,4,54,0
17706864.0,2,8,4.0,3,5,2,0
17709941.0,43,88,2.046511627906977,1,4,43,0
17713513.0,425,2047,4.816470588235294,2,8,422,3
17715586.0,245,1213,4.951020408163266,2,8,243,2
17716763.0,406,3911,9.633004926108374,2,13,26,380
17717233.0,280,2432,8.685714285714285,2,12,30,250
17717518.0,542,2639,4.869003690036901,2,8,540,2
17717692.0,464,4071,8.773706896551724,2,12,47,417
17728362.0,298,2307,7.741610738255034,2,11,105,193
17728900.0,2,21,10.5,10,11,0,2
17735333.0,884,6126,6.929864253393665,2,12,610,274
17735646.0,218,1872,8.587155963302752,2,12,41,177
17743640.0,160,1112,6.95,2,10,109,51
17755059.0,144,1099,7.631944444444445,3,11,57,87
17757664.0,136,918,6.75,2,9,102,34
17758557.0,262,1293,4.935114503816794,2,8,260,2
17765189.0,394,3424,8.690355329949238,2,11,55,339
17765425.0,92,195,2.119565217391304,1,4,92,0
17769404.0,15,47,3.1333333333333333,1,5,15,0
17774070.0,28,66,2.357142857142857,1,5,28,0
17776165.0,21,43,2.0476190476190474,1,4,21,0
17782505.0,66,523,7.924242424242424,5,10,22,44
17783220.0,151,322,2.1324503311258276,1,4,151,0
17784390.0,130,641,4.930769230769231,2,7,130,0
17791113.0,38,307,8.078947368421053,3,11,14,24
17791510.0,148,718,4.851351351351352,2,8,146,2
17797538.0,116,793,6.836206896551724,4,10,87,29
17802640.0,141,298,2.1134751773049647,1,4,141,0
17802908.0,4,11,2.75,2,4,4,0
17817066.0,1,3,3.0,3,3,1,0
17825390.0,5,13,2.6,1,4,5,0
17825573.0,98,211,2.1530612244897958,1,5,98,0
17828433.0,19,37,1.9473684210526316,1,4,19,0
17834351.0,30,242,8.066666666666666,5,10,8,22
17836144.0,3,9,3.0,2,4,3,0
17838023.0,8,16,2.0,1,4,8,0
17839866.0,7,21,3.0,2,4,7,0
17840282.0,3,7,2.3333333333333335,1,3,3,0
17840320.0,1,2,2.0,2,2,1,0
17840910.0,4,38,9.5,9,10,0,4
17843827.0,315,2151,6.828571428571428,2,9,228,87
17846666.0,40,59,1.475,1,3,40,0
17853779.0,24,57,2.375,1,4,24,0
17854145.0,197,1861,9.446700507614214,2,12,18,179
17859877.0,4,7,1.75,1,3,4,0
17860716.0,425,2107,4.95764705882353,2,8,423,2
17861397.0,124,1192,9.612903225806452,2,12,7,117
17871125.0,6,41,6.833333333333333,6,7,6,0
17874233.0,263,1799,6.840304182509506,2,10,180,83
17878810.0,59,179,3.0338983050847457,1,5,59,0
17883297.0,17,97,5.705882352941177,4,8,16,1
17885186.0,528,2605,4.933712121212121,2,8,523,5
17886534.0,98,665,6.785714285714286,4,9,68,30
17886861.0,137,1300,9.489051094890511,2,12,12,125
17891928.0,72,160,2.2222222222222223,1,5,72,0
17892372.0,29,64,2.206896551724138,1,4,29,0
17896398.0,293,1444,4.928327645051194,2,8,291,2
17897804.0,373,1863,4.994638069705094,2,8,372,1
17898001.0,131,637,4.862595419847328,2,7,131,0
17899473.0,128,624,4.875,2,8,126,2
17900282.0,32,62,1.9375,1,4,32,0
17903077.0,20,161,8.05,4,10,5,15
17903863.0,178,884,4.966292134831461,2,8,177,1
17914266.0,518,2556,4.934362934362935,2,8,515,3
17917418.0,364,2497,6.8598901098901095,2,10,260,104
17930771.0,218,1077,4.940366972477064,1,7,218,0
17932739.0,283,571,2.0176678445229683,1,5,283,0
17933443.0,248,512,2.064516129032258,1,4,248,0
17933497.0,64,570,8.90625,4,11,6,58
17935348.0,177,347,1.96045197740113,1,4,177,0
17937063.0,355,2413,6.79718309859155,2,10,259,96
17938385.0,119,929,7.80672268907563,2,11,41,78
17939045.0,16,34,2.125,1,4,16,0
17955687.0,3,6,2.0,1,3,3,0
17959385.0,132,391,2.962121212121212,1,6,132,0
17960977.0,28,267,9.535714285714286,4,12,4,24
17968767.0,226,662,2.9292035398230087,1,6,226,0
17973836.0,2,5,2.5,2,3,2,0
17978148.0,154,446,2.896103896103896,1,6,154,0
17979142.0,76,360,4.7368421052631575,2,7,76,0
17982210.0,424,4091,9.648584905660377,2,13,23,401
17985694.0,255,763,2.992156862745098,1,6,255,0
17988020.0,404,1577,3.9034653465346536,1,7,404,0
17988142.0,570,2794,4.901754385964912,2,8,567,3
17993535.0,36,348,9.666666666666666,2,12,3,33
18001589.0,1,4,4.0,4,4,1,0
18003944.0,392,1951,4.9770408163265305,2,8,390,2
18007029.0,332,978,2.9457831325301207,1,5,332,0
18007530.0,201,409,2.0348258706467663,1,6,201,0
18011722.0,1,1,1.0,1,1,1,0
18011822.0,161,1103,6.850931677018633,2,10,109,52
18012048.0,53,213,4.018867924528302,1,6,53,0
18012163.0,166,947,5.704819277108434,2,9,156,10
18016295.0,253,2202,8.703557312252965,2,12,22,231
18019998.0,297,1463,4.925925925925926,2,8,295,2
18022249.0,136,1327,9.757352941176471,2,12,4,132
18024767.0,3,4,1.3333333333333333,1,2,3,0
18027290.0,11,37,3.3636363636363638,1,5,11,0
18029476.0,6,42,7.0,3,9,3,3
18030968.0,114,341,2.991228070175439,1,6,114,0
18032664.0,220,862,3.918181818181818,2,7,220,0
18037665.0,68,203,2.985294117647059,1,6,68,0
18039199.0,2,5,2.5,1,4,2,0
18045454.0,6,15,2.5,1,4,6,0
18046510.0,63,119,1.8888888888888888,1,4,63,0
18049992.0,7,11,1.5714285714285714,1,2,7,0
18051043.0,1,4,4.0,4,4,1,0
18055157.0,50,193,3.86,2,6,50,0
18062732.0,60,238,3.966666666666667,2,7,60,0
18064894.0,28,264,9.428571428571429,2,11,2,26
18067139.0,43,99,2.302325581395349,1,5,43,0
18067583.0,178,380,2.134831460674157,1,6,178,0
18068203.0,2,3,1.5,1,2,2,0
18070118.0,52,504,9.692307692307692,3,12,5,47
18071804.0,10,35,3.5,2,5,10,0
18075317.0,15,30,2.0,1,3,15,0
18087363.0,289,593,2.0519031141868513,1,5,289,0
18092890.0,8,14,1.75,1,3,8,0
18093383.0,775,3843,4.958709677419355,1,8,771,4
18100690.0,508,3518,6.925196850393701,2,11,340,168
18103406.0,119,259,2.176470588235294,1,5,119,0
18104115.0,6,8,1.3333333333333333,1,2,6,0
18105409.0,516,5002,9.693798449612403,2,13,35,481
18107547.0,55,108,1.9636363636363636,1,4,55,0
18107706.0,1,1,1.0,1,1,1,0
18108055.0,59,354,6.0,2,9,52,7
18109185.0,70,479,6.8428571428571425,2,9,47,23
18109842.0,135,298,2.2074074074074073,1,5,135,0
18110697.0,197,268,1.3604060913705585,1,4,197,0
18112384.0,174,851,4.890804597701149,2,8,173,1
18116356.0,6,11,1.8333333333333333,1,3,6,0
18117468.0,61,297,4.868852459016393,2,8,60,1
18124366.0,57,84,1.4736842105263157,1,4,57,0
18128838.0,43,130,3.0232558139534884,1,5,43,0
18133683.0,309,928,3.0032362459546924,1,7,309,0
18138319.0,200,400,2.0,1,5,200,0
18138583.0,1,2,2.0,2,2,1,0
18138585.0,293,613,2.092150170648464,1,4,293,0
18144362.0,284,1927,6.785211267605634,2,10,218,66
18145719.0,279,2682,9.612903225806452,3,13,20,259
18145824.0,88,608,6.909090909090909,2,10,64,24
18146906.0,232,1977,8.52155172413793,2,12,38,194
18147028.0,23,63,2.739130434782609,1,5,23,0
18147455.0,131,291,2.2213740458015265,1,5,131,0
18149388.0,212,434,2.047169811320755,1,5,212,0
18150360.0,201,426,2.1194029850746268,1,5,201,0
18150468.0,17,37,2.176470588235294,1,4,17,0
18150744.0,353,736,2.084985835694051,1,5,353,0
18151509.0,61,80,1.3114754098360655,1,3,61,0
18153771.0,205,1621,7.907317073170732,2,10,58,147
18155070.0,385,2602,6.758441558441558,2,10,285,100
18157287.0,120,379,3.158333333333333,1,6,120,0
18157839.0,82,112,1.3658536585365855,1,4,82,0
18157874.0,119,372,3.1260504201680672,1,5,119,0
18164030.0,29,197,6.793103448275862,4,9,20,9
18165743.0,408,3571,8.752450980392156,2,12,47,361
18170275.0,212,1046,4.933962264150943,2,8,211,1
18183989.0,20,44,2.2,1,3,20,0
18189771.0,283,1943,6.865724381625442,2,10,199,84
18190138.0,45,294,6.533333333333333,3,10,36,9
18192922.0,18,42,2.3333333333333335,1,5,18,0
18193204.0,173,848,4.901734104046243,2,8,169,4
18194776.0,10,16,1.6,1,3,10,0
18201293.0,404,3873,9.586633663366337,2,13,24,380
18209826.0,268,2638,9.843283582089553,2,13,17,251
18210181.0,198,1894,9.565656565656566,2,13,13,185
18237903.0,32,260,8.125,4,11,8,24
18246902.0,197,790,4.01015228426396,1,7,197,0
18248531.0,45,391,8.688888888888888,2,10,5,40
18250369.0,326,1302,3.9938650306748467,1,7,326,0
18251416.0,108,741,6.861111111111111,2,9,76,32
18252446.0,422,3293,7.803317535545023,2,11,144,278
18253375.0,147,319,2.1700680272108843,1,5,147,0
18260240.0,601,5799,9.64891846921797,2,13,37,564
18265707.0,457,3544,7.75492341356674,2,10,161,296
18269419.0,63,317,5.031746031746032,3,7,63,0
18271284.0,265,2543,9.596226415094339,2,13,17,248
18274047.0,188,759,4.037234042553192,1,7,188,0
18278565.0,309,2139,6.922330097087379,2,11,212,97
18283473.0,213,452,2.1220657276995305,1,5,213,0
18301694.0,201,427,2.1243781094527363,1,5,201,0
18304295.0,197,1873,9.50761421319797,2,14,18,179
18304952.0,285,1419,4.978947368421053,2,7,285,0
18305543.0,359,1383,3.852367688022284,1,7,359,0
18308268.0,6,13,2.1666666666666665,1,4,6,0
18337725.0,101,718,7.108910891089109,3,10,65,36
18343092.0,10,10,1.0,1,1,10,0
18347276.0,6,42,7.0,6,8,4,2
18351607.0,31,63,2.032258064516129,1,4,31,0
18355060.0,218,663,3.041284403669725,1,5,218,0
18359346.0,19,28,1.4736842105263157,1,3,19,0
18359971.0,5,12,2.4,2,3,5,0
18364639.0,348,1702,4.890804597701149,2,8,347,1
18374398.0,58,414,7.137931034482759,4,9,39,19
18375181.0,209,448,2.1435406698564594,1,5,209,0
18381343.0,160,791,4.94375,2,8,158,2
18385355.0,471,1871,3.9723991507430996,1,7,471,0
18398638.0,121,603,4.983471074380165,2,7,121,0
18399333.0,109,723,6.63302752293578,2,9,85,24
18399595.0,2,6,3.0,3,3,2,0
18401587.0,126,176,1.3968253968253967,1,4,126,0
18404226.0,68,486,7.147058823529412,4,9,47,21
18405744.0,91,446,4.9010989010989015,2,8,90,1
18411330.0,78,607,7.782051282051282,2,11,26,52
18420272.0,158,772,4.886075949367089,2,8,157,1
18421975.0,320,1592,4.975,2,8,316,4
18423711.0,49,65,1.3265306122448979,1,3,49,0
18423794.0,341,2357,6.912023460410557,2,10,243,98
18428211.0,75,161,2.1466666666666665,1,5,75,0
18430447.0,136,544,4.0,2,6,136,0
18430465.0,18,57,3.1666666666666665,2,5,18,0
18439923.0,129,1100,8.527131782945736,2,11,18,111
18443731.0,167,495,2.964071856287425,1,5,167,0
18445633.0,162,495,3.0555555555555554,1,6,162,0
18452491.0,228,2225,9.758771929824562,2,13,10,218
18453184.0,122,1069,8.762295081967213,3,12,15,107
18454806.0,227,465,2.048458149779736,1,5,227,0
18458433.0,16,87,5.4375,3,7,16,0
18470166.0,104,814,7.826923076923077,2,11,35,69
18474084.0,197,775,3.934010152284264,1,6,197,0
18474323.0,549,4835,8.806921675774134,2,13,56,493
18475379.0,49,341,6.959183673469388,5,9,32,17
18475386.0,77,549,7.12987012987013,5,9,45,32
18479125.0,150,1155,7.7,2,11,56,94
18481018.0,1,4,4.0,4,4,1,0
18482971.0,295,2045,6.932203389830509,2,10,205,90
18484414.0,3,17,5.666666666666667,5,6,3,0
18484767.0,115,1097,9.539130434782608,3,12,8,107
18484807.0,5,19,3.8,3,4,5,0
18488845.0,61,132,2.1639344262295084,1,4,61,0
18499262.0,146,1425,9.76027397260274,2,13,9,137
18501380.0,696,2749,3.949712643678161,1,6,696,0
18502845.0,315,2988,9.485714285714286,2,13,26,289
18511884.0,17,47,2.764705882352941,1,5,17,0
18514352.0,75,579,7.72,2,10,25,50
18516313.0,152,756,4.973684210526316,2,7,152,0
18516614.0,89,265,2.9775280898876404,1,5,89,0
18521622.0,4,10,2.5,2,3,4,0
18521768.0,7,34,4.857142857142857,4,7,7,0
18524450.0,49,327,6.673469387755102,3,9,39,10
18532919.0,3,19,6.333333333333333,4,9,2,1
18540086.0,155,763,4.922580645161291,2,7,155,0
18542749.0,38,205,5.394736842105263,3,8,36,2
18544199.0,55,533,9.690909090909091,3,12,2,53
18547065.0,346,699,2.020231213872832,1,5,346,0
18547097.0,18,115,6.388888888888889,2,8,14,4
18553440.0,2,2,1.0,1,1,2,0
18554594.0,69,631,9.144927536231885,3,12,4,65
18558906.0,7,49,7.0,6,8,5,2
18559867.0,100,503,5.03,2,8,99,1
18559980.0,488,4742,9.717213114754099,2,13,25,463
18560684.0,104,305,2.9326923076923075,1,5,104,0
18562237.0,78,164,2.1025641025641026,1,4,78,0
18576199.0,35,103,2.942857142857143,1,5,35,0
18579388.0,229,1966,8.585152838427948,2,11,30,199
18580528.0,68,339,4.985294117647059,3,7,68,0
18588925.0,56,274,4.892857142857143,2,7,56,0
18610667.0,237,478,2.0168776371308015,1,5,237,0
18611284.0,37,183,4.945945945945946,3,7,37,0
18614168.0,12,26,2.1666666666666665,1,5,12,0
18620031.0,15,73,4.866666666666666,3,7,15,0
18622049.0,336,3254,9.68452380952381,2,13,18,318
18622741.0,277,1358,4.902527075812275,2,8,275,2
18628006.0,2,5,2.5,2,3,2,0
18631940.0,41,85,2.073170731707317,1,4,41,0
18634925.0,105,722,6.876190476190477,2,9,75,30
18635333.0,307,1504,4.899022801302932,2,8,305,2
18644148.0,272,1352,4.970588235294118,2,8,270,2
18651669.0,104,311,2.9903846153846154,1,5,104,0
18652834.0,100,206,2.06,1,5,100,0
18661562.0,163,1622,9.950920245398773,5,14,3,160
18662487.0,3,8,2.6666666666666665,2,3,3,0
18663087.0,239,1179,4.933054393305439,2,9,238,1
18667319.0,1,2,2.0,2,2,1,0
18684628.0,4,10,2.5,2,3,4,0
18687664.0,240,1182,4.925,2,8,239,1
18688866.0,442,913,2.065610859728507,1,5,442,0
18698423.0,173,519,3.0,1,6,173,0
18701268.0,1,3,3.0,3,3,1,0
18702360.0,694,1480,2.132564841498559,1,5,694,0
18709964.0,7,53,7.571428571428571,7,8,3,4
18710977.0,77,234,3.038961038961039,1,6,77,0
18712658.0,207,441,2.130434782608696,1,5,207,0
18719337.0,402,2755,6.853233830845771,2,10,276,126
18723334.0,339,1030,3.03834808259587,1,6,339,0
18729645.0,80,168,2.1,1,5,80,0
18731637.0,248,2386,9.620967741935484,2,12,17,231
18731837.0,368,3157,8.578804347826088,2,11,56,312
18735064.0,2,7,3.5,3,4,2,0
18735462.0,34,147,4.323529411764706,3,6,34,0
18740855.0,287,2495,8.693379790940767,2,12,35,252
18741251.0,18,58,3.2222222222222223,1,5,18,0
18742589.0,20,41,2.05,1,5,20,0
18750292.0,12,32,2.6666666666666665,1,4,12,0
18751303.0,194,966,4.979381443298969,2,8,193,1
18752674.0,177,868,4.903954802259887,2,8,176,1
18752763.0,9,27,3.0,1,4,9,0
18753757.0,75,718,9.573333333333334,5,12,4,71
18762925.0,167,819,4.904191616766467,2,8,166,1
18770632.0,3,8,2.6666666666666665,2,4,3,0
18770769.0,56,389,6.946428571428571,5,9,41,15
18779998.0,216,653,3.0231481481481484,1,6,216,0
18781700.0,82,733,8.939024390243903,6,11,7,75
18788316.0,62,613,9.887096774193548,7,12,1,61
18788862.0,9,50,5.555555555555555,4,7,9,0
18790389.0,212,1056,4.981132075471698,2,8,207,5
18791961.0,313,1225,3.913738019169329,1,7,313,0
18798332.0,30,60,2.0,1,3,30,0
18800052.0,300,641,2.1366666666666667,1,5,300,0
18803097.0,4,6,1.5,1,2,4,0
18803182.0,245,508,2.073469387755102,1,4,245,0
18805131.0,55,159,2.890909090909091,1,5,55,0
18808253.0,1,4,4.0,4,4,1,0
18810052.0,36,101,2.8055555555555554,1,5,36,0
18816591.0,63,122,1.9365079365079365,1,4,63,0
18818015.0,27,81,3.0,1,5,27,0
18818916.0,213,866,4.065727699530516,2,7,213,0
18823896.0,91,195,2.142857142857143,1,5,91,0
18832556.0,51,462,9.058823529411764,2,12,7,44
18838800.0,51,358,7.019607843137255,5,9,40,11
18850626.0,59,128,2.169491525423729,1,5,59,0
18852582.0,202,1003,4.965346534653466,2,8,200,2
18852744.0,3,6,2.0,1,3,3,0
18854892.0,218,1073,4.922018348623853,1,7,218,0
18860019.0,212,1420,6.69811320754717,2,10,155,57
18862453.0,26,54,2.076923076923077,1,4,26,0
18862624.0,3,5,1.6666666666666667,1,3,3,0
18869819.0,98,293,2.989795918367347,1,6,98,0
18872707.0,371,1109,2.98921832884097,1,6,371,0
18878500.0,74,571,7.716216216216216,2,10,25,49
18880856.0,284,2184,7.690140845070423,2,11,109,175
18880964.0,3,11,3.6666666666666665,3,4,3,0
18888228.0,322,3078,9.559006211180124,2,12,18,304
18895663.0,1,3,3.0,3,3,1,0
18900456.0,11,95,8.636363636363637,6,10,1,10
18907660.0,225,487,2.1644444444444444,1,5,225,0
18922191.0,70,91,1.3,1,4,70,0
18923001.0,10,32,3.2,2,4,10,0
18925206.0,101,298,2.9504950495049505,1,5,101,0
18925855.0,102,508,4.980392156862745,2,7,102,0
18926695.0,26,173,6.653846153846154,3,8,20,6
18929605.0,405,1977,4.881481481481481,2,8,401,4
18932588.0,314,2150,6.8471337579617835,2,10,216,98
18933125.0,277,1937,6.992779783393502,2,9,186,91
18939228.0,31,55,1.7741935483870968,1,4,31,0
18939260.0,166,808,4.867469879518072,1,7,166,0
18942981.0,102,704,6.901960784313726,3,10,77,25
18943963.0,73,155,2.1232876712328768,1,4,73,0
18945412.0,207,1201,5.8019323671497585,2,9,192,15
18947268.0,16,32,2.0,1,4,16,0
18950813.0,106,211,1.990566037735849,1,5,106,0
18954106.0,5,24,4.8,4,6,5,0
18954460.0,250,528,2.112,1,5,250,0
18955319.0,73,351,4.808219178082192,2,7,73,0
18956161.0,280,1109,3.960714285714286,1,7,280,0
18957139.0,104,300,2.8846153846153846,1,5,104,0
18957739.0,44,220,5.0,2,7,44,0
18968621.0,222,1746,7.864864864864865,2,11,77,145
18969293.0,116,346,2.9827586206896552,1,6,116,0
18972777.0,138,677,4.905797101449275,1,9,134,4
18973223.0,298,894,3.0,1,6,298,0
18982253.0,1,3,3.0,3,3,1,0
18985326.0,100,845,8.45,2,12,18,82
18993001.0,39,120,3.076923076923077,1,5,39,0
18993060.0,29,86,2.9655172413793105,1,5,29,0
18997835.0,3,4,1.3333333333333333,1,2,3,0
19002835.0,226,2153,9.526548672566372,2,13,16,210
19003056.0,44,144,3.272727272727273,1,6,44,0
19006238.0,3,11,3.6666666666666665,3,5,3,0
19007851.0,416,1282,3.081730769230769,1,6,416,0
19008009.0,7,14,2.0,1,3,7,0
19010464.0,154,774,5.025974025974026,2,8,153,1
19013324.0,117,354,3.0256410256410255,1,6,117,0
19033719.0,482,1907,3.9564315352697097,1,7,482,0
19036745.0,1,3,3.0,3,3,1,0
19042056.0,47,437,9.297872340425531,2,12,4,43
19043049.0,3,6,2.0,1,3,3,0
19047326.0,2,2,1.0,1,1,2,0
19047757.0,161,812,5.043478260869565,2,8,160,1
19054913.0,197,1708,8.67005076142132,2,12,24,173
19060650.0,36,71,1.9722222222222223,1,5,36,0
19062449.0,138,288,2.0869565217391304,1,5,138,0
19062758.0,255,2451,9.611764705882353,2,13,17,238
19065078.0,2,17,8.5,8,9,0,2
19067737.0,2,2,1.0,1,1,2,0
19069869.0,51,206,4.03921568627451,1,7,51,0
19071125.0,319,1576,4.940438871473354,2,8,315,4
19077015.0,3,19,6.333333333333333,6,7,3,0
19077473.0,20,41,2.05,1,5,20,0
19079583.0,254,1961,7.7204724409448815,2,11,96,158
19092335.0,122,1201,9.844262295081966,2,13,5,117
19095342.0,472,3247,6.879237288135593,2,10,320,152
19097150.0,53,168,3.169811320754717,1,5,53,0
19097752.0,21,64,3.0476190476190474,1,6,21,0
19098680.0,8,20,2.5,1,4,8,0
19105495.0,12,31,2.5833333333333335,1,4,12,0
19108736.0,4,8,2.0,1,3,4,0
19108940.0,5,8,1.6,1,3,5,0
19109115.0,118,924,7.830508474576271,2,11,42,76
19109200.0,16,66,4.125,2,6,16,0
19109490.0,417,2842,6.815347721822542,2,10,306,111
19111892.0,43,207,4.813953488372093,2,7,43,0
19112582.0,291,2553,8.77319587628866,2,12,27,264
19112671.0,343,698,2.0349854227405246,1,5,343,0
19115291.0,75,531,7.08,2,10,49,26
19117571.0,2,2,1.0,1,1,2,0
19118395.0,361,2473,6.850415512465374,2,10,255,106
19120060.0,7,13,1.8571428571428572,1,3,7,0
19125045.0,2,7,3.5,3,4,2,0
19126422.0,383,1173,3.06266318537859,1,7,383,0
19132851.0,38,198,5.2105263157894735,3,7,38,0
19134734.0,2,4,2.0,2,2,2,0
19135262.0,30,174,5.8,4,8,29,1
19138077.0,3,5,1.6666666666666667,1,2,3,0
19147255.0,6,14,2.3333333333333335,1,4,6,0
19147632.0,37,76,2.054054054054054,1,4,37,0
19149799.0,290,1404,4.841379310344828,2,7,290,0
19151590.0,95,472,4.968421052631579,2,7,95,0
19152675.0,1,1,1.0,1,1,1,0
19155053.0,35,73,2.085714285714286,1,4,35,0
19155752.0,316,1557,4.927215189873418,2,8,313,3
19156049.0,15,27,1.8,1,3,15,0
19156916.0,1,4,4.0,4,4,1,0
19158406.0,24,50,2.0833333333333335,1,4,24,0
19168186.0,445,2182,4.903370786516854,2,8,441,4
19168256.0,101,490,4.851485148514851,2,7,101,0
19169621.0,1,4,4.0,4,4,1,0
19172122.0,270,557,2.062962962962963,1,5,270,0
19172641.0,1,1,1.0,1,1,1,0
19175300.0,317,934,2.946372239747634,1,6,317,0
19175302.0,137,404,2.948905109489051,1,5,137,0
19175717.0,222,1125,5.0675675675675675,2,9,218,4
19176547.0,21,46,2.1904761904761907,1,3,21,0
19177785.0,229,1106,4.829694323144105,2,7,229,0
19181164.0,7,20,2.857142857142857,1,5,7,0
19185703.0,30,78,2.6,1,5,30,0
19190183.0,119,595,5.0,2,8,117,2
19191289.0,53,112,2.1132075471698113,1,4,53,0
19192898.0,63,254,4.031746031746032,1,6,63,0
19194989.0,1,4,4.0,4,4,1,0
19198435.0,228,683,2.995614035087719,1,7,228,0
19204621.0,442,3928,8.886877828054299,2,12,37,405
19205203.0,334,3221,9.6437125748503,2,13,18,316
19206616.0,162,337,2.080246913580247,1,5,162,0
19221797.0,105,322,3.066666666666667,1,5,105,0
19221798.0,182,555,3.0494505494505493,1,6,182,0
19223342.0,26,127,4.884615384615385,3,7,26,0
19223483.0,1,6,6.0,6,6,1,0
19224699.0,180,364,2.022222222222222,1,4,180,0
19225389.0,2,5,2.5,2,3,2,0
19225802.0,36,173,4.805555555555555,2,8,35,1
19235328.0,40,87,2.175,1,5,40,0
19237710.0,448,945,2.109375,1,5,448,0
19239133.0,7,21,3.0,1,4,7,0
19247151.0,262,2519,9.614503816793894,2,13,17,245
19252955.0,48,442,9.208333333333334,2,11,4,44
19253549.0,4,6,1.5,1,2,4,0
19257877.0,1,2,2.0,2,2,1,0
19258149.0,1,1,1.0,1,1,1,0
19258503.0,3,7,2.3333333333333335,1,3,3,0
19258578.0,1,2,2.0,2,2,1,0
19260485.0,208,2034,9.778846153846153,2,13,10,198
19260655.0,131,649,4.9541984732824424,2,7,131,0
19262942.0,30,294,9.8,5,12,1,29
19263764.0,9,29,3.2222222222222223,1,4,9,0
19266049.0,20,84,4.2,2,7,20,0
19267077.0,140,686,4.9,2,8,139,1
19267721.0,187,1426,7.625668449197861,2,10,73,114
19268299.0,102,202,1.9803921568627452,1,4,102,0
19268590.0,53,124,2.339622641509434,1,5,53,0
19269803.0,49,66,1.346938775510204,1,3,49,0
19270083.0,41,83,2.024390243902439,1,5,41,0
19270198.0,55,116,2.109090909090909,1,4,55,0
19271698.0,1,6,6.0,6,6,1,0
19278272.0,34,48,1.411764705882353,1,3,34,0
19278728.0,208,420,2.019230769230769,1,5,208,0
19279231.0,1,1,1.0,1,1,1,0
19279428.0,29,146,5.0344827586206895,3,7,29,0
19280195.0,76,436,5.7368421052631575,2,8,70,6
19280961.0,138,276,2.0,1,5,138,0
19281556.0,86,484,5.627906976744186,2,9,81,5
19281881.0,74,450,6.081081081081081,4,9,66,8
19285336.0,87,406,4.666666666666667,2,7,87,0
19290112.0,77,595,7.7272727272727275,2,10,26,51
19292184.0,56,497,8.875,4,12,5,51
19292810.0,148,1436,9.702702702702704,2,13,10,138
19293542.0,1,4,4.0,4,4,1,0
19294104.0,123,254,2.065040650406504,1,4,123,0
19302769.0,411,3564,8.671532846715328,2,12,53,358
19303431.0,12,31,2.5833333333333335,2,4,12,0
19303668.0,2,6,3.0,3,3,2,0
19307692.0,4,15,3.75,3,5,4,0
19307956.0,9,27,3.0,2,5,9,0
19310134.0,31,279,9.0,7,11,1,30
19311782.0,245,2115,8.63265306122449,2,12,33,212
19314402.0,78,246,3.1538461538461537,1,5,78,0
19315659.0,8,9,1.125,1,2,8,0
19320179.0,1,4,4.0,4,4,1,0
19321571.0,91,805,8.846153846153847,2,12,12,79
19322834.0,290,2821,9.727586206896552,2,12,11,279
19323256.0,178,363,2.039325842696629,1,5,178,0
19326688.0,2,15,7.5,7,8,1,1
19327853.0,3,5,1.6666666666666667,1,2,3,0
19338863.0,130,664,5.107692307692307,3,7,130,0
19339011.0,183,1744,9.530054644808743,2,13,14,169
19341324.0,4,4,1.0,1,1,4,0
19341454.0,7,21,3.0,1,5,7,0
19341675.0,38,115,3.026315789473684,1,5,38,0
19341887.0,136,1192,8.764705882352942,2,12,19,117
19342533.0,103,913,8.864077669902912,2,12,13,90
19342600.0,4,10,2.5,1,4,4,0
19342946.0,66,93,1.4090909090909092,1,3,66,0
19344668.0,333,1628,4.888888888888889,2,8,332,1
19344933.0,1,3,3.0,3,3,1,0
19348989.0,428,2930,6.845794392523365,2,10,301,127
19351077.0,392,2693,6.869897959183674,2,10,287,105
19352717.0,339,1647,4.8584070796460175,2,8,337,2
19353757.0,266,1309,4.921052631578948,2,8,264,2
19354863.0,3,7,2.3333333333333335,2,3,3,0
19355848.0,3,3,1.0,1,1,3,0
19356645.0,175,512,2.9257142857142857,1,5,175,0
19359353.0,47,406,8.638297872340425,4,10,7,40
19361512.0,494,996,2.016194331983806,1,5,494,0
19361737.0,19,27,1.4210526315789473,1,4,19,0
19361742.0,29,96,3.310344827586207,1,5,29,0
19364210.0,81,555,6.851851851851852,3,9,62,19
19369221.0,216,665,3.0787037037037037,1,6,216,0
19371484.0,239,1636,6.845188284518828,2,9,166,73
19371914.0,146,420,2.8767123287671232,1,6,146,0
19373180.0,1,5,5.0,5,5,1,0
19375995.0,489,4763,9.740286298568508,2,13,27,462
19380403.0,498,1020,2.0481927710843375,1,5,498,0
19381649.0,3,8,2.6666666666666665,2,3,3,0
19384206.0,257,528,2.054474708171206,1,5,257,0
19385530.0,396,801,2.022727272727273,1,4,396,0
19385911.0,227,2181,9.607929515418503,2,13,12,215
19386068.0,445,915,2.056179775280899,1,5,445,0
19395423.0,148,308,2.081081081081081,1,4,148,0
19396581.0,3,6,2.0,1,3,3,0
19397837.0,1,2,2.0,2,2,1,0
19401341.0,1,3,3.0,3,3,1,0
19404098.0,60,193,3.216666666666667,1,5,60,0
19406085.0,440,939,2.1340909090909093,1,5,440,0
19406810.0,2,5,2.5,1,4,2,0
19407019.0,33,157,4.757575757575758,2,7,33,0
19408012.0,88,272,3.090909090909091,1,5,88,0
19410915.0,135,528,3.911111111111111,1,7,135,0
19411126.0,9,64,7.111111111111111,6,8,6,3
19411989.0,1,3,3.0,3,3,1,0
19417791.0,33,61,1.8484848484848484,1,3,33,0
19419938.0,2,5,2.5,1,4,2,0
19423628.0,122,1198,9.819672131147541,2,13,7,115
19428759.0,279,388,1.3906810035842294,1,4,279,0
19430341.0,1,5,5.0,5,5,1,0
19438429.0,510,4448,8.72156862745098,2,12,57,453
19449044.0,72,217,3.013888888888889,1,6,72,0
19449308.0,4,7,1.75,1,3,4,0
19451361.0,37,263,7.108108108108108,5,9,26,11
19456074.0,79,114,1.4430379746835442,1,3,79,0
19457889.0,6,15,2.5,1,3,6,0
19462408.0,27,37,1.3703703703703705,1,3,27,0
19466852.0,1,4,4.0,4,4,1,0
19473236.0,2,3,1.5,1,2,2,0
19480180.0,415,4003,9.64578313253012,2,13,26,389
19481301.0,11,35,3.1818181818181817,1,5,11,0
19481524.0,319,426,1.335423197492163,1,3,319,0
19485276.0,27,42,1.5555555555555556,1,3,27,0
19487112.0,10,90,9.0,8,10,0,10
19487723.0,176,518,2.9431818181818183,1,6,176,0
19497053.0,1,2,2.0,2,2,1,0
19499396.0,29,62,2.1379310344827585,1,4,29,0
19500610.0,32,76,2.375,1,4,32,0
19505053.0,3,8,2.6666666666666665,1,4,3,0
19509041.0,183,1268,6.9289617486338795,2,10,125,58
19509214.0,154,329,2.1363636363636362,1,4,154,0
19509339.0,93,289,3.10752688172043,1,5,93,0
19513227.0,50,494,9.88,2,12,2,48
19514032.0,3,4,1.3333333333333333,1,2,3,0
19515549.0,73,154,2.1095890410958904,1,4,73,0
19517706.0,2,6,3.0,2,4,2,0
19522001.0,66,191,2.893939393939394,1,5,66,0
19522833.0,8,13,1.625,1,3,8,0
19524052.0,1,1,1.0,1,1,1,0
19525837.0,9,26,2.888888888888889,2,4,9,0
19528622.0,2,7,3.5,3,4,2,0
19528778.0,2,4,2.0,1,3,2,0
19529778.0,65,87,1.3384615384615384,1,4,65,0
19536551.0,8,43,5.375,3,6,8,0
19541566.0,16,32,2.0,1,4,16,0
19543183.0,39,348,8.923076923076923,3,12,5,34
19543453.0,4,18,4.5,4,5,4,0
19547515.0,147,296,2.0136054421768708,1,4,147,0
19547787.0,27,38,1.4074074074074074,1,3,27,0
19548058.0,402,809,2.012437810945274,1,5,402,0
19553592.0,115,899,7.817391304347826,2,10,38,77
19559949.0,2,3,1.5,1,2,2,0
19560372.0,192,415,2.1614583333333335,1,5,192,0
19561659.0,4,21,5.25,3,7,4,0
19564668.0,18,25,1.3888888888888888,1,4,18,0
19565923.0,48,365,7.604166666666667,3,10,18,30
19567559.0,189,1665,8.80952380952381,2,11,22,167
19569608.0,611,4199,6.872340425531915,2,10,429,182
19571534.0,194,592,3.051546391752577,1,6,194,0
19573319.0,198,986,4.97979797979798,2,7,198,0
19581941.0,32,64,2.0,1,4,32,0
19584525.0,390,807,2.0692307692307694,1,5,390,0
19585753.0,2,8,4.0,3,5,2,0
19587804.0,172,1176,6.837209302325581,3,10,123,49
19589452.0,6,22,3.6666666666666665,3,4,6,0
19599296.0,64,498,7.78125,2,11,21,43
19605418.0,371,2575,6.940700808625337,2,10,258,113
19612960.0,14,70,5.0,4,7,14,0
19613052.0,31,56,1.8064516129032258,1,3,31,0
19613468.0,172,871,5.063953488372093,2,8,170,2
19613999.0,206,633,3.0728155339805827,1,5,206,0
19620306.0,108,237,2.1944444444444446,1,4,108,0
19624256.0,30,240,8.0,5,10,9,21
19631949.0,6,7,1.1666666666666667,1,2,6,0
19632851.0,185,398,2.151351351351351,1,5,185,0
19633681.0,10,39,3.9,2,6,10,0
19644187.0,293,2792,9.52901023890785,2,12,22,271
19646742.0,292,2831,9.695205479452055,2,13,15,277
19647245.0,242,948,3.9173553719008263,1,6,242,0
19647693.0,168,1178,7.011904761904762,2,10,110,58
19647866.0,3,10,3.3333333333333335,2,4,3,0
19650974.0,7,10,1.4285714285714286,1,2,7,0
19651156.0,7,13,1.8571428571428572,1,3,7,0
19655668.0,2,6,3.0,3,3,2,0
19656294.0,312,1533,4.913461538461538,2,7,312,0
19659012.0,257,2473,9.622568093385214,2,12,17,240
19663089.0,73,476,6.52054794520548,2,9,58,15
19664404.0,97,669,6.896907216494846,2,9,66,31
19664860.0,185,1425,7.702702702702703,2,10,72,113
19666258.0,1,5,5.0,5,5,1,0
19670008.0,246,699,2.841463414634146,1,6,246,0
19671146.0,18,36,2.0,1,3,18,0
19683305.0,133,895,6.7293233082706765,2,10,103,30
19686121.0,87,199,2.2873563218390807,1,5,87,0
19688533.0,143,1230,8.601398601398602,2,12,19,124
19688891.0,94,203,2.1595744680851063,1,4,94,0
19688946.0,113,340,3.0088495575221237,1,5,113,0
19691652.0,1,3,3.0,3,3,1,0
19692022.0,374,1840,4.919786096256685,2,8,372,2
19692765.0,255,1272,4.988235294117647,2,8,252,3
19694297.0,10,32,3.2,2,5,10,0
19697811.0,290,1449,4.996551724137931,2,8,289,1
19712664.0,1,1,1.0,1,1,1,0
19713236.0,22,42,1.9090909090909092,1,4,22,0
19723041.0,40,51,1.275,1,2,40,0
19731712.0,107,150,1.4018691588785046,1,3,107,0
19741376.0,396,825,2.0833333333333335,1,5,396,0
19742507.0,70,545,7.785714285714286,3,10,25,45
19742750.0,2,5,2.5,1,4,2,0
19755142.0,7,47,6.714285714285714,5,9,5,2
19755426.0,98,857,8.744897959183673,2,13,12,86
19756622.0,329,2242,6.814589665653496,2,10,233,96
19758093.0,354,3406,9.621468926553673,2,13,24,330
19760391.0,89,846,9.50561797752809,2,13,4,85
19761991.0,40,123,3.075,1,5,40,0
19771515.0,318,3088,9.71069182389937,2,13,13,305
19772178.0,117,458,3.9145299145299144,2,6,117,0
19779890.0,413,3943,9.54721549636804,2,12,25,388
19779968.0,79,396,5.012658227848101,3,7,79,0
19784925.0,395,841,2.1291139240506327,1,5,395,0
19790665.0,309,1517,4.909385113268608,2,8,307,2
19792787.0,196,1556,7.938775510204081,3,10,61,135
19795158.0,47,99,2.106382978723404,1,4,47,0
19796279.0,172,1168,6.790697674418604,2,9,125,47
19803659.0,16,107,6.6875,3,9,10,6
19804684.0,367,2197,5.986376021798365,2,9,345,22
19804827.0,117,341,2.9145299145299144,1,6,117,0
19805401.0,369,2180,5.907859078590786,2,8,356,13
19807219.0,67,217,3.2388059701492535,1,6,67,0
19817938.0,412,2779,6.745145631067961,2,10,309,103
19823070.0,324,1886,5.820987654320987,2,10,307,17
19823421.0,285,1933,6.782456140350877,2,9,208,77
19825677.0,339,1329,3.920353982300885,1,7,339,0
19826108.0,1,1,1.0,1,1,1,0
19827547.0,1,3,3.0,3,3,1,0
19832638.0,184,1799,9.777173913043478,2,13,9,175
19836954.0,150,744,4.96,2,8,148,2
19841388.0,377,781,2.0716180371352784,1,5,377,0
19845235.0,1,2,2.0,2,2,1,0
19846095.0,3,11,3.6666666666666665,3,4,3,0
19850984.0,307,414,1.3485342019543973,1,5,307,0
19852477.0,1,4,4.0,4,4,1,0
19867197.0,141,289,2.049645390070922,1,6,141,0
19870994.0,1,2,2.0,2,2,1,0
19872174.0,8,37,4.625,3,6,8,0
19874474.0,51,234,4.588235294117647,2,7,51,0
19882688.0,87,856,9.839080459770114,2,13,3,84
19888400.0,19,180,9.473684210526315,7,12,1,18
19890777.0,9,18,2.0,1,4,9,0
19891220.0,34,292,8.588235294117647,4,12,7,27
19891688.0,48,154,3.2083333333333335,1,5,48,0
19896654.0,369,3559,9.644986449864499,2,13,34,335
19901354.0,664,3293,4.9593373493975905,2,8,661,3
19906346.0,235,2267,9.646808510638298,2,13,14,221
19919009.0,26,97,3.730769230769231,2,5,26,0
19922980.0,54,128,2.3703703703703702,1,5,54,0
19924828.0,59,173,2.9322033898305087,1,5,59,0
19924834.0,358,711,1.9860335195530727,1,4,358,0
19931449.0,248,738,2.975806451612903,1,7,248,0
19936762.0,6,35,5.833333333333333,5,7,6,0
19938364.0,184,743,4.038043478260869,1,6,184,0
19940747.0,45,216,4.8,2,7,45,0
19941018.0,15,43,2.8666666666666667,1,4,15,0
19941235.0,14,40,2.857142857142857,1,5,14,0
19941493.0,9,18,2.0,1,3,9,0
19945366.0,77,736,9.558441558441558,2,12,6,71
19955273.0,235,2330,9.914893617021276,3,13,8,227
19958108.0,129,516,4.0,1,6,129,0
19958174.0,237,508,2.1434599156118144,1,5,237,0
19965807.0,69,202,2.927536231884058,1,5,69,0
19966438.0,76,609,8.013157894736842,2,10,19,57
19974031.0,268,557,2.078358208955224,1,5,268,0
19975472.0,80,180,2.25,1,5,80,0
19976306.0,361,751,2.080332409972299,1,6,361,0
19977136.0,76,152,2.0,1,4,76,0
19978045.0,15,81,5.4,4,7,15,0
19978260.0,46,96,2.0869565217391304,1,5,46,0
19980724.0,1,2,2.0,2,2,1,0
19983226.0,1,3,3.0,3,3,1,0
19984657.0,400,845,2.1125,1,4,400,0
19990607.0,88,670,7.613636363636363,2,12,34,54
19992352.0,108,219,2.0277777777777777,1,5,108,0
19993726.0,154,1045,6.785714285714286,2,10,108,46
19999450.0,58,228,3.9310344827586206,2,7,58,0
20005556.0,21,153,7.285714285714286,5,10,13,8
20009690.0,404,3909,9.675742574257425,2,12,20,384
20010069.0,466,1854,3.9785407725321886,1,6,466,0
20010762.0,553,5255,9.502712477396022,2,13,45,508
20011461.0,69,347,5.028985507246377,3,8,68,1
20013960.0,226,478,2.1150442477876106,1,5,226,0
20022587.0,145,305,2.103448275862069,1,4,145,0
20023385.0,29,54,1.8620689655172413,1,4,29,0
20026468.0,15,29,1.9333333333333333,1,4,15,0
20029097.0,92,192,2.0869565217391304,1,5,92,0
20029385.0,119,368,3.092436974789916,1,6,119,0
20030616.0,240,2362,9.841666666666667,2,12,11,229
20031690.0,255,1254,4.91764705882353,2,8,253,2
20042196.0,301,1490,4.95016611295681,2,8,299,2
20042220.0,120,235,1.9583333333333333,1,6,120,0
20049665.0,1,2,2.0,2,2,1,0
20060669.0,6,11,1.8333333333333333,1,3,6,0
20065196.0,32,217,6.78125,2,9,21,11
20070091.0,93,457,4.913978494623656,2,7,93,0
20080484.0,79,525,6.6455696202531644,3,9,61,18
20080487.0,44,285,6.4772727272727275,4,9,39,5
20083273.0,621,6004,9.668276972624799,2,14,31,590
20089804.0,193,385,1.994818652849741,1,5,193,0
20098186.0,401,863,2.1521197007481296,1,5,401,0
20101277.0,48,424,8.833333333333334,2,11,8,40
20120064.0,216,1070,4.953703703703703,2,8,213,3
20127481.0,129,642,4.976744186046512,2,7,129,0
20129330.0,125,858,6.864,2,9,91,34
20130468.0,140,282,2.0142857142857142,1,5,140,0
20132289.0,109,334,3.0642201834862384,1,6,109,0
20135729.0,267,2592,9.707865168539326,2,13,15,252
20148324.0,59,123,2.0847457627118646,1,5,59,0
20153564.0,1,3,3.0,3,3,1,0
20169279.0,5,7,1.4,1,2,5,0
20180442.0,24,158,6.583333333333333,5,8,20,4
20181157.0,15,150,10.0,8,13,0,15
20181508.0,1,2,2.0,2,2,1,0
20181536.0,11,31,2.8181818181818183,2,4,11,0
20184329.0,2,4,2.0,2,2,2,0
20185096.0,113,669,5.920353982300885,2,9,107,6
20185407.0,74,112,1.5135135135135136,1,3,74,0
20187539.0,10,94,9.4,8,10,0,10
20190235.0,343,2717,7.921282798833819,2,11,101,242
20199593.0,695,3466,4.987050359712231,1,8,690,5
20199981.0,1,1,1.0,1,1,1,0
20200455.0,785,3070,3.910828025477707,1,7,785,0
20201013.0,742,2944,3.967654986522911,1,7,742,0
20202346.0,102,1010,9.901960784313726,2,12,4,98
20203522.0,70,149,2.1285714285714286,1,5,70,0
20205492.0,84,586,6.976190476190476,3,9,55,29
20207401.0,203,623,3.0689655172413794,1,5,203,0
20212612.0,19,44,2.3157894736842106,1,4,19,0
20221372.0,38,86,2.263157894736842,1,5,38,0
20233549.0,200,1561,7.805,2,10,63,137
20237400.0,7,17,2.4285714285714284,1,4,7,0
20238369.0,349,2398,6.871060171919771,2,10,254,95
20239424.0,11,55,5.0,2,8,10,1
20259825.0,69,201,2.9130434782608696,1,5,69,0
20260701.0,7,40,5.714285714285714,2,7,7,0
20262262.0,2,3,1.5,1,2,2,0
20264807.0,703,6836,9.724039829302987,2,13,41,662
20265429.0,70,537,7.671428571428572,2,10,28,42
20265530.0,18,36,2.0,1,4,18,0
20273611.0,68,273,4.014705882352941,1,7,68,0
20274666.0,27,221,8.185185185185185,5,11,7,20
20275663.0,52,77,1.4807692307692308,1,4,52,0
20276020.0,106,1031,9.726415094339623,2,12,4,102
20279246.0,6,30,5.0,4,6,6,0
20302903.0,14,39,2.7857142857142856,1,5,14,0
20303682.0,83,192,2.3132530120481927,1,4,83,0
20304887.0,319,962,3.0156739811912225,1,7,319,0
20307919.0,119,593,4.983193277310924,2,8,118,1
20312352.0,321,425,1.32398753894081,1,4,321,0
20315047.0,53,371,7.0,2,9,36,17
20318361.0,3,3,1.0,1,1,3,0
20319756.0,176,885,5.028409090909091,3,8,175,1
20324976.0,38,365,9.605263157894736,6,12,2,36
20325613.0,229,1586,6.925764192139738,2,10,161,68
20335046.0,419,3257,7.77326968973747,2,11,148,271
20336747.0,1,3,3.0,3,3,1,0
20346903.0,631,4884,7.740095087163233,2,11,234,397
20347373.0,99,194,1.9595959595959596,1,4,99,0
20348152.0,147,311,2.1156462585034013,1,5,147,0
20356593.0,75,359,4.786666666666667,2,8,74,1
20357669.0,113,450,3.982300884955752,2,6,113,0
20371803.0,8,58,7.25,6,8,5,3
20376429.0,170,521,3.0647058823529414,1,6,170,0
20379548.0,47,240,5.1063829787234045,2,7,47,0
20379858.0,53,219,4.132075471698113,2,7,53,0
20392308.0,17,111,6.529411764705882,4,9,11,6
20398715.0,249,734,2.9477911646586343,1,6,249,0
20408381.0,127,168,1.3228346456692914,1,4,127,0
20414468.0,54,368,6.814814814814815,2,9,38,16
20417815.0,187,1799,9.620320855614974,2,13,10,177
20436115.0,16,126,7.875,6,10,6,10
20452408.0,249,1240,4.979919678714859,2,8,248,1
20456319.0,82,400,4.878048780487805,3,7,82,0
20465040.0,111,217,1.954954954954955,1,5,111,0
20468641.0,1,2,2.0,2,2,1,0
20473789.0,153,1174,7.673202614379085,2,10,58,95
20487100.0,19,138,7.2631578947368425,4,9,11,8
20491478.0,63,317,5.031746031746032,2,9,61,2
20498920.0,10,68,6.8,4,9,8,2
20509156.0,492,679,1.3800813008130082,1,4,492,0
20510685.0,2,2,1.0,1,1,2,0
20516221.0,18,43,2.388888888888889,1,4,18,0
20520511.0,208,1011,4.860576923076923,2,7,208,0
20542189.0,149,770,5.167785234899329,2,8,148,1
20547966.0,11,72,6.545454545454546,3,8,8,3
20548940.0,19,37,1.9473684210526316,1,4,19,0
20550523.0,6,9,1.5,1,2,6,0
20554986.0,515,3568,6.9281553398058255,2,10,356,159
20556494.0,335,3149,9.4,2,12,27,308
20560468.0,201,1196,5.9502487562189055,2,9,187,14
20561727.0,125,621,4.968,2,8,123,2
20563774.0,1,3,3.0,3,3,1,0
20563987.0,12,29,2.4166666666666665,1,4,12,0
20575616.0,4,7,1.75,1,2,4,0
20576553.0,71,618,8.704225352112676,2,11,7,64
20577575.0,80,379,4.7375,3,7,80,0
20579404.0,55,116,2.109090909090909,1,5,55,0
20583855.0,159,465,2.9245283018867925,1,6,159,0
20587871.0,115,164,1.4260869565217391,1,3,115,0
20594717.0,164,500,3.048780487804878,1,6,164,0
20599691.0,205,1005,4.902439024390244,2,8,203,2
20603926.0,73,576,7.890410958904109,4,11,25,48
20613339.0,61,424,6.950819672131147,2,9,41,20
20620197.0,99,128,1.292929292929293,1,3,99,0
20635529.0,45,323,7.177777777777778,2,10,26,19
20643757.0,27,38,1.4074074074074074,1,3,27,0
20650116.0,40,81,2.025,1,4,40,0
20652700.0,63,555,8.80952380952381,4,11,5,58
20670897.0,15,135,9.0,8,11,0,15
20677597.0,39,285,7.3076923076923075,5,10,21,18
20683915.0,36,82,2.2777777777777777,1,4,36,0
20684297.0,119,916,7.697478991596639,2,11,52,67
20693422.0,60,404,6.733333333333333,5,9,50,10
20694997.0,3,6,2.0,1,3,3,0
20706300.0,419,880,2.100238663484487,1,5,419,0
20707190.0,207,1404,6.782608695652174,2,10,150,57
20707974.0,688,5924,8.61046511627907,2,11,88,600
20726645.0,224,2130,9.508928571428571,2,12,14,210
20727029.0,28,56,2.0,1,4,28,0
20733548.0,1,2,2.0,2,2,1,0
20734742.0,1,5,5.0,5,5,1,0
20736283.0,55,121,2.2,1,4,55,0
20736724.0,131,184,1.4045801526717556,1,3,131,0
20740624.0,322,3114,9.670807453416149,2,13,23,299
20751573.0,77,162,2.103896103896104,1,5,77,0
20765496.0,23,78,3.391304347826087,2,5,23,0
20766400.0,7,13,1.8571428571428572,1,3,7,0
20766863.0,230,1763,7.665217391304348,2,10,90,140
20767452.0,2,5,2.5,2,3,2,0
20770882.0,143,201,1.4055944055944056,1,3,143,0
20770894.0,12,20,1.6666666666666667,1,3,12,0
20792652.0,118,599,5.076271186440678,3,7,118,0
20794430.0,10,18,1.8,1,3,10,0
20802151.0,54,362,6.703703703703703,2,9,38,16
20806292.0,42,396,9.428571428571429,2,11,3,39
20807349.0,111,216,1.945945945945946,1,4,111,0
20807444.0,289,1413,4.889273356401384,2,8,286,3
20813778.0,195,1360,6.9743589743589745,2,10,132,63
20823320.0,6,18,3.0,2,4,6,0
20825778.0,333,2874,8.63063063063063,2,12,47,286
20834053.0,43,326,7.5813953488372094,2,10,14,29
20834855.0,1,2,2.0,2,2,1,0
20839439.0,561,1177,2.0980392156862746,1,5,561,0
20839512.0,133,272,2.045112781954887,1,4,133,0
20842630.0,387,1929,4.984496124031008,2,8,383,4
20845149.0,64,90,1.40625,1,3,64,0
20847854.0,93,910,9.78494623655914,2,12,4,89
20853622.0,80,465,5.8125,2,9,74,6
20854599.0,90,111,1.2333333333333334,1,3,90,0
20858946.0,365,3533,9.67945205479452,2,13,21,344
20859057.0,78,170,2.1794871794871793,1,4,78,0
20868157.0,377,770,2.042440318302387,1,5,377,0
20870547.0,4,4,1.0,1,1,4,0
20874390.0,35,103,2.942857142857143,1,5,35,0
20880570.0,120,615,5.125,2,9,118,2
20885517.0,6,16,2.6666666666666665,2,4,6,0
20892573.0,309,2970,9.611650485436893,2,13,23,286
20894273.0,184,1778,9.66304347826087,2,13,17,167
20895357.0,43,296,6.883720930232558,2,9,30,13
20898818.0,47,147,3.127659574468085,1,5,47,0
20900488.0,244,2121,8.692622950819672,2,13,33,211
20907122.0,85,177,2.0823529411764707,1,4,85,0
20907153.0,80,802,10.025,4,13,2,78
20913233.0,36,104,2.888888888888889,1,5,36,0
20924163.0,19,39,2.0526315789473686,1,4,19,0
20925743.0,196,773,3.943877551020408,1,7,196,0
20931830.0,98,844,8.612244897959183,2,11,18,80
20938041.0,20,156,7.8,2,10,6,14
20939364.0,7,12,1.7142857142857142,1,3,7,0
20939932.0,51,458,8.980392156862745,7,11,3,48
20943169.0,135,279,2.066666666666667,1,5,135,0
20943314.0,53,118,2.2264150943396226,1,4,53,0
20947592.0,298,2627,8.815436241610739,2,12,36,262
20950426.0,26,38,1.4615384615384615,1,3,26,0
20950889.0,4,14,3.5,3,4,4,0
20951336.0,148,311,2.1013513513513513,1,5,148,0
20952037.0,8,25,3.125,2,5,8,0
20953395.0,180,517,2.8722222222222222,1,5,180,0
20955251.0,403,878,2.1786600496277915,1,5,403,0
20957277.0,53,424,8.0,5,10,15,38
20960733.0,45,88,1.9555555555555555,1,3,45,0
20967427.0,119,155,1.3025210084033614,1,3,119,0
20967829.0,194,254,1.309278350515464,1,3,194,0
20968007.0,174,235,1.3505747126436782,1,3,174,0
20968100.0,252,371,1.4722222222222223,1,4,252,0
20969394.0,240,1650,6.875,2,10,179,61
20981310.0,115,232,2.017391304347826,1,5,115,0
20985821.0,2,2,1.0,1,1,2,0
20987580.0,201,601,2.990049751243781,1,5,201,0
20989468.0,6,7,1.1666666666666667,1,2,6,0
20992531.0,31,318,10.258064516129032,4,13,1,30
21001845.0,28,58,2.0714285714285716,1,4,28,0
21002021.0,152,1063,6.993421052631579,2,10,106,46
21002529.0,385,1884,4.893506493506494,2,8,382,3
21007373.0,149,449,3.0134228187919465,1,5,149,0
21018319.0,58,188,3.2413793103448274,1,6,58,0
21020651.0,2,4,2.0,2,2,2,0
21022136.0,360,2831,7.863888888888889,2,12,122,238
21025278.0,186,894,4.806451612903226,2,8,185,1
21026173.0,81,396,4.888888888888889,2,7,81,0
21034741.0,3,5,1.6666666666666667,1,2,3,0
21034899.0,40,281,7.025,4,10,26,14
21035366.0,477,1462,3.0649895178197064,1,6,477,0
21037710.0,361,743,2.0581717451523547,1,5,361,0
21038222.0,115,1137,9.88695652173913,2,13,9,106
21039039.0,418,2894,6.923444976076555,2,10,287,131
21039228.0,102,803,7.872549019607843,4,11,36,66
21039601.0,10,13,1.3,1,2,10,0
21039766.0,160,822,5.1375,2,8,159,1
21041035.0,145,430,2.9655172413793105,1,6,145,0
21042605.0,111,1071,9.64864864864865,2,12,5,106
21057863.0,271,1324,4.885608856088561,2,7,271,0
21062399.0,1,2,2.0,2,2,1,0
21083580.0,197,1903,9.65989847715736,2,12,10,187
21087568.0,2,18,9.0,8,10,0,2
21090847.0,95,654,6.88421052631579,2,10,66,29
21093334.0,5,12,2.4,2,4,5,0
21093465.0,30,80,2.6666666666666665,1,4,30,0
21096480.0,168,675,4.017857142857143,2,7,168,0
21103099.0,26,110,4.230769230769231,3,6,26,0
21103302.0,27,207,7.666666666666667,3,10,12,15
21105620.0,10,43,4.3,3,5,10,0
21115748.0,131,259,1.9770992366412214,1,5,131,0
21116143.0,101,491,4.861386138613861,2,8,100,1
21117343.0,48,320,6.666666666666667,4,9,37,11
21119642.0,117,580,4.957264957264957,1,8,116,1
21120756.0,194,412,2.1237113402061856,1,5,194,0
21122724.0,155,613,3.9548387096774196,2,7,155,0
21125322.0,193,424,2.1968911917098444,1,7,193,0
21131931.0,2,6,3.0,3,3,2,0
21132675.0,1,4,4.0,4,4,1,0
21132956.0,63,259,4.111111111111111,2,7,63,0
21133739.0,2,2,1.0,1,1,2,0
21139972.0,185,393,2.1243243243243244,1,5,185,0
21158218.0,148,887,5.993243243243243,2,8,138,10
21160188.0,285,599,2.101754385964912,1,5,285,0
21168708.0,96,199,2.0729166666666665,1,4,96,0
21168927.0,379,1891,4.989445910290238,1,8,378,1
21169513.0,287,2758,9.609756097560975,2,13,19,268
21169917.0,131,541,4.129770992366412,1,6,131,0
21172911.0,25,70,2.8,1,5,25,0
21180608.0,144,431,2.9930555555555554,1,5,144,0
21184348.0,194,393,2.0257731958762886,1,5,194,0
21185525.0,70,471,6.728571428571429,2,10,50,20
21187127.0,1,4,4.0,4,4,1,0
21188083.0,5,12,2.4,2,3,5,0
21191658.0,244,728,2.9836065573770494,1,7,244,0
21193777.0,3,23,7.666666666666667,7,9,2,1
21198017.0,203,437,2.1527093596059115,1,5,203,0
21201191.0,1,3,3.0,3,3,1,0
21212124.0,134,897,6.6940298507462686,2,10,97,37
21212218.0,282,822,2.9148936170212765,1,6,282,0
21213060.0,213,446,2.0938967136150235,1,5,213,0
21216455.0,217,2077,9.571428571428571,2,12,18,199
21222340.0,67,221,3.298507462686567,1,5,67,0
21228880.0,51,340,6.666666666666667,2,10,40,11
21230945.0,43,58,1.3488372093023255,1,4,43,0
21234461.0,12,90,7.5,2,9,4,8
21246678.0,188,373,1.9840425531914894,1,4,188,0
21248751.0,21,150,7.142857142857143,5,9,13,8
21249806.0,202,1990,9.851485148514852,4,13,9,193
21258367.0,231,2217,9.597402597402597,2,13,19,212
21258978.0,18,19,1.0555555555555556,1,2,18,0
21262594.0,266,1837,6.906015037593985,2,11,179,87
21270038.0,106,444,4.188679245283019,2,6,106,0
21271126.0,1,1,1.0,1,1,1,0
21271310.0,90,180,2.0,1,5,90,0
21272863.0,150,884,5.8933333333333335,2,9,140,10
21277713.0,17,25,1.4705882352941178,1,3,17,0
21283905.0,180,1767,9.816666666666666,2,13,9,171
21291212.0,163,333,2.042944785276074,1,4,163,0
21293152.0,12,28,2.3333333333333335,1,4,12,0
21301754.0,123,874,7.105691056910569,4,10,77,46
21303463.0,3,9,3.0,2,4,3,0
21303850.0,5,38,7.6,6,9,2,3
21314860.0,48,245,5.104166666666667,3,7,48,0
21317724.0,102,200,1.9607843137254901,1,5,102,0
21318687.0,33,108,3.272727272727273,1,5,33,0
21340006.0,140,1224,8.742857142857142,2,12,18,122
21352124.0,86,183,2.127906976744186,1,4,86,0
21360480.0,98,380,3.877551020408163,1,6,98,0
21362931.0,57,85,1.4912280701754386,1,3,57,0
21362950.0,16,148,9.25,7,10,1,15
21364019.0,29,275,9.482758620689655,3,11,2,27
21364597.0,12,40,3.3333333333333335,2,5,12,0
21365468.0,37,47,1.2702702702702702,1,3,37,0
21366983.0,4,14,3.5,3,4,4,0
21367082.0,135,544,4.029629629629629,1,7,135,0
21368162.0,98,144,1.469387755102041,1,4,98,0
21371309.0,504,1049,2.0813492063492065,1,6,504,0
21372569.0,3,9,3.0,2,4,3,0
21376743.0,4,7,1.75,1,2,4,0
21378300.0,406,1615,3.977832512315271,1,7,406,0
21381956.0,18,23,1.2777777777777777,1,2,18,0
21384524.0,29,42,1.4482758620689655,1,3,29,0
21386666.0,82,156,1.9024390243902438,1,5,82,0
21387602.0,87,767,8.816091954022989,4,12,9,78
21388431.0,78,151,1.935897435897436,1,5,78,0
21388718.0,245,766,3.126530612244898,1,6,245,0
21389483.0,680,3409,5.0132352941176475,2,9,675,5
21389707.0,255,1272,4.988235294117647,3,9,252,3
21390150.0,18,151,8.38888888888889,3,11,4,14
21390488.0,100,202,2.02,1,5,100,0
21393723.0,7,53,7.571428571428571,6,9,3,4
21396016.0,56,100,1.7857142857142858,1,5,56,0
21401356.0,83,393,4.734939759036145,2,7,83,0
21401494.0,27,53,1.962962962962963,1,4,27,0
21402384.0,189,904,4.783068783068783,3,9,188,1
21408141.0,313,1230,3.929712460063898,1,6,313,0
21409351.0,77,698,9.064935064935066,3,12,8,69
21412860.0,4,8,2.0,1,3,4,0
21417708.0,5,7,1.4,1,2,5,0
21418557.0,15,34,2.2666666666666666,1,4,15,0
21419399.0,26,35,1.3461538461538463,1,3,26,0
21421719.0,43,381,8.86046511627907,3,11,2,41
21422183.0,160,471,2.94375,1,6,160,0
21422656.0,10,13,1.3,1,2,10,0
21424926.0,6,6,1.0,1,1,6,0
21430330.0,56,274,4.892857142857143,3,7,56,0
21437216.0,509,2471,4.854616895874264,2,8,508,1
21437634.0,22,32,1.4545454545454546,1,4,22,0
21441201.0,219,1712,7.8173515981735155,2,11,78,141
21444447.0,176,871,4.948863636363637,2,8,175,1
21445332.0,10,25,2.5,1,4,10,0
21446148.0,70,340,4.857142857142857,2,7,70,0
21448741.0,25,197,7.88,5,9,7,18
21453792.0,342,1339,3.915204678362573,1,7,342,0
21455170.0,803,6255,7.789539227895392,2,11,266,537
21456431.0,18,32,1.7777777777777777,1,3,18,0
21456587.0,52,118,2.269230769230769,1,4,52,0
21469240.0,51,441,8.647058823529411,2,11,7,44
21469337.0,25,69,2.76,1,4,25,0
21473919.0,50,76,1.52,1,4,50,0
21476110.0,8,11,1.375,1,2,8,0
21480621.0,1,3,3.0,3,3,1,0
21482044.0,104,516,4.961538461538462,2,8,103,1
21485131.0,301,2839,9.43189368770764,3,13,27,274
21486293.0,437,3802,8.700228832951945,2,13,59,378
21493122.0,298,918,3.0805369127516777,1,5,298,0
21496005.0,92,188,2.0434782608695654,1,4,92,0
21496663.0,533,2584,4.848030018761726,2,8,531,2
21498125.0,609,5905,9.696223316912972,2,13,35,574
21507668.0,155,346,2.232258064516129,1,6,155,0
21509581.0,289,837,2.8961937716262978,1,6,289,0
21511822.0,8,66,8.25,6,11,3,5
21514093.0,3,5,1.6666666666666667,1,3,3,0
21515121.0,228,2206,9.675438596491228,2,12,14,214
21526399.0,55,275,5.0,3,7,55,0
21532356.0,116,340,2.9310344827586206,1,5,116,0
21545797.0,246,2146,8.723577235772357,2,12,25,221
21549755.0,25,198,7.92,6,10,9,16
21573980.0,33,225,6.818181818181818,4,9,22,11
21578752.0,1,2,2.0,2,2,1,0
21584192.0,171,860,5.029239766081871,2,8,170,1
21584566.0,16,21,1.3125,1,3,16,0
21592236.0,73,642,8.794520547945206,2,11,9,64
21593162.0,125,621,4.968,2,8,122,3
21595408.0,246,2121,8.621951219512194,2,12,30,216
21602634.0,112,237,2.1160714285714284,1,5,112,0
21604470.0,59,299,5.067796610169491,3,8,58,1
21604537.0,11,17,1.5454545454545454,1,3,11,0
21605391.0,2,2,1.0,1,1,2,0
21605577.0,156,339,2.173076923076923,1,6,156,0
21618153.0,22,72,3.272727272727273,1,5,22,0
21619398.0,135,389,2.8814814814814813,1,5,135,0
21628332.0,522,4544,8.704980842911878,2,12,77,445
21629717.0,6,14,2.3333333333333335,1,3,6,0
21631810.0,5,11,2.2,1,4,5,0
21631907.0,2,4,2.0,1,3,2,0
21638201.0,205,1016,4.95609756097561,2,7,205,0
21638682.0,167,351,2.1017964071856285,1,4,167,0
21641319.0,144,1239,8.604166666666666,3,12,20,124
21641672.0,233,1116,4.789699570815451,2,8,232,1
21645197.0,154,616,4.0,2,6,154,0
21646853.0,8,51,6.375,5,8,7,1
21647093.0,80,241,3.0125,1,5,80,0
21647352.0,23,156,6.782608695652174,3,8,16,7
21650426.0,335,1665,4.970149253731344,1,7,335,0
21651978.0,294,1434,4.877551020408164,2,7,294,0
21652480.0,39,266,6.82051282051282,3,9,30,9
21653334.0,137,277,2.021897810218978,1,4,137,0
21653361.0,135,274,2.0296296296296297,1,4,135,0
21654281.0,120,476,3.966666666666667,2,6,120,0
21655975.0,206,809,3.9271844660194173,1,6,206,0
21656304.0,323,1282,3.9690402476780187,1,7,323,0
21656537.0,5,7,1.4,1,3,5,0
21661715.0,2,3,1.5,1,2,2,0
21665242.0,174,700,4.022988505747127,2,8,173,1
21670468.0,98,472,4.816326530612245,2,8,97,1
21671884.0,45,191,4.2444444444444445,2,6,45,0
21672060.0,56,269,4.803571428571429,3,7,56,0
21672268.0,184,1275,6.929347826086956,2,10,127,57
21677507.0,2,14,7.0,6,8,1,1
21677593.0,165,800,4.848484848484849,2,8,164,1
21687269.0,50,405,8.1,2,10,16,34
21693180.0,50,349,6.98,2,10,32,18
21695325.0,208,1398,6.721153846153846,2,10,157,51
21698918.0,126,632,5.015873015873016,3,8,125,1
21708199.0,411,842,2.048661800486618,1,5,411,0
21711127.0,225,1332,5.92,2,9,209,16
21711292.0,141,277,1.9645390070921986,1,4,141,0
21719395.0,250,2453,9.812,3,12,8,242
21723324.0,10,12,1.2,1,2,10,0
21728003.0,440,900,2.0454545454545454,1,5,440,0
21731954.0,492,1006,2.0447154471544717,1,5,492,0
21732035.0,440,1722,3.9136363636363636,1,7,440,0
21732036.0,483,2417,5.004140786749482,2,8,482,1
21732039.0,463,2300,4.967602591792657,2,8,462,1
21749346.0,37,117,3.1621621621621623,1,5,37,0
21749942.0,347,709,2.043227665706052,1,5,347,0
21756845.0,259,776,2.996138996138996,1,6,259,0
21757507.0,236,1608,6.813559322033898,2,10,172,64
21758467.0,6,43,7.166666666666667,4,9,2,4
21758630.0,19,53,2.789473684210526,1,5,19,0
21759471.0,97,294,3.0309278350515463,1,5,97,0
21762182.0,253,514,2.0316205533596836,1,5,253,0
21764635.0,5,6,1.2,1,2,5,0
21765308.0,173,526,3.040462427745665,1,6,173,0
21765690.0,8,69,8.625,8,10,0,8
21767107.0,2,2,1.0,1,1,2,0
21769396.0,307,623,2.029315960912052,1,4,307,0
21778294.0,257,1021,3.972762645914397,2,7,257,0
21794188.0,164,1547,9.432926829268293,2,12,15,149
21794995.0,1,2,2.0,2,2,1,0
21795666.0,85,175,2.0588235294117645,1,4,85,0
21795805.0,100,206,2.06,1,5,100,0
21801616.0,42,50,1.1904761904761905,1,3,42,0
21805831.0,2,7,3.5,3,4,2,0
21805879.0,5,48,9.6,9,10,0,5
21805917.0,4,36,9.0,8,10,0,4
21808155.0,5,19,3.8,3,5,5,0
21809520.0,377,1848,4.901856763925729,2,8,376,1
21813599.0,23,47,2.0434782608695654,1,3,23,0
21820029.0,221,645,2.918552036199095,1,6,221,0
21831529.0,290,850,2.9310344827586206,1,5,290,0
21831640.0,199,990,4.974874371859296,2,7,199,0
21834678.0,190,924,4.863157894736842,2,8,188,2
21844127.0,371,1470,3.9622641509433962,1,6,371,0
21847866.0,251,2375,9.46215139442231,2,13,25,226
21859129.0,416,2097,5.040865384615385,2,8,415,1
21859287.0,414,2034,4.913043478260869,2,7,414,0
21859330.0,371,1858,5.008086253369272,2,8,369,2
21859393.0,153,758,4.954248366013072,3,8,151,2
21859407.0,36,143,3.9722222222222223,2,6,36,0
21859420.0,73,360,4.931506849315069,2,7,73,0
21859444.0,85,439,5.1647058823529415,2,8,84,1
21859458.0,57,291,5.105263157894737,3,7,57,0
21861165.0,59,294,4.983050847457627,3,7,59,0
21861935.0,139,292,2.1007194244604315,1,5,139,0
21862103.0,23,67,2.9130434782608696,1,4,23,0
21872041.0,315,1543,4.898412698412699,2,8,313,2
21875340.0,26,200,7.6923076923076925,3,10,10,16
21876384.0,5,10,2.0,1,3,5,0
21876398.0,121,269,2.2231404958677685,1,4,121,0
21877008.0,1,3,3.0,3,3,1,0
21877512.0,176,857,4.869318181818182,2,8,173,3
21879461.0,63,525,8.333333333333334,3,11,11,52
21879674.0,99,469,4.737373737373737,3,7,99,0
21882223.0,385,813,2.1116883116883116,1,5,385,0
21882929.0,339,3279,9.672566371681416,2,13,25,314
21888134.0,33,330,10.0,3,13,1,32
21889023.0,309,1537,4.97411003236246,2,7,309,0
21889233.0,53,502,9.471698113207546,2,12,4,49
21891926.0,26,131,5.038461538461538,3,7,26,0
21896113.0,139,534,3.841726618705036,1,7,139,0
21897224.0,231,1144,4.9523809523809526,1,8,229,2
21897674.0,244,1664,6.819672131147541,2,10,176,68
21907666.0,373,1849,4.957104557640751,2,8,372,1
21917398.0,11,67,6.090909090909091,2,9,8,3
21923038.0,195,1344,6.892307692307693,2,9,143,52
21923527.0,1,3,3.0,3,3,1,0
21924342.0,42,288,6.857142857142857,4,9,29,13
21932846.0,223,2150,9.641255605381167,2,13,12,211
21941422.0,9,18,2.0,1,3,9,0
21942566.0,347,1366,3.936599423631124,1,8,346,1
21943620.0,1,1,1.0,1,1,1,0
21944126.0,114,441,3.8684210526315788,1,7,114,0
21944800.0,261,1304,4.996168582375479,2,7,261,0
21946532.0,301,1521,5.053156146179402,2,8,296,5
21948184.0,242,732,3.024793388429752,1,5,242,0
21948629.0,208,1043,5.014423076923077,2,8,203,5
21948767.0,236,2292,9.711864406779661,2,12,13,223
21953409.0,38,52,1.368421052631579,1,3,38,0
21953979.0,207,1625,7.85024154589372,3,10,69,138
21955178.0,160,800,5.0,2,8,158,2
21961391.0,115,226,1.9652173913043478,1,5,115,0
21963438.0,389,830,2.133676092544987,1,5,389,0
21971392.0,305,655,2.1475409836065573,1,5,305,0
21972138.0,139,668,4.805755395683454,1,7,139,0
21977656.0,65,135,2.076923076923077,1,4,65,0
21978147.0,77,157,2.038961038961039,1,4,77,0
21981519.0,138,951,6.891304347826087,2,10,97,41
21991679.0,21,147,7.0,5,9,15,6
21993344.0,82,563,6.865853658536586,2,9,57,25
21993405.0,142,293,2.063380281690141,1,5,142,0
21993614.0,4,14,3.5,1,5,4,0
21994352.0,10,24,2.4,1,4,10,0
21994965.0,144,1114,7.736111111111111,2,11,53,91
21995203.0,13,112,8.615384615384615,2,11,2,11
21995360.0,40,121,3.025,1,6,40,0
21996793.0,7,10,1.4285714285714286,1,2,7,0
22003790.0,323,2261,7.0,2,9,207,116
22004777.0,17,36,2.1176470588235294,1,3,17,0
22005454.0,151,756,5.006622516556291,2,8,149,2
22006696.0,251,2418,9.633466135458168,2,13,18,233
22007370.0,38,78,2.0526315789473686,1,5,38,0
22022217.0,6,8,1.3333333333333333,1,2,6,0
22022746.0,74,353,4.77027027027027,2,7,74,0
22026359.0,59,173,2.9322033898305087,1,5,59,0
22028562.0,131,524,4.0,2,7,131,0
22028612.0,4,11,2.75,1,4,4,0
22029941.0,133,1313,9.87218045112782,2,13,9,124
22033666.0,527,2642,5.013282732447818,2,8,522,5
22042300.0,11,17,1.5454545454545454,1,5,11,0
22043848.0,176,886,5.034090909090909,2,7,176,0
22043917.0,7,22,3.142857142857143,2,4,7,0
22045201.0,208,2012,9.673076923076923,2,13,11,197
22048891.0,2,3,1.5,1,2,2,0
22056147.0,9,73,8.11111111111111,7,10,2,7
22056579.0,165,1564,9.478787878787879,2,13,16,149
22057400.0,1,3,3.0,3,3,1,0
22059474.0,199,1333,6.698492462311558,2,10,151,48
22060178.0,164,1114,6.7926829268292686,2,10,122,42
22070432.0,44,177,4.0227272727272725,2,6,44,0
22072825.0,6,10,1.6666666666666667,1,3,6,0
22074163.0,11,51,4.636363636363637,3,7,11,0
22074541.0,24,113,4.708333333333333,2,7,24,0
22074774.0,31,123,3.967741935483871,1,6,31,0
22074854.0,55,277,5.036363636363636,2,7,55,0
22074946.0,8,44,5.5,4,7,8,0
22075076.0,2,11,5.5,5,6,2,0
22075215.0,6,48,8.0,5,10,2,4
22080021.0,192,417,2.171875,1,5,192,0
22080927.0,3,5,1.6666666666666667,1,2,3,0
22081119.0,14,127,9.071428571428571,2,11,2,12
22082795.0,111,224,2.018018018018018,1,4,111,0
22084743.0,3,7,2.3333333333333335,1,3,3,0
22093111.0,23,46,2.0,1,4,23,0
22093664.0,3,6,2.0,1,4,3,0
22093916.0,24,31,1.2916666666666667,1,3,24,0
22094140.0,5,12,2.4,1,4,5,0
22096126.0,18,42,2.3333333333333335,1,4,18,0
22101263.0,394,1928,4.893401015228426,2,8,388,6
22101833.0,340,3284,9.658823529411764,3,13,21,319
22103455.0,452,2226,4.924778761061947,2,8,451,1
22121376.0,89,521,5.853932584269663,2,9,82,7
22121943.0,9,14,1.5555555555555556,1,3,9,0
22122090.0,8,10,1.25,1,2,8,0
22123039.0,179,1750,9.776536312849162,2,12,9,170
22135480.0,34,236,6.9411764705882355,2,9,25,9
22141851.0,7,9,1.2857142857142858,1,2,7,0
22143442.0,45,259,5.7555555555555555,3,8,42,3
22144374.0,7,9,1.2857142857142858,1,3,7,0
22144862.0,157,1518,9.668789808917197,2,12,11,146
22145265.0,80,458,5.725,3,9,75,5
22159114.0,2,16,8.0,8,8,0,2
22160218.0,257,1254,4.879377431906615,2,9,256,1
22161057.0,19,38,2.0,1,4,19,0
22161781.0,20,44,2.2,1,5,20,0
22163894.0,84,254,3.0238095238095237,1,5,84,0
22169128.0,208,1025,4.927884615384615,2,8,207,1
22172491.0,64,139,2.171875,1,4,64,0
22173645.0,67,232,3.462686567164179,1,6,67,0
22174013.0,98,280,2.857142857142857,1,5,98,0
22182516.0,2,2,1.0,1,1,2,0
22183315.0,1,4,4.0,4,4,1,0
22185626.0,56,539,9.625,2,12,6,50
22199272.0,35,184,5.257142857142857,3,7,35,0
22203112.0,10,98,9.8,9,11,0,10
22218310.0,47,364,7.74468085106383,2,11,15,32
22218431.0,311,1571,5.051446945337621,2,8,310,1
22225515.0,39,93,2.3846153846153846,1,4,39,0
22225748.0,363,1444,3.9779614325068873,1,7,363,0
22226095.0,34,93,2.735294117647059,1,4,34,0
22227272.0,339,1359,4.008849557522124,1,7,339,0
22227273.0,305,1190,3.901639344262295,1,7,305,0
22237513.0,1,4,4.0,4,4,1,0
22243486.0,119,839,7.050420168067227,2,10,75,44
22245868.0,181,719,3.972375690607735,1,7,181,0
22247143.0,179,1715,9.581005586592179,2,12,14,165
22247312.0,84,353,4.2023809523809526,1,7,84,0
22248175.0,5,20,4.0,2,5,5,0
22253539.0,41,302,7.365853658536586,2,10,20,21
22259952.0,2,3,1.5,1,2,2,0
22266820.0,229,1134,4.951965065502184,1,7,229,0
22272640.0,28,56,2.0,1,3,28,0
22275934.0,208,1847,8.879807692307692,2,12,15,193
22278200.0,9,15,1.6666666666666667,1,3,9,0
22280427.0,30,93,3.1,1,6,30,0
22286719.0,58,347,5.982758620689655,2,8,55,3
22300328.0,28,200,7.142857142857143,4,9,19,9
22302614.0,70,129,1.8428571428571427,1,4,70,0
22305603.0,410,1992,4.8585365853658535,1,8,407,3
22307213.0,245,515,2.1020408163265305,1,6,245,0
22307669.0,236,679,2.8771186440677967,1,6,236,0
22313159.0,195,1355,6.948717948717949,2,9,129,66
22314456.0,6,8,1.3333333333333333,1,2,6,0
22316138.0,98,199,2.0306122448979593,1,5,98,0
22320268.0,426,1297,3.044600938967136,1,6,426,0
22321964.0,423,1254,2.9645390070921986,1,6,423,0
22322823.0,480,1456,3.033333333333333,1,6,480,0
22330230.0,117,933,7.9743589743589745,2,11,34,83
22330754.0,76,217,2.8552631578947367,1,6,76,0
22332008.0,1,2,2.0,2,2,1,0
22336334.0,69,139,2.0144927536231885,1,5,69,0
22338475.0,309,611,1.977346278317152,1,5,309,0
22342124.0,444,902,2.0315315315315314,1,4,444,0
22342207.0,197,600,3.045685279187817,1,6,197,0
22342492.0,71,219,3.084507042253521,1,5,71,0
22348012.0,16,116,7.25,5,9,10,6
22352254.0,275,1350,4.909090909090909,2,8,271,4
22352494.0,64,97,1.515625,1,3,64,0
22353726.0,2,6,3.0,3,3,2,0
22354625.0,247,501,2.02834008097166,1,4,247,0
22354751.0,242,1194,4.933884297520661,2,8,241,1
22355241.0,349,732,2.097421203438395,1,5,349,0
22359269.0,578,2828,4.892733564013841,2,8,576,2
22363662.0,92,273,2.967391304347826,1,5,92,0
22366138.0,2,4,2.0,2,2,2,0
22369829.0,1,1,1.0,1,1,1,0
22373063.0,425,887,2.0870588235294116,1,5,425,0
22380263.0,120,558,4.65,2,7,120,0
22381438.0,124,166,1.3387096774193548,1,3,124,0
22387931.0,67,209,3.1194029850746268,1,5,67,0
22395407.0,40,85,2.125,1,4,40,0
22401318.0,155,1049,6.767741935483871,2,10,109,46
22406502.0,245,508,2.073469387755102,1,5,245,0
22409298.0,324,663,2.0462962962962963,1,4,324,0
22414175.0,33,302,9.151515151515152,2,13,4,29
22414195.0,135,1057,7.82962962962963,2,11,55,80
22416848.0,458,2262,4.93886462882096,1,8,456,2
22419773.0,170,1176,6.91764705882353,2,10,113,57
22432173.0,139,539,3.8776978417266186,1,7,139,0
22432427.0,291,582,2.0,1,5,291,0
22441812.0,30,59,1.9666666666666666,1,4,30,0
22443198.0,497,4760,9.577464788732394,2,13,36,461
22443289.0,182,1391,7.642857142857143,2,10,68,114
22446032.0,133,271,2.037593984962406,1,4,133,0
22446866.0,227,478,2.105726872246696,1,5,227,0
22454692.0,154,1092,7.090909090909091,4,9,94,60
22460012.0,5,34,6.8,6,8,4,1
22464399.0,24,97,4.041666666666667,2,6,24,0
22475549.0,160,1093,6.83125,2,10,111,49
22478937.0,124,259,2.088709677419355,1,5,124,0
22483208.0,195,1329,6.815384615384615,2,10,126,69
22488194.0,26,47,1.8076923076923077,1,4,26,0
22491898.0,220,305,1.3863636363636365,1,3,220,0
22496335.0,217,1074,4.949308755760368,2,8,213,4
22501213.0,538,4220,7.843866171003717,2,11,181,357
22510011.0,271,2603,9.605166051660516,2,13,17,254
22510354.0,268,2578,9.619402985074627,2,12,15,253
22510608.0,250,498,1.992,1,5,250,0
22514963.0,174,1696,9.74712643678161,2,13,7,167
22521242.0,25,53,2.12,1,4,25,0
22522456.0,2,5,2.5,2,3,2,0
22522464.0,104,1028,9.884615384615385,2,12,5,99
22529103.0,106,201,1.8962264150943395,1,4,106,0
22532179.0,365,1822,4.991780821917808,2,8,364,1
22536373.0,20,175,8.75,7,10,3,17
22537694.0,19,115,6.052631578947368,4,8,18,1
22539171.0,5,38,7.6,7,9,3,2
22542701.0,149,304,2.040268456375839,1,5,149,0
22543661.0,170,678,3.988235294117647,1,6,170,0
22549921.0,3,22,7.333333333333333,6,8,1,2
22559323.0,114,778,6.824561403508772,2,9,82,32
22561066.0,90,804,8.933333333333334,3,11,10,80
22562310.0,185,899,4.859459459459459,2,7,185,0
22563937.0,1,4,4.0,4,4,1,0
22581948.0,4,23,5.75,3,7,4,0
22594046.0,4,6,1.5,1,2,4,0
22603727.0,18,132,7.333333333333333,2,9,7,11
22621394.0,32,219,6.84375,2,8,20,12
22623197.0,422,2156,5.109004739336493,2,9,418,4
22628506.0,123,267,2.1707317073170733,1,4,123,0
22628570.0,2,8,4.0,4,4,2,0
22634993.0,301,2644,8.784053156146179,2,11,34,267
22642437.0,5,18,3.6,3,5,5,0
22644847.0,247,737,2.983805668016194,1,6,247,0
22648222.0,108,332,3.074074074074074,1,6,108,0
22650457.0,37,76,2.054054054054054,1,5,37,0
22651452.0,31,236,7.612903225806452,4,10,11,20
22660533.0,242,509,2.103305785123967,1,4,242,0
22661664.0,67,212,3.1641791044776117,1,6,67,0
22662207.0,121,259,2.1404958677685952,1,4,121,0
22664561.0,293,602,2.054607508532423,1,5,293,0
22668535.0,23,43,1.8695652173913044,1,4,23,0
22669275.0,162,329,2.0308641975308643,1,5,162,0
22681145.0,135,402,2.977777777777778,1,5,135,0
22684096.0,6,9,1.5,1,2,6,0
22684554.0,12,13,1.0833333333333333,1,2,12,0
22688293.0,1,3,3.0,3,3,1,0
22694811.0,204,800,3.9215686274509802,1,7,204,0
22700207.0,132,385,2.9166666666666665,1,5,132,0
22707983.0,169,822,4.863905325443787,2,8,168,1
22709327.0,16,52,3.25,2,5,16,0
22714490.0,168,347,2.0654761904761907,1,4,168,0
22716599.0,113,891,7.884955752212389,4,11,39,74
22726077.0,127,613,4.826771653543307,2,7,127,0
22729922.0,54,532,9.851851851851851,4,12,1,53
22730118.0,1,2,2.0,2,2,1,0
22733333.0,4,8,2.0,1,3,4,0
22748869.0,64,301,4.703125,2,7,64,0
22752048.0,381,808,2.120734908136483,1,5,381,0
22756930.0,7,11,1.5714285714285714,1,2,7,0
22758306.0,247,1236,5.004048582995951,2,9,246,1
22759109.0,232,713,3.0732758620689653,1,6,232,0
22759604.0,187,761,4.06951871657754,1,8,186,1
22764792.0,110,224,2.036363636363636,1,5,110,0
22765827.0,1,2,2.0,2,2,1,0
22766899.0,9,14,1.5555555555555556,1,2,9,0
22770187.0,223,1097,4.9192825112107625,2,8,221,2
22780563.0,198,775,3.914141414141414,1,7,198,0
22785220.0,49,106,2.163265306122449,1,4,49,0
22785366.0,22,78,3.5454545454545454,1,5,22,0
22787035.0,13,16,1.2307692307692308,1,3,13,0
22787596.0,7,7,1.0,1,1,7,0
22800510.0,37,83,2.2432432432432434,1,5,37,0
22800970.0,191,402,2.1047120418848166,1,5,191,0
22801194.0,49,435,8.877551020408163,5,11,4,45
22802228.0,61,466,7.639344262295082,3,10,21,40
22802277.0,33,247,7.484848484848484,2,10,14,19
22803132.0,4,8,2.0,1,4,4,0
22806331.0,2,12,6.0,5,7,2,0
22808440.0,57,174,3.0526315789473686,1,6,57,0
22808871.0,369,1084,2.937669376693767,1,6,369,0
22815736.0,312,924,2.9615384615384617,1,7,312,0
22822928.0,5,12,2.4,2,3,5,0
22825890.0,152,749,4.927631578947368,2,7,152,0
22827031.0,21,198,9.428571428571429,6,11,2,19
22830902.0,23,159,6.913043478260869,5,9,20,3
22841087.0,90,460,5.111111111111111,2,7,90,0
22842633.0,73,154,2.1095890410958904,1,5,73,0
22843633.0,8,53,6.625,3,9,5,3
22846276.0,363,3503,9.650137741046832,2,13,22,341
22856030.0,58,175,3.0172413793103448,2,5,58,0
22861012.0,37,333,9.0,7,11,3,34
22862142.0,169,1150,6.804733727810651,2,10,118,51
22863670.0,222,659,2.9684684684684686,1,6,222,0
22865011.0,1,4,4.0,4,4,1,0
22865582.0,166,1139,6.86144578313253,3,10,121,45
22871581.0,40,117,2.925,1,5,40,0
22872668.0,525,5076,9.668571428571429,2,13,28,497
22873250.0,13,107,8.23076923076923,7,10,3,10
22874749.0,10,32,3.2,1,5,10,0
22876092.0,135,1322,9.792592592592593,3,12,7,128
22877437.0,385,1907,4.953246753246753,2,8,384,1
22878458.0,214,824,3.850467289719626,1,7,214,0
22893199.0,85,334,3.929411764705882,1,6,85,0
22895126.0,1,1,1.0,1,1,1,0
22895515.0,93,751,8.075268817204302,5,10,20,73
22896409.0,89,359,4.033707865168539,2,7,89,0
22896599.0,153,759,4.96078431372549,3,7,153,0
22912378.0,55,115,2.090909090909091,1,4,55,0
22916423.0,183,1582,8.6448087431694,2,11,17,166
22918821.0,119,247,2.0756302521008405,1,4,119,0
22925834.0,140,964,6.885714285714286,2,9,96,44
22930406.0,67,523,7.8059701492537314,2,10,22,45
22931768.0,116,547,4.7155172413793105,2,7,116,0
22933453.0,154,605,3.9285714285714284,1,6,154,0
22933569.0,27,76,2.814814814814815,1,5,27,0
22939598.0,247,1668,6.753036437246964,2,11,184,63
22942266.0,416,2064,4.961538461538462,2,8,414,2
22943330.0,45,61,1.3555555555555556,1,4,45,0
22943847.0,120,841,7.008333333333334,2,10,77,43
22953249.0,113,235,2.079646017699115,1,4,113,0
22979863.0,368,1835,4.986413043478261,1,9,366,2
22984725.0,50,395,7.9,6,10,13,37
22985103.0,88,258,2.9318181818181817,1,5,88,0
22985266.0,97,762,7.855670103092783,2,10,31,66
22991001.0,134,670,5.0,2,8,132,2
22993368.0,315,3034,9.631746031746031,2,13,20,295
22997140.0,31,151,4.870967741935484,3,7,31,0
22999163.0,24,193,8.041666666666666,6,10,6,18
23000192.0,310,1502,4.84516129032258,2,7,310,0
23000277.0,4,6,1.5,1,2,4,0
23000633.0,33,236,7.151515151515151,3,10,17,16
23002507.0,49,417,8.510204081632653,2,11,6,43
23003939.0,7,19,2.7142857142857144,2,3,7,0
23008906.0,14,93,6.642857142857143,5,8,11,3
23012033.0,11,32,2.909090909090909,1,5,11,0
23013704.0,39,150,3.8461538461538463,1,6,39,0
23034890.0,191,593,3.1047120418848166,1,5,191,0
23041302.0,40,196,4.9,2,7,40,0
23044497.0,257,2012,7.828793774319066,3,10,96,161
23050623.0,451,3091,6.853658536585366,2,9,311,140
23056291.0,59,284,4.813559322033898,2,7,59,0
23058236.0,216,1060,4.907407407407407,2,7,216,0
23059120.0,461,4420,9.587852494577007,2,13,33,428
23067470.0,44,347,7.886363636363637,6,10,17,27
23067514.0,114,360,3.1578947368421053,1,5,114,0
23069092.0,549,1098,2.0,1,5,549,0
23072513.0,32,280,8.75,4,11,5,27
23084860.0,1,1,1.0,1,1,1,0
23085138.0,1,2,2.0,2,2,1,0
23088380.0,49,247,5.040816326530612,3,7,49,0
23101953.0,349,1722,4.934097421203439,2,8,347,2
23105267.0,95,469,4.936842105263158,2,8,94,1
23105274.0,63,307,4.873015873015873,2,7,63,0
23107624.0,207,832,4.019323671497585,2,6,207,0
23108520.0,2,5,2.5,2,3,2,0
23117462.0,10,64,6.4,3,8,6,4
23118654.0,11,34,3.090909090909091,1,4,11,0
23119737.0,365,1792,4.909589041095891,2,8,364,1
23124018.0,18,101,5.611111111111111,4,8,15,3
23124958.0,466,3198,6.8626609442060085,2,10,333,133
23125522.0,67,280,4.17910447761194,2,7,67,0
23134144.0,5,5,1.0,1,1,5,0
23135389.0,2,6,3.0,3,3,2,0
23135411.0,130,1279,9.838461538461539,2,12,7,123
23135722.0,3,8,2.6666666666666665,2,3,3,0
23136822.0,4,6,1.5,1,3,4,0
23137302.0,14,18,1.2857142857142858,1,2,14,0
23137498.0,1,2,2.0,2,2,1,0
23137641.0,7,8,1.1428571428571428,1,2,7,0
23138724.0,1,1,1.0,1,1,1,0
23138965.0,2,3,1.5,1,2,2,0
23139110.0,1,1,1.0,1,1,1,0
23139491.0,5,32,6.4,6,7,5,0
23139932.0,6,38,6.333333333333333,5,8,5,1
23142367.0,145,1266,8.73103448275862,2,12,17,128
23145918.0,22,48,2.1818181818181817,1,5,22,0
23160106.0,269,843,3.133828996282528,1,6,269,0
23162158.0,216,1431,6.625,2,9,158,58
23163777.0,81,164,2.0246913580246915,1,5,81,0
23166282.0,328,994,3.0304878048780486,1,6,328,0
23167066.0,232,2228,9.60344827586207,2,13,12,220
23176137.0,190,385,2.026315789473684,1,5,190,0
23181640.0,15,29,1.9333333333333333,1,3,15,0
23186843.0,111,227,2.045045045045045,1,4,111,0
23194228.0,20,37,1.85,1,4,20,0
23194959.0,144,435,3.0208333333333335,1,6,144,0
23196870.0,339,1666,4.9144542772861355,2,8,336,3
23197871.0,16,53,3.3125,1,6,16,0
23199091.0,271,1351,4.985239852398524,2,8,267,4
23199176.0,63,309,4.904761904761905,2,8,62,1
23203785.0,37,75,2.027027027027027,1,4,37,0
23205290.0,42,165,3.9285714285714284,2,6,42,0
23210760.0,533,2646,4.9643527204502815,2,8,528,5
23211401.0,37,255,6.891891891891892,2,10,23,14
23216406.0,30,96,3.2,2,5,30,0
23217051.0,213,1044,4.901408450704225,1,8,212,1
23217957.0,467,4496,9.627408993576017,2,13,32,435
23224367.0,126,385,3.0555555555555554,1,5,126,0
23225408.0,212,1467,6.919811320754717,2,10,146,66
23226721.0,44,85,1.9318181818181819,1,4,44,0
23231839.0,418,2861,6.844497607655502,2,9,297,121
23241387.0,143,718,5.020979020979021,2,8,142,1
23243363.0,2,7,3.5,3,4,2,0
23250743.0,159,311,1.9559748427672956,1,5,159,0
23250788.0,15,54,3.6,1,5,15,0
23251015.0,262,2021,7.713740458015267,2,10,89,173
23252743.0,17,53,3.1176470588235294,2,5,17,0
23254630.0,9,30,3.3333333333333335,2,5,9,0
23254763.0,33,285,8.636363636363637,4,11,5,28
23260377.0,17,48,2.823529411764706,1,5,17,0
23266320.0,129,858,6.651162790697675,2,10,93,36
23269747.0,297,1456,4.902356902356902,2,8,295,2
23273927.0,3,4,1.3333333333333333,1,2,3,0
23274878.0,271,1313,4.845018450184502,2,7,271,0
23280389.0,90,830,9.222222222222221,2,13,12,78
23280751.0,120,837,6.975,5,10,85,35
23280962.0,153,1047,6.8431372549019605,4,10,112,41
23282326.0,60,297,4.95,2,7,60,0
23284290.0,70,156,2.2285714285714286,1,4,70,0
23286224.0,168,1483,8.827380952380953,3,13,23,145
23287977.0,349,1716,4.916905444126074,1,8,345,4
23288641.0,257,1260,4.902723735408561,2,8,256,1
23290823.0,4,16,4.0,3,5,4,0
23298462.0,113,349,3.088495575221239,1,6,113,0
23298763.0,45,92,2.0444444444444443,1,4,45,0
23301767.0,346,736,2.1271676300578033,1,4,346,0
23303365.0,239,1157,4.841004184100418,2,8,238,1
23317320.0,3,4,1.3333333333333333,1,2,3,0
23317354.0,151,613,4.059602649006623,1,8,150,1
23318384.0,2,3,1.5,1,2,2,0
23318489.0,101,684,6.772277227722772,3,10,77,24
23332735.0,519,5029,9.689788053949904,2,13,30,489
23332765.0,121,597,4.933884297520661,2,7,121,0
23336651.0,437,919,2.102974828375286,1,5,437,0
23340755.0,210,2009,9.566666666666666,2,13,17,193
23349170.0,257,747,2.906614785992218,1,6,257,0
23351387.0,334,1649,4.937125748502994,2,7,334,0
23351424.0,125,1098,8.784,2,12,17,108
23351951.0,2,4,2.0,2,2,2,0
23357799.0,155,789,5.090322580645161,3,8,152,3
23358230.0,6,20,3.3333333333333335,2,6,6,0
23363995.0,306,1518,4.96078431372549,2,8,305,1
23368751.0,72,219,3.0416666666666665,1,5,72,0
23368752.0,141,409,2.900709219858156,1,5,141,0
23369070.0,26,129,4.961538461538462,2,7,26,0
23370397.0,70,493,7.042857142857143,5,9,46,24
23372536.0,282,2204,7.815602836879433,2,10,99,183
23375485.0,35,186,5.314285714285714,3,7,35,0
23377510.0,11,16,1.4545454545454546,1,3,11,0
23386788.0,4,30,7.5,3,10,1,3
23397073.0,176,369,2.096590909090909,1,5,176,0
23405331.0,254,773,3.043307086614173,1,5,254,0
23405437.0,15,17,1.1333333333333333,1,2,15,0
23409683.0,11,14,1.2727272727272727,1,2,11,0
23413884.0,136,288,2.1176470588235294,1,4,136,0
23417733.0,56,529,9.446428571428571,2,12,5,51
23418298.0,21,41,1.9523809523809523,1,3,21,0
23423162.0,59,582,9.864406779661017,3,12,3,56
23423790.0,302,2343,7.758278145695364,2,11,103,199
23427054.0,220,1043,4.740909090909091,2,8,219,1
23429304.0,330,1608,4.872727272727273,2,8,329,1
23430746.0,515,4053,7.8699029126213595,2,11,177,338
23431176.0,187,921,4.925133689839572,3,9,184,3
23442372.0,65,201,3.0923076923076924,1,5,65,0
23447147.0,33,45,1.3636363636363635,1,3,33,0
23450084.0,6,42,7.0,6,8,5,1
23451465.0,72,98,1.3611111111111112,1,3,72,0
23459257.0,33,65,1.9696969696969697,1,4,33,0
23459443.0,76,166,2.1842105263157894,1,5,76,0
23460041.0,41,86,2.097560975609756,1,4,41,0
23461573.0,228,1777,7.793859649122807,2,11,84,144
23461721.0,1,2,2.0,2,2,1,0
23464427.0,233,1164,4.9957081545064375,3,8,231,2
23464880.0,29,112,3.8620689655172415,3,5,29,0
23476851.0,317,650,2.050473186119874,1,4,317,0
23479247.0,153,1035,6.764705882352941,3,9,112,41
23479787.0,128,1234,9.640625,2,13,8,120
23480914.0,9,20,2.2222222222222223,1,4,9,0
23485232.0,79,694,8.784810126582279,5,11,8,71
23490604.0,178,1225,6.882022471910112,2,10,125,53
23491904.0,118,1041,8.822033898305085,3,11,12,106
23494179.0,259,1552,5.992277992277992,2,9,245,14
23495076.0,305,2120,6.950819672131147,2,10,210,95
23495524.0,256,2496,9.75,2,13,11,245
23497627.0,29,56,1.9310344827586208,1,4,29,0
23499269.0,197,581,2.949238578680203,1,6,197,0
23500006.0,51,355,6.96078431372549,3,10,34,17
23504628.0,37,72,1.945945945945946,1,4,37,0
23514501.0,122,956,7.836065573770492,2,11,35,87
23514904.0,15,139,9.266666666666667,3,13,2,13
23518344.0,159,308,1.9371069182389937,1,5,159,0
23518775.0,48,98,2.0416666666666665,1,4,48,0
23521086.0,117,787,6.726495726495727,2,10,91,26
23528954.0,84,575,6.845238095238095,2,9,57,27
23531756.0,11,92,8.363636363636363,7,10,2,9
23534312.0,90,180,2.0,1,5,90,0
23537916.0,58,270,4.655172413793103,3,7,58,0
23542773.0,265,1299,4.90188679245283,2,8,264,1
23544096.0,23,42,1.826086956521739,1,3,23,0
23551630.0,502,2486,4.952191235059761,2,8,500,2
23554443.0,48,242,5.041666666666667,2,7,48,0
23554747.0,61,257,4.213114754098361,1,7,61,0
23557914.0,139,552,3.971223021582734,1,7,139,0
23573448.0,14,66,4.714285714285714,4,6,14,0
23574920.0,63,594,9.428571428571429,2,13,5,58
23576978.0,110,214,1.9454545454545455,1,5,110,0
23579143.0,168,355,2.113095238095238,1,5,168,0
23588879.0,209,1239,5.92822966507177,2,8,194,15
23591365.0,52,154,2.9615384615384617,1,5,52,0
23591650.0,36,72,2.0,1,4,36,0
23601031.0,62,182,2.935483870967742,1,5,62,0
23601424.0,39,330,8.461538461538462,2,11,7,32
23608646.0,58,131,2.2586206896551726,1,4,58,0
23614762.0,60,516,8.6,5,11,7,53
23623391.0,41,205,5.0,3,7,41,0
23632622.0,27,203,7.518518518518518,3,9,11,16
23638253.0,150,311,2.0733333333333333,1,5,150,0
23643982.0,166,504,3.036144578313253,1,6,166,0
23649464.0,22,41,1.8636363636363635,1,3,22,0
23657566.0,1,4,4.0,4,4,1,0
23660687.0,50,100,2.0,1,4,50,0
23664667.0,192,967,5.036458333333333,2,8,190,2
23667784.0,4,10,2.5,2,3,4,0
23667896.0,75,372,4.96,3,7,75,0
23668308.0,3,4,1.3333333333333333,1,2,3,0
23674514.0,755,3043,4.03046357615894,1,7,755,0
23674750.0,746,3645,4.886058981233244,2,8,744,2
23674753.0,4,12,3.0,1,5,4,0
23675993.0,342,711,2.0789473684210527,1,5,342,0
23684534.0,7,47,6.714285714285714,2,8,3,4
23685128.0,1,2,2.0,2,2,1,0
23692698.0,9,28,3.111111111111111,2,5,9,0
23697736.0,126,735,5.833333333333333,2,8,119,7
23698875.0,3,3,1.0,1,1,3,0
23700696.0,150,1033,6.886666666666667,3,9,111,39
23706651.0,96,293,3.0520833333333335,1,6,96,0
23710175.0,174,1699,9.764367816091953,2,12,7,167
23713457.0,298,2900,9.731543624161073,2,13,18,280
23719774.0,124,1203,9.701612903225806,2,12,8,116
23721334.0,313,623,1.9904153354632588,1,5,313,0
23723904.0,25,208,8.32,7,10,4,21
23723964.0,27,127,4.703703703703703,2,7,27,0
23725966.0,390,1152,2.953846153846154,1,6,390,0
23726371.0,239,1174,4.912133891213389,2,8,236,3
23726971.0,86,343,3.988372093023256,2,7,86,0
23727844.0,167,804,4.81437125748503,2,9,165,2
23728656.0,2,2,1.0,1,1,2,0
23737302.0,281,1125,4.00355871886121,1,7,281,0
23739309.0,235,488,2.076595744680851,1,5,235,0
23742671.0,1,1,1.0,1,1,1,0
23743497.0,155,490,3.161290322580645,1,5,155,0
23745996.0,171,502,2.935672514619883,1,5,171,0
23747534.0,30,232,7.733333333333333,5,9,8,22
23748826.0,49,380,7.755102040816326,2,10,15,34
23756999.0,118,235,1.9915254237288136,1,4,118,0
23757774.0,316,1579,4.996835443037975,2,8,313,3
23767636.0,40,129,3.225,1,5,40,0
23770161.0,340,1665,4.897058823529412,2,8,338,2
23777837.0,22,177,8.045454545454545,6,10,8,14
23778843.0,57,219,3.8421052631578947,2,7,57,0
23788164.0,176,1221,6.9375,2,10,122,54
23789248.0,142,198,1.3943661971830985,1,4,142,0
23797642.0,246,499,2.0284552845528454,1,5,246,0
23798502.0,102,397,3.892156862745098,2,6,102,0
23798608.0,308,2140,6.9480519480519485,2,10,205,103
23800083.0,78,152,1.9487179487179487,1,4,78,0
23807865.0,157,1214,7.732484076433121,3,10,55,102
23808037.0,329,3166,9.623100303951368,2,13,22,307
23808189.0,309,2424,7.844660194174757,2,11,100,209
23809359.0,6,39,6.5,3,9,3,3
23809632.0,555,2743,4.942342342342342,2,8,552,3
23809722.0,51,340,6.666666666666667,4,9,35,16
23819530.0,330,1316,3.987878787878788,2,7,330,0
23824485.0,162,800,4.938271604938271,2,7,162,0
23831382.0,137,1337,9.75912408759124,2,13,6,131
23841284.0,205,1969,9.604878048780488,2,12,12,193
23844149.0,150,1032,6.88,2,10,99,51
23851967.0,237,730,3.080168776371308,1,6,237,0
23853652.0,35,263,7.514285714285714,2,10,14,21
23854785.0,225,1504,6.684444444444445,3,9,169,56
23856264.0,9,18,2.0,1,3,9,0
23856627.0,173,352,2.0346820809248554,1,4,173,0
23860842.0,21,135,6.428571428571429,2,8,19,2
23863233.0,155,1060,6.838709677419355,2,10,112,43
23864324.0,108,203,1.8796296296296295,1,4,108,0
23870321.0,362,1816,5.016574585635359,2,8,356,6
23870338.0,2,5,2.5,2,3,2,0
23872048.0,92,369,4.010869565217392,2,7,92,0
23872258.0,36,112,3.111111111111111,1,5,36,0
23872787.0,144,716,4.972222222222222,2,9,143,1
23873238.0,202,418,2.0693069306930694,1,5,202,0
23880028.0,248,1202,4.846774193548387,2,8,247,1
23880383.0,26,170,6.538461538461538,4,8,21,5
23880939.0,3,5,1.6666666666666667,1,2,3,0
23884624.0,73,580,7.945205479452055,2,10,22,51
23887305.0,186,564,3.032258064516129,1,6,186,0
23887434.0,24,47,1.9583333333333333,1,4,24,0
23888232.0,71,94,1.323943661971831,1,3,71,0
23888421.0,4,11,2.75,1,5,4,0
23888448.0,42,65,1.5476190476190477,1,3,42,0
23901804.0,139,542,3.8992805755395685,1,7,139,0
23902991.0,122,598,4.901639344262295,2,7,122,0
23913656.0,70,345,4.928571428571429,2,7,70,0
23915849.0,4,8,2.0,1,4,4,0
23917540.0,151,306,2.0264900662251657,1,5,151,0
23918141.0,122,256,2.098360655737705,1,4,122,0
23918771.0,37,184,4.972972972972973,3,7,37,0
23919658.0,36,272,7.555555555555555,3,11,15,21
23921327.0,124,607,4.895161290322581,2,7,124,0
23923900.0,8,12,1.5,1,3,8,0
23924474.0,150,752,5.013333333333334,2,7,150,0
23930840.0,161,790,4.906832298136646,3,7,161,0
23931701.0,189,381,2.015873015873016,1,4,189,0
23935986.0,236,965,4.088983050847458,1,7,236,0
23936046.0,17,98,5.764705882352941,5,7,17,0
23939767.0,238,465,1.953781512605042,1,5,238,0
23942086.0,111,1053,9.486486486486486,2,14,12,99
23943168.0,132,1240,9.393939393939394,2,12,14,118
23943336.0,5,13,2.6,1,4,5,0
23943627.0,108,540,5.0,2,8,107,1
23949246.0,34,71,2.088235294117647,1,4,34,0
23952878.0,135,794,5.881481481481481,3,8,127,8
23953585.0,165,835,5.0606060606060606,2,8,160,5
23958330.0,99,202,2.04040404040404,1,5,99,0
23969176.0,19,63,3.3157894736842106,1,5,19,0
23969417.0,184,1600,8.695652173913043,2,12,27,157
23971222.0,114,226,1.9824561403508771,1,4,114,0
23977589.0,415,3624,8.732530120481927,2,12,44,371
23977745.0,31,141,4.548387096774194,3,7,31,0
23985514.0,1,3,3.0,3,3,1,0
23985955.0,3,3,1.0,1,1,3,0
23986132.0,440,4256,9.672727272727272,2,13,26,414
23987766.0,17,87,5.117647058823529,4,8,16,1
23990745.0,31,157,5.064516129032258,4,7,31,0
23991007.0,140,678,4.8428571428571425,2,7,140,0
23994033.0,231,894,3.8701298701298703,1,7,231,0
23995231.0,193,1478,7.658031088082901,2,10,70,123
23996172.0,165,1101,6.672727272727273,2,10,126,39
24001422.0,130,1250,9.615384615384615,3,13,8,122
24003145.0,166,1636,9.855421686746988,2,13,9,157
24004654.0,6,35,5.833333333333333,5,6,6,0
24005645.0,141,1359,9.638297872340425,2,13,14,127
24006648.0,26,58,2.230769230769231,1,4,26,0
24009787.0,128,398,3.109375,1,6,128,0
24010896.0,161,795,4.937888198757764,2,7,161,0
24014537.0,87,180,2.0689655172413794,1,4,87,0
24014857.0,75,164,2.1866666666666665,1,4,75,0
24018410.0,4,9,2.25,1,4,4,0
24019089.0,55,280,5.090909090909091,2,8,54,1
24026402.0,126,492,3.9047619047619047,1,6,126,0
24026667.0,47,395,8.404255319148936,5,11,9,38
24032303.0,41,112,2.731707317073171,1,5,41,0
24032723.0,107,423,3.953271028037383,2,7,107,0
24033354.0,19,148,7.7894736842105265,3,10,6,13
24035381.0,326,677,2.076687116564417,1,5,326,0
24035894.0,86,170,1.9767441860465116,1,4,86,0
24037666.0,251,1725,6.872509960159363,2,9,178,73
24038249.0,125,1212,9.696,2,13,5,120
24038378.0,125,1068,8.544,2,12,20,105
24038780.0,62,110,1.7741935483870968,1,4,62,0
24040427.0,36,79,2.1944444444444446,1,4,36,0
24042695.0,48,202,4.208333333333333,1,6,48,0
24051218.0,233,1787,7.669527896995708,2,10,91,142
24064123.0,15,45,3.0,1,4,15,0
24064337.0,551,1150,2.087114337568058,1,5,551,0
24070644.0,17,37,2.176470588235294,1,4,17,0
24071841.0,342,3350,9.7953216374269,2,13,15,327
24076072.0,150,1151,7.673333333333333,2,10,58,92
24094148.0,36,285,7.916666666666667,6,10,14,22
24095882.0,87,178,2.045977011494253,1,4,87,0
24099947.0,291,2255,7.74914089347079,2,10,109,182
24107884.0,24,167,6.958333333333333,6,9,18,6
24115591.0,291,604,2.075601374570447,1,5,291,0
24119332.0,281,2741,9.754448398576512,2,13,13,268
24125795.0,137,672,4.905109489051095,2,7,137,0
24128944.0,277,2188,7.898916967509026,2,10,94,183
24134099.0,4,6,1.5,1,2,4,0
24134121.0,63,140,2.2222222222222223,1,5,63,0
24135239.0,105,410,3.9047619047619047,1,6,105,0
24136062.0,78,239,3.0641025641025643,1,6,78,0
24147709.0,244,1635,6.700819672131147,2,10,181,63
24151213.0,55,173,3.1454545454545455,1,5,55,0
24151782.0,158,1532,9.69620253164557,2,13,12,146
24165160.0,124,871,7.024193548387097,2,10,78,46
24166876.0,124,617,4.975806451612903,2,7,124,0
24171096.0,268,2363,8.817164179104477,2,11,29,239
24172512.0,85,173,2.0352941176470587,1,4,85,0
24178010.0,12,105,8.75,7,10,2,10
24178248.0,589,2909,4.938879456706282,2,8,588,1
24180857.0,368,3244,8.815217391304348,2,12,41,327
24181506.0,191,1326,6.942408376963351,3,10,136,55
24182172.0,161,955,5.931677018633541,2,9,154,7
24198823.0,642,6200,9.657320872274143,2,13,41,601
24200381.0,71,147,2.0704225352112675,1,4,71,0
24201540.0,255,2459,9.64313725490196,2,12,18,237
24218907.0,94,275,2.925531914893617,1,5,94,0
24220508.0,327,1624,4.966360856269113,2,8,324,3
24225762.0,5,9,1.8,1,3,5,0
24228890.0,5,39,7.8,7,9,3,2
24243031.0,8,40,5.0,4,6,8,0
24246818.0,1,4,4.0,4,4,1,0
24247623.0,165,1465,8.878787878787879,2,12,17,148
24250606.0,10,54,5.4,5,6,10,0
24253786.0,175,547,3.125714285714286,1,7,175,0
24257940.0,87,339,3.896551724137931,1,6,87,0
24258225.0,194,1912,9.855670103092784,3,13,8,186
24258892.0,2,3,1.5,1,2,2,0
24258981.0,113,149,1.3185840707964602,1,3,113,0
24264598.0,57,117,2.0526315789473686,1,4,57,0
24275005.0,76,504,6.631578947368421,2,9,57,19
24275066.0,65,88,1.353846153846154,1,3,65,0
24278032.0,14,75,5.357142857142857,2,8,13,1
24303204.0,122,1156,9.475409836065573,2,12,10,112
24304659.0,20,38,1.9,1,3,20,0
24305449.0,1,3,3.0,3,3,1,0
24306988.0,5,17,3.4,1,5,5,0
24309006.0,4,9,2.25,1,3,4,0
24317070.0,196,788,4.020408163265306,1,7,196,0
24320628.0,169,364,2.1538461538461537,1,5,169,0
24323668.0,122,985,8.073770491803279,3,12,32,90
24324849.0,16,30,1.875,1,4,16,0
24328395.0,7,22,3.142857142857143,1,5,7,0
24339118.0,179,1218,6.804469273743017,2,10,126,53
24341360.0,87,652,7.494252873563219,3,10,42,45
24348581.0,115,158,1.373913043478261,1,3,115,0
24350200.0,8,33,4.125,2,5,8,0
24351998.0,1,2,2.0,2,2,1,0
24355249.0,214,1677,7.836448598130841,2,11,72,142
24355672.0,434,2989,6.887096774193548,2,10,290,144
24362246.0,33,73,2.212121212121212,1,4,33,0
24363926.0,45,84,1.8666666666666667,1,4,45,0
24364750.0,29,274,9.448275862068966,3,12,3,26
24366011.0,436,4191,9.612385321100918,2,13,30,406
24376153.0,102,209,2.049019607843137,1,4,102,0
24384670.0,244,1675,6.864754098360656,2,10,175,69
24385582.0,47,366,7.787234042553192,4,11,18,29
24392439.0,523,2599,4.969407265774379,2,8,515,8
24395903.0,18,24,1.3333333333333333,1,3,18,0
24398997.0,57,160,2.807017543859649,1,5,57,0
24402529.0,14,126,9.0,5,11,2,12
24407807.0,134,181,1.3507462686567164,1,4,134,0
24415128.0,6,14,2.3333333333333335,1,4,6,0
24419135.0,252,785,3.115079365079365,1,6,252,0
24421887.0,15,44,2.933333333333333,1,5,15,0
24425841.0,12,23,1.9166666666666667,1,4,12,0
24425858.0,329,2201,6.689969604863222,2,10,242,87
24430508.0,71,213,3.0,1,5,71,0
24436630.0,34,68,2.0,1,4,34,0
24437133.0,346,715,2.066473988439306,1,6,346,0
24439052.0,191,958,5.015706806282722,2,8,190,1
24440846.0,2,6,3.0,2,4,2,0
24442021.0,5,6,1.2,1,2,5,0
24444094.0,64,265,4.140625,2,7,64,0
24449568.0,406,3878,9.551724137931034,2,13,31,375
24451972.0,68,327,4.8088235294117645,2,7,68,0
24458539.0,237,490,2.067510548523207,1,6,237,0
24459446.0,273,2609,9.556776556776557,2,13,19,254
24460827.0,190,763,4.015789473684211,2,7,190,0
24461899.0,211,1046,4.957345971563981,2,8,209,2
24463484.0,139,286,2.0575539568345325,1,4,139,0
24468159.0,7,13,1.8571428571428572,1,3,7,0
24474302.0,41,359,8.75609756097561,6,11,4,37
24478640.0,11,16,1.4545454545454546,1,3,11,0
24478877.0,22,34,1.5454545454545454,1,3,22,0
24478960.0,348,474,1.3620689655172413,1,4,348,0
24479088.0,30,39,1.3,1,2,30,0
24479843.0,422,4050,9.597156398104266,2,13,29,393
24482043.0,21,46,2.1904761904761907,1,4,21,0
24484273.0,164,1596,9.731707317073171,2,13,5,159
24484360.0,10,83,8.3,7,9,1,9
24484822.0,39,77,1.9743589743589745,1,3,39,0
24487266.0,92,439,4.771739130434782,2,8,91,1
24489295.0,4,9,2.25,1,3,4,0
24492360.0,103,581,5.640776699029126,2,8,101,2
24494055.0,113,157,1.3893805309734513,1,4,113,0
24497663.0,38,88,2.3157894736842106,1,5,38,0
24505443.0,67,473,7.059701492537314,2,10,45,22
24508884.0,57,222,3.8947368421052633,1,6,57,0
24509024.0,27,54,2.0,1,5,27,0
24527962.0,31,95,3.064516129032258,1,5,31,0
24530851.0,21,61,2.9047619047619047,1,4,21,0
24534164.0,3,8,2.6666666666666665,2,4,3,0
24535371.0,47,398,8.46808510638298,2,11,11,36
24535651.0,66,450,6.818181818181818,3,10,48,18
24537996.0,402,1964,4.885572139303482,2,8,400,2
24538131.0,202,985,4.876237623762377,2,8,200,2
24540015.0,258,2506,9.713178294573643,2,13,17,241
24542059.0,19,145,7.631578947368421,5,9,8,11
24550275.0,55,170,3.090909090909091,1,5,55,0
24555986.0,111,850,7.657657657657658,2,10,41,70
24556958.0,320,3115,9.734375,2,13,23,297
24557582.0,61,125,2.0491803278688523,1,4,61,0
24565129.0,79,627,7.936708860759493,4,10,23,56
24567665.0,1,9,9.0,9,9,0,1
24568268.0,98,933,9.520408163265307,3,12,8,90
24572838.0,131,878,6.702290076335878,2,9,104,27
24576454.0,97,397,4.092783505154639,1,6,97,0
24577810.0,3,6,2.0,1,3,3,0
24577826.0,1,3,3.0,3,3,1,0
24590724.0,4,7,1.75,1,2,4,0
24592541.0,265,795,3.0,1,5,265,0
24594682.0,9,36,4.0,2,7,9,0
24594700.0,164,631,3.847560975609756,2,6,164,0
24603663.0,72,289,4.013888888888889,2,7,72,0
24604357.0,45,319,7.088888888888889,5,9,32,13
24606358.0,8,23,2.875,1,4,8,0
24611641.0,107,823,7.691588785046729,2,10,38,69
24615822.0,98,211,2.1530612244897958,1,5,98,0
24622764.0,107,517,4.831775700934579,2,7,107,0
24624146.0,105,530,5.0476190476190474,2,7,105,0
24626298.0,104,525,5.048076923076923,2,7,104,0
24630615.0,198,407,2.0555555555555554,1,5,198,0
24638195.0,2,4,2.0,2,2,2,0
24638828.0,137,917,6.693430656934306,3,9,110,27
24639304.0,287,2001,6.97212543554007,2,9,197,90
24639705.0,9,15,1.6666666666666667,1,3,9,0
24640533.0,68,199,2.926470588235294,1,5,68,0
24641609.0,4,29,7.25,6,9,3,1
24655695.0,44,434,9.863636363636363,4,12,2,42
24663096.0,6,46,7.666666666666667,7,9,3,3
24666391.0,243,1217,5.008230452674897,2,8,242,1
24669134.0,25,51,2.04,1,4,25,0
24673931.0,175,360,2.057142857142857,1,5,175,0
24677283.0,30,73,2.433333333333333,1,5,30,0
24681953.0,201,973,4.840796019900497,1,7,201,0
24682171.0,63,252,4.0,2,7,63,0
24686198.0,11,47,4.2727272727272725,2,6,11,0
24691530.0,114,328,2.8771929824561404,1,5,114,0
24692982.0,250,727,2.908,1,7,250,0
24693057.0,236,698,2.957627118644068,1,5,236,0
24694109.0,366,3531,9.647540983606557,2,13,23,343
24694762.0,633,6085,9.612954186413901,2,13,36,597
24696077.0,6,21,3.5,3,4,6,0
24697607.0,18,76,4.222222222222222,2,6,18,0
24703589.0,25,140,5.6,2,9,24,1
24712001.0,128,1259,9.8359375,4,13,5,123
24722194.0,6,32,5.333333333333333,4,6,6,0
24726954.0,310,1536,4.95483870967742,2,8,309,1
24727336.0,4,26,6.5,6,8,3,1
24729745.0,19,80,4.2105263157894735,3,6,19,0
24734169.0,68,480,7.0588235294117645,5,10,44,24
24740233.0,28,107,3.8214285714285716,2,7,28,0
24740380.0,29,179,6.172413793103448,4,9,26,3
24743779.0,47,228,4.851063829787234,3,7,47,0
24745931.0,108,840,7.777777777777778,3,10,43,65
24749197.0,232,2216,9.551724137931034,2,14,19,213
24751809.0,297,1461,4.91919191919192,2,8,296,1
24752653.0,198,1917,9.681818181818182,2,13,10,188
24753493.0,14,97,6.928571428571429,2,9,8,6
24765400.0,96,946,9.854166666666666,3,13,4,92
24768989.0,3,4,1.3333333333333333,1,2,3,0
24771418.0,373,1826,4.89544235924933,1,8,372,1
24779365.0,250,1251,5.004,2,7,250,0
24780084.0,111,946,8.522522522522523,2,12,19,92
24784822.0,66,551,8.348484848484848,3,11,12,54
24787515.0,264,2540,9.621212121212121,2,13,22,242
24789511.0,115,800,6.956521739130435,3,10,78,37
24791264.0,44,287,6.5227272727272725,3,9,35,9
24801304.0,29,213,7.344827586206897,2,10,11,18
24802481.0,276,2678,9.702898550724637,2,14,17,259
24805269.0,19,100,5.2631578947368425,2,8,18,1
24806839.0,72,349,4.847222222222222,3,7,72,0
24813961.0,58,321,5.5344827586206895,2,8,53,5
24816210.0,17,38,2.235294117647059,1,4,17,0
24818083.0,2,17,8.5,8,9,0,2
24818462.0,96,837,8.71875,2,11,10,86
24819443.0,256,1069,4.17578125,2,6,256,0
24819547.0,104,518,4.980769230769231,2,8,103,1
24821348.0,209,1063,5.086124401913875,2,7,209,0
24825239.0,6,40,6.666666666666667,4,9,4,2
24826150.0,44,63,1.4318181818181819,1,3,44,0
24843594.0,5,11,2.2,1,4,5,0
24848501.0,44,216,4.909090909090909,3,7,44,0
24850243.0,231,2166,9.376623376623376,2,13,24,207
24852173.0,165,1136,6.884848484848485,3,10,120,45
24854475.0,5,7,1.4,1,2,5,0
24861763.0,71,208,2.9295774647887325,1,5,71,0
24862265.0,341,999,2.929618768328446,1,6,341,0
24863420.0,164,1133,6.908536585365853,2,9,106,58
24869040.0,146,311,2.1301369863013697,1,4,146,0
24872161.0,370,3605,9.743243243243244,2,13,12,358
24880934.0,17,83,4.882352941176471,3,7,17,0
24885811.0,62,86,1.3870967741935485,1,4,62,0
24888754.0,42,82,1.9523809523809523,1,4,42,0
24900786.0,34,92,2.7058823529411766,1,4,34,0
24903281.0,106,538,5.0754716981132075,3,8,105,1
24909875.0,256,1763,6.88671875,2,10,175,81
24911413.0,31,95,3.064516129032258,1,5,31,0
24912217.0,354,2783,7.861581920903955,2,11,116,238
24912601.0,181,1768,9.767955801104973,3,12,9,172
24913799.0,376,2959,7.86968085106383,2,11,107,269
24914858.0,8,64,8.0,3,10,2,6
24916189.0,478,2376,4.97071129707113,2,8,475,3
24919027.0,8,10,1.25,1,2,8,0
24930160.0,331,3227,9.749244712990937,2,13,18,313
24932985.0,276,2670,9.673913043478262,2,13,19,257
24935267.0,119,598,5.025210084033613,3,8,118,1
24936729.0,519,4554,8.77456647398844,2,12,71,448
24937981.0,2,16,8.0,8,8,0,2
24940514.0,35,311,8.885714285714286,6,11,3,32
24940608.0,438,2994,6.835616438356165,2,10,310,128
24942511.0,94,452,4.808510638297872,2,8,93,1
24950993.0,238,2313,9.718487394957982,2,13,13,225
24951180.0,287,1402,4.885017421602788,2,8,286,1
24955353.0,161,474,2.9440993788819876,1,6,161,0
24959331.0,376,1829,4.86436170212766,2,8,375,1
24967286.0,240,486,2.025,1,5,240,0
24967363.0,129,270,2.0930232558139537,1,4,129,0
24967871.0,13,66,5.076923076923077,2,7,13,0
24973416.0,182,1770,9.725274725274724,3,13,9,173
24977601.0,36,117,3.25,1,7,36,0
24982258.0,23,92,4.0,2,6,23,0
24986072.0,197,604,3.065989847715736,1,6,197,0
24989766.0,14,55,3.9285714285714284,3,5,14,0
25003158.0,99,968,9.777777777777779,4,12,4,95
25007265.0,36,74,2.0555555555555554,1,4,36,0
25007995.0,10,42,4.2,2,5,10,0
25010225.0,38,109,2.8684210526315788,1,5,38,0
25017442.0,226,2150,9.513274336283185,2,13,16,210
25018147.0,342,1684,4.923976608187134,1,7,342,0
25025198.0,13,21,1.6153846153846154,1,3,13,0
25041070.0,25,75,3.0,1,5,25,0
25047520.0,111,156,1.4054054054054055,1,4,111,0
25048595.0,280,1388,4.957142857142857,2,8,279,1
25062470.0,139,947,6.81294964028777,2,9,94,45
25063330.0,311,658,2.1157556270096465,1,4,311,0
25063558.0,164,1246,7.597560975609756,2,10,68,96
25066302.0,264,2525,9.56439393939394,2,13,18,246
25067868.0,11,16,1.4545454545454546,1,3,11,0
25069074.0,15,20,1.3333333333333333,1,3,15,0
25070970.0,54,97,1.7962962962962963,1,4,54,0
25076797.0,66,200,3.0303030303030303,1,5,66,0
25079758.0,23,45,1.9565217391304348,1,4,23,0
25092509.0,31,66,2.129032258064516,1,5,31,0
25093967.0,70,354,5.057142857142857,2,8,69,1
25103082.0,66,200,3.0303030303030303,1,5,66,0
25104318.0,4,4,1.0,1,1,4,0
25117934.0,11,22,2.0,1,4,11,0
25122371.0,29,178,6.137931034482759,3,9,25,4
25125590.0,114,561,4.921052631578948,2,7,114,0
25128975.0,168,517,3.0773809523809526,1,5,168,0
25130216.0,6,12,2.0,1,3,6,0
25135178.0,13,26,2.0,1,3,13,0
25150819.0,48,467,9.729166666666666,3,12,4,44
25152284.0,107,434,4.05607476635514,2,6,107,0
25153236.0,33,60,1.8181818181818181,1,3,33,0
25153508.0,296,1470,4.966216216216216,2,8,295,1
25156920.0,105,734,6.9904761904761905,2,10,69,36
25160549.0,36,73,2.0277777777777777,1,4,36,0
25173129.0,222,1323,5.95945945945946,3,9,202,20
25175484.0,60,483,8.05,6,10,15,45
25180400.0,280,1399,4.996428571428571,2,7,280,0
25182387.0,220,1112,5.054545454545455,2,8,219,1
25183815.0,208,1041,5.0048076923076925,2,7,208,0
25190221.0,171,841,4.918128654970761,2,8,170,1
25190892.0,37,185,5.0,3,7,37,0
25191190.0,121,598,4.9421487603305785,2,8,120,1
25201464.0,334,2288,6.850299401197605,2,10,237,97
25207154.0,392,2679,6.834183673469388,2,10,281,111
25207374.0,285,590,2.0701754385964914,1,5,285,0
25207595.0,384,2606,6.786458333333333,2,10,281,103
25207888.0,336,2304,6.857142857142857,2,10,240,96
25208089.0,417,875,2.0983213429256593,1,5,417,0
25210319.0,4,12,3.0,1,4,4,0
25226881.0,51,188,3.6862745098039214,2,6,51,0
25229537.0,283,2159,7.628975265017668,2,12,112,171
25229654.0,448,4358,9.727678571428571,2,13,27,421
25229885.0,214,460,2.149532710280374,1,4,214,0
25231967.0,141,1357,9.624113475177305,2,12,11,130
25234088.0,8,10,1.25,1,2,8,0
25237239.0,5,12,2.4,1,3,5,0
25245684.0,80,172,2.15,1,4,80,0
25251844.0,211,1439,6.819905213270142,2,10,154,57
25254836.0,73,145,1.9863013698630136,1,5,73,0
25256329.0,10,48,4.8,4,6,10,0
25256742.0,503,2484,4.938369781312128,2,8,500,3
25259515.0,191,1863,9.75392670157068,3,13,17,174
25259657.0,48,480,10.0,7,12,1,47
25262285.0,96,208,2.1666666666666665,1,4,96,0
25265182.0,187,1785,9.545454545454545,2,14,15,172
25278403.0,119,361,3.033613445378151,1,7,119,0
25284361.0,20,48,2.4,1,4,20,0
25287172.0,88,851,9.670454545454545,2,12,2,86
25291932.0,123,370,3.008130081300813,1,6,123,0
25304380.0,62,178,2.870967741935484,1,6,62,0
25305938.0,16,106,6.625,4,8,12,4
25307158.0,12,21,1.75,1,4,12,0
25308917.0,77,233,3.0259740259740258,1,6,77,0
25312533.0,143,989,6.916083916083916,4,9,102,41
25313243.0,252,542,2.1507936507936507,1,5,252,0
25318478.0,322,3110,9.658385093167702,2,12,20,302
25321282.0,7,19,2.7142857142857144,2,4,7,0
25323846.0,25,74,2.96,1,5,25,0
25329329.0,629,1290,2.0508744038155804,1,5,629,0
25336303.0,15,21,1.4,1,2,15,0
25343589.0,30,69,2.3,1,4,30,0
25358481.0,383,3625,9.464751958224543,2,12,36,347
25360742.0,111,749,6.747747747747748,3,10,89,22
25361181.0,350,1768,5.051428571428572,2,8,348,2
25366643.0,221,666,3.013574660633484,1,5,221,0
25366708.0,57,520,9.12280701754386,7,11,1,56
25366967.0,1,1,1.0,1,1,1,0
25370004.0,15,21,1.4,1,3,15,0
25371389.0,17,25,1.4705882352941178,1,3,17,0
25373452.0,16,19,1.1875,1,2,16,0
25373795.0,17,22,1.2941176470588236,1,2,17,0
25377610.0,14,22,1.5714285714285714,1,3,14,0
25387104.0,15,22,1.4666666666666666,1,3,15,0
25391587.0,233,522,2.240343347639485,1,5,233,0
25391756.0,38,79,2.0789473684210527,1,5,38,0
25391883.0,19,24,1.263157894736842,1,3,19,0
25391903.0,119,1037,8.714285714285714,3,12,17,102
25393356.0,9,14,1.5555555555555556,1,3,9,0
25394047.0,14,15,1.0714285714285714,1,2,14,0
25398055.0,58,106,1.8275862068965518,1,4,58,0
25408619.0,27,80,2.962962962962963,1,5,27,0
25409448.0,647,1349,2.0850077279752703,1,5,647,0
25411643.0,61,241,3.9508196721311477,2,7,61,0
25413950.0,122,611,5.008196721311475,3,7,122,0
25415187.0,24,85,3.5416666666666665,2,5,24,0
25417162.0,29,210,7.241379310344827,5,9,16,13
25419828.0,287,1143,3.9825783972125435,2,7,287,0
25437138.0,416,1244,2.9903846153846154,1,6,416,0
25438727.0,27,217,8.037037037037036,3,10,7,20
25441986.0,12,23,1.9166666666666667,1,3,12,0
25445387.0,132,648,4.909090909090909,2,8,131,1
25448553.0,44,127,2.8863636363636362,1,5,44,0
25448737.0,153,760,4.967320261437909,2,7,153,0
25453414.0,355,1739,4.898591549295775,2,8,353,2
25455278.0,540,3671,6.798148148148148,2,10,400,140
25461658.0,281,1905,6.779359430604982,2,10,201,80
25463501.0,103,407,3.9514563106796117,2,6,103,0
25465197.0,140,421,3.007142857142857,1,6,140,0
25465763.0,230,1153,5.01304347826087,2,8,229,1
25467137.0,208,633,3.043269230769231,1,5,208,0
25473755.0,94,649,6.904255319148936,3,10,69,25
25475293.0,2,4,2.0,2,2,2,0
25477776.0,447,4326,9.677852348993289,2,13,27,420
25478666.0,20,146,7.3,2,9,6,14
25479299.0,38,330,8.68421052631579,2,10,6,32
25481435.0,357,1785,5.0,1,8,356,1
25485780.0,386,3773,9.77461139896373,2,12,19,367
25497904.0,48,138,2.875,1,4,48,0
25499025.0,167,515,3.0838323353293413,1,6,167,0
25508677.0,38,339,8.921052631578947,2,11,2,36
25509182.0,74,215,2.9054054054054053,1,6,74,0
25510829.0,10,103,10.3,8,13,0,10
25514919.0,3,5,1.6666666666666667,1,2,3,0
25517091.0,18,34,1.8888888888888888,1,4,18,0
25523332.0,366,762,2.081967213114754,1,5,366,0
25526935.0,258,1765,6.841085271317829,3,9,185,73
25528569.0,36,71,1.9722222222222223,1,4,36,0
25531394.0,5,9,1.8,1,3,5,0
25540733.0,202,603,2.985148514851485,1,6,202,0
25542784.0,125,1076,8.608,2,11,17,108
25544015.0,182,887,4.873626373626373,3,8,181,1
25554347.0,60,122,2.033333333333333,1,4,60,0
25555881.0,153,448,2.9281045751633985,1,5,153,0
25558451.0,410,3904,9.521951219512195,2,13,31,379
25562169.0,4,9,2.25,2,3,4,0
25564019.0,23,70,3.0434782608695654,1,4,23,0
25571350.0,115,154,1.3391304347826087,1,3,115,0
25571647.0,287,1425,4.965156794425087,2,8,285,2
25572293.0,493,1042,2.1135902636916835,1,6,493,0
25578374.0,23,46,2.0,1,4,23,0
25606815.0,192,904,4.708333333333333,2,8,191,1
25607973.0,2,3,1.5,1,2,2,0
25624241.0,41,95,2.317073170731707,1,4,41,0
25625262.0,293,2798,9.549488054607508,2,13,21,272
25625786.0,51,152,2.980392156862745,1,5,51,0
25627333.0,383,1904,4.971279373368146,2,8,381,2
25652775.0,2,4,2.0,1,3,2,0
25659263.0,143,1382,9.664335664335665,2,13,7,136
25661942.0,108,321,2.9722222222222223,1,5,108,0
25664232.0,67,630,9.402985074626866,2,12,7,60
25668633.0,623,1844,2.9598715890850724,1,7,623,0
25708850.0,263,361,1.3726235741444868,1,4,263,0
25709882.0,6,7,1.1666666666666667,1,2,6,0
25712099.0,57,565,9.912280701754385,7,12,1,56
25718701.0,76,163,2.1447368421052633,1,4,76,0
25719358.0,316,3081,9.75,2,13,20,296
25719793.0,60,479,7.983333333333333,4,10,18,42
25728564.0,178,902,5.067415730337078,2,7,178,0
25737454.0,311,1530,4.919614147909968,2,8,308,3
25760183.0,62,606,9.774193548387096,2,13,3,59
25761607.0,28,225,8.035714285714286,6,10,8,20
25762368.0,237,1163,4.9071729957805905,2,8,235,2
25764881.0,97,751,7.742268041237113,2,10,39,58
25773718.0,305,2099,6.881967213114754,2,10,217,88
25775949.0,20,41,2.05,1,3,20,0
25777905.0,317,1576,4.971608832807571,2,8,314,3
25778223.0,10,22,2.2,1,4,10,0
25778878.0,91,692,7.604395604395604,3,10,37,54
25779036.0,320,1236,3.8625,2,7,320,0
25792060.0,52,163,3.1346153846153846,1,5,52,0
25793418.0,287,2732,9.519163763066203,2,12,20,267
25794739.0,144,297,2.0625,1,4,144,0
25795660.0,36,366,10.166666666666666,8,13,0,36
25796759.0,106,523,4.933962264150943,2,7,106,0
25797831.0,216,1458,6.75,2,10,162,54
25809329.0,135,284,2.1037037037037036,1,5,135,0
25817039.0,433,2968,6.854503464203233,2,10,308,125
25821014.0,14,21,1.5,1,3,14,0
25822926.0,100,972,9.72,2,13,6,94
25823763.0,17,36,2.1176470588235294,1,4,17,0
25824287.0,87,274,3.1494252873563218,1,5,87,0
25825736.0,4,6,1.5,1,2,4,0
25838541.0,9,14,1.5555555555555556,1,4,9,0
25839050.0,10,20,2.0,1,4,10,0
25842258.0,28,104,3.7142857142857144,2,5,28,0
25844146.0,36,78,2.1666666666666665,1,5,36,0
25850003.0,304,1506,4.953947368421052,2,9,302,2
25851859.0,323,646,2.0,1,4,323,0
25853542.0,178,367,2.061797752808989,1,5,178,0
25853678.0,24,48,2.0,1,4,24,0
25855032.0,2,3,1.5,1,2,2,0
25856766.0,150,464,3.0933333333333333,1,6,150,0
25862956.0,374,3526,9.427807486631016,2,12,32,342
25863077.0,111,1094,9.855855855855856,2,12,9,102
25872708.0,2,5,2.5,1,4,2,0
25877563.0,281,2433,8.658362989323843,2,13,42,239
25887117.0,247,513,2.076923076923077,1,5,247,0
25898716.0,97,957,9.8659793814433,2,13,5,92
25900726.0,18,51,2.8333333333333335,1,5,18,0
25901054.0,2,18,9.0,9,9,0,2
25904829.0,131,912,6.961832061068702,3,10,93,38
25910781.0,19,33,1.736842105263158,1,4,19,0
25910859.0,106,827,7.80188679245283,2,12,36,70
25917631.0,3,4,1.3333333333333333,1,2,3,0
25926090.0,38,294,7.7368421052631575,3,10,14,24
25934289.0,11,25,2.272727272727273,1,4,11,0
25939631.0,403,3492,8.665012406947891,2,13,55,348
25944336.0,26,214,8.23076923076923,6,11,5,21
25945144.0,9,29,3.2222222222222223,1,5,9,0
25954047.0,69,678,9.826086956521738,5,12,3,66
25955551.0,17,148,8.705882352941176,4,11,3,14
25960826.0,153,1472,9.620915032679738,2,13,13,140
25975140.0,139,1341,9.647482014388489,2,13,10,129
25976126.0,1,1,1.0,1,1,1,0
25985325.0,8,14,1.75,1,4,8,0
25991131.0,176,1665,9.460227272727273,2,12,14,162
25999022.0,8,26,3.25,1,5,8,0
26002097.0,312,2123,6.80448717948718,2,9,221,91
26003466.0,7,14,2.0,1,3,7,0
26015760.0,206,1768,8.58252427184466,2,12,32,174
26021624.0,152,1067,7.019736842105263,2,9,104,48
26022154.0,160,772,4.825,2,8,158,2
26022897.0,106,519,4.89622641509434,3,8,105,1
26027837.0,105,213,2.0285714285714285,1,4,105,0
26028344.0,73,212,2.904109589041096,1,5,73,0
26028942.0,94,178,1.8936170212765957,1,4,94,0
26034755.0,14,45,3.2142857142857144,2,5,14,0
26044619.0,363,1746,4.809917355371901,2,8,361,2
26046732.0,70,273,3.9,1,7,70,0
26048596.0,143,1353,9.461538461538462,2,13,12,131
26049697.0,67,142,2.1194029850746268,1,4,67,0
26049771.0,103,144,1.3980582524271845,1,4,103,0
26049905.0,22,68,3.090909090909091,1,5,22,0
26050008.0,3,8,2.6666666666666665,2,3,3,0
26061617.0,128,1152,9.0,3,12,16,112
26066860.0,10,31,3.1,2,5,10,0
26071518.0,312,1843,5.907051282051282,2,9,287,25
26080277.0,129,377,2.9224806201550386,1,6,129,0
26084187.0,354,1735,4.901129943502825,2,8,350,4
26088584.0,70,343,4.9,2,8,68,2
26090135.0,3,5,1.6666666666666667,1,3,3,0
26092838.0,428,4156,9.710280373831775,2,13,21,407
26096804.0,1,2,2.0,2,2,1,0
26101647.0,4,11,2.75,2,3,4,0
26102471.0,3,6,2.0,1,3,3,0
26104737.0,43,343,7.976744186046512,5,10,12,31
26106526.0,14,71,5.071428571428571,4,6,14,0
26106993.0,25,55,2.2,1,4,25,0
26116470.0,2,7,3.5,2,5,2,0
26116560.0,106,834,7.867924528301887,4,11,43,63
26122304.0,45,133,2.9555555555555557,1,5,45,0
26125014.0,11,39,3.5454545454545454,2,5,11,0
26126278.0,31,88,2.838709677419355,1,5,31,0
26127618.0,53,398,7.509433962264151,2,10,20,33
26129374.0,227,306,1.3480176211453745,1,3,227,0
26131373.0,329,2564,7.793313069908814,2,10,110,219
26140668.0,55,432,7.8545454545454545,6,10,21,34
26146857.0,51,487,9.549019607843137,3,13,2,49
26148638.0,390,3048,7.815384615384615,3,11,143,247
26159276.0,2,5,2.5,2,3,2,0
26162509.0,58,278,4.793103448275862,2,7,58,0
26182221.0,127,844,6.645669291338582,2,10,91,36
26182408.0,1,1,1.0,1,1,1,0
26184634.0,158,1368,8.658227848101266,2,11,21,137
26190842.0,1,5,5.0,5,5,1,0
26194861.0,294,1413,4.8061224489795915,2,7,294,0
26198720.0,35,68,1.9428571428571428,1,4,35,0
26199834.0,43,88,2.046511627906977,1,4,43,0
26213529.0,14,33,2.357142857142857,1,4,14,0
26214131.0,166,1630,9.819277108433734,3,13,5,161
26214176.0,12,81,6.75,2,9,7,5
26216482.0,22,65,2.9545454545454546,1,4,22,0
26223518.0,2,9,4.5,4,5,2,0
26228884.0,8,23,2.875,2,4,8,0
26230020.0,278,828,2.9784172661870505,1,6,278,0
26237283.0,43,338,7.8604651162790695,5,10,18,25
26237466.0,93,869,9.344086021505376,2,12,7,86
26237805.0,123,1192,9.691056910569106,2,13,8,115
26251900.0,109,1051,9.642201834862385,3,13,8,101
26255270.0,34,69,2.0294117647058822,1,4,34,0
26255768.0,310,2748,8.864516129032259,2,12,26,284
26263831.0,25,172,6.88,3,9,16,9
26266563.0,127,881,6.937007874015748,3,10,83,44
26269189.0,130,893,6.869230769230769,2,10,97,33
26272353.0,98,918,9.36734693877551,2,12,9,89
26273307.0,420,2110,5.023809523809524,2,8,418,2
26277250.0,8,44,5.5,3,7,8,0
26279555.0,73,366,5.013698630136986,2,8,72,1
26279672.0,61,300,4.918032786885246,3,7,61,0
26288965.0,10,71,7.1,5,9,8,2
26290563.0,43,413,9.604651162790697,2,12,3,40
26295635.0,156,471,3.019230769230769,1,6,156,0
26296813.0,20,59,2.95,2,4,20,0
26299264.0,48,101,2.1041666666666665,1,4,48,0
26299378.0,227,1122,4.942731277533039,1,7,227,0
26302022.0,3,3,1.0,1,1,3,0
26303222.0,1,3,3.0,3,3,1,0
26312758.0,74,156,2.108108108108108,1,5,74,0
26314832.0,262,1282,4.893129770992366,3,8,259,3
26319698.0,1,1,1.0,1,1,1,0
26321473.0,191,1266,6.628272251308901,2,10,146,45
26322985.0,151,457,3.0264900662251657,1,6,151,0
26323977.0,16,33,2.0625,1,4,16,0
26325192.0,65,632,9.723076923076922,3,12,4,61
26328566.0,71,609,8.577464788732394,2,10,8,63
26329598.0,199,768,3.85929648241206,2,6,199,0
26342138.0,240,1189,4.954166666666667,2,8,238,2
26342152.0,247,1231,4.983805668016195,2,8,244,3
26342160.0,212,1038,4.89622641509434,2,8,211,1
26342173.0,123,613,4.983739837398374,2,7,123,0
26342175.0,49,242,4.938775510204081,2,9,48,1
26342192.0,148,741,5.006756756756757,2,8,144,4
26345032.0,130,390,3.0,1,6,130,0
26348050.0,34,70,2.0588235294117645,1,4,34,0
26349906.0,9,33,3.6666666666666665,1,5,9,0
26353430.0,172,865,5.02906976744186,2,8,169,3
26355698.0,13,27,2.076923076923077,1,4,13,0
26359657.0,2,7,3.5,3,4,2,0
26374262.0,181,375,2.0718232044198897,1,5,181,0
26376301.0,372,3244,8.720430107526882,2,12,49,323
26379046.0,76,104,1.368421052631579,1,4,76,0
26379148.0,166,341,2.0542168674698793,1,5,166,0
26379208.0,206,618,3.0,1,6,206,0
26379320.0,8,33,4.125,2,6,8,0
26379431.0,163,1110,6.809815950920245,2,10,121,42
26379511.0,77,323,4.194805194805195,2,6,77,0
26380024.0,3,9,3.0,2,4,3,0
26383016.0,5,10,2.0,1,3,5,0
26383438.0,10,48,4.8,3,6,10,0
26386760.0,31,62,2.0,1,5,31,0
26390070.0,11,81,7.363636363636363,5,9,6,5
26392491.0,4,6,1.5,1,2,4,0
26395356.0,41,82,2.0,1,4,41,0
26405010.0,261,772,2.9578544061302683,1,5,261,0
26405707.0,166,1148,6.9156626506024095,2,9,114,52
26406207.0,205,1614,7.873170731707317,2,11,66,139
26408412.0,117,244,2.0854700854700856,1,4,117,0
26410862.0,45,338,7.511111111111111,2,10,19,26
26412053.0,12,33,2.75,1,5,12,0
26412657.0,175,505,2.8857142857142857,1,6,175,0
26416243.0,48,424,8.833333333333334,2,11,4,44
26416522.0,61,127,2.081967213114754,1,4,61,0
26423501.0,63,212,3.365079365079365,2,5,63,0
26426029.0,5,6,1.2,1,2,5,0
26435373.0,69,281,4.072463768115942,2,6,69,0
26437376.0,281,1135,4.039145907473309,1,7,281,0
26441358.0,9,18,2.0,1,3,9,0
26442547.0,261,1266,4.850574712643678,2,8,260,1
26445267.0,376,1511,4.0186170212765955,1,7,376,0
26448054.0,306,1516,4.954248366013072,2,8,305,1
26449233.0,519,1098,2.115606936416185,1,5,519,0
26453896.0,3,8,2.6666666666666665,1,4,3,0
26462507.0,37,113,3.054054054054054,1,5,37,0
26466169.0,348,3034,8.718390804597702,2,12,38,310
26467284.0,1,2,2.0,2,2,1,0
26468026.0,289,2758,9.543252595155709,2,13,22,267
26468102.0,2,4,2.0,2,2,2,0
26469909.0,1,2,2.0,2,2,1,0
26480104.0,14,76,5.428571428571429,4,7,14,0
26480116.0,141,719,5.099290780141844,2,8,140,1
26483404.0,2,3,1.5,1,2,2,0
26484345.0,214,445,2.0794392523364484,1,5,214,0
26489005.0,122,467,3.8278688524590163,1,6,122,0
26490596.0,12,37,3.0833333333333335,1,4,12,0
26494877.0,81,625,7.716049382716049,3,10,35,46
26495089.0,3,4,1.3333333333333333,1,2,3,0
26496151.0,119,248,2.0840336134453783,1,4,119,0
26497308.0,390,2662,6.825641025641025,2,10,274,116
26500221.0,6,12,2.0,1,3,6,0
26508771.0,302,2928,9.695364238410596,2,13,20,282
26509350.0,2,3,1.5,1,2,2,0
26510318.0,247,1244,5.036437246963563,2,7,247,0
26517999.0,18,29,1.6111111111111112,1,3,18,0
26518718.0,32,290,9.0625,7,10,1,31
26518792.0,1,2,2.0,2,2,1,0
26530619.0,48,324,6.75,2,9,34,14
26533079.0,19,31,1.631578947368421,1,3,19,0
26543291.0,333,3218,9.663663663663664,2,12,22,311
26545580.0,8,51,6.375,5,8,7,1
26547432.0,58,283,4.879310344827586,3,7,58,0
26550190.0,130,1129,8.684615384615384,2,11,16,114
26550694.0,88,620,7.045454545454546,2,9,55,33
26554396.0,419,2066,4.930787589498807,2,8,418,1
26556405.0,37,261,7.054054054054054,5,10,29,8
26558166.0,137,535,3.9051094890510947,1,6,137,0
26559402.0,66,315,4.7727272727272725,2,7,66,0
26561092.0,373,3638,9.753351206434317,2,13,13,360
26562155.0,2,4,2.0,1,3,2,0
26563934.0,2,4,2.0,2,2,2,0
26569461.0,2,3,1.5,1,2,2,0
26579896.0,8,11,1.375,1,2,8,0
26582669.0,3,5,1.6666666666666667,1,3,3,0
26590995.0,15,90,6.0,5,8,14,1
26596042.0,364,1743,4.788461538461538,2,8,363,1
26597228.0,150,753,5.02,2,8,149,1
26597581.0,167,1466,8.778443113772456,2,12,18,149
26597871.0,238,2310,9.705882352941176,2,13,11,227
26599807.0,184,374,2.032608695652174,1,4,184,0
26601742.0,135,668,4.948148148148148,2,9,132,3
26611894.0,106,229,2.160377358490566,1,4,106,0
26612609.0,1,2,2.0,2,2,1,0
26613115.0,86,433,5.034883720930233,2,8,85,1
26616262.0,249,1711,6.871485943775101,2,10,173,76
26619703.0,271,1099,4.055350553505535,1,7,271,0
26620126.0,27,127,4.703703703703703,2,6,27,0
26620318.0,247,2351,9.518218623481781,2,13,17,230
26624931.0,5,12,2.4,1,4,5,0
26628611.0,5,37,7.4,6,9,3,2
26630352.0,5,9,1.8,1,4,5,0
26631338.0,77,387,5.025974025974026,3,8,76,1
26638091.0,117,840,7.17948717948718,4,10,69,48
26638818.0,1,4,4.0,4,4,1,0
26639503.0,1,1,1.0,1,1,1,0
26639785.0,2,2,1.0,1,1,2,0
26640076.0,1,1,1.0,1,1,1,0
26648543.0,133,1013,7.616541353383458,2,10,50,83
26649955.0,100,201,2.01,1,5,100,0
26650453.0,5,11,2.2,1,3,5,0
26651207.0,1,4,4.0,4,4,1,0
26651752.0,7,17,2.4285714285714284,1,4,7,0
26652662.0,3,9,3.0,2,4,3,0
26653068.0,130,287,2.207692307692308,1,5,130,0
26655441.0,21,28,1.3333333333333333,1,3,21,0
26657334.0,97,919,9.474226804123711,3,12,7,90
26665255.0,51,213,4.176470588235294,2,6,51,0
26666232.0,134,661,4.932835820895522,2,8,132,2
26672046.0,15,21,1.4,1,3,15,0
26672190.0,17,24,1.411764705882353,1,3,17,0
26677637.0,61,129,2.1147540983606556,1,5,61,0
26680030.0,2,5,2.5,2,3,2,0
26683288.0,37,175,4.72972972972973,2,8,36,1
26688961.0,40,49,1.225,1,2,40,0
26690255.0,30,93,3.1,1,6,30,0
26690367.0,14,39,2.7857142857142856,2,5,14,0
26707858.0,74,232,3.135135135135135,1,5,74,0
26710185.0,490,2392,4.881632653061224,2,8,488,2
26711300.0,1,2,2.0,2,2,1,0
26713449.0,88,610,6.931818181818182,3,9,56,32
26715025.0,90,191,2.1222222222222222,1,4,90,0
26716805.0,61,496,8.131147540983607,6,11,17,44
26725460.0,18,62,3.4444444444444446,2,5,18,0
26727937.0,91,278,3.0549450549450547,1,5,91,0
26728651.0,186,718,3.860215053763441,2,6,186,0
26732463.0,191,956,5.005235602094241,2,8,190,1
26737776.0,2,7,3.5,3,4,2,0
26749155.0,337,1685,5.0,2,8,333,4
26750759.0,1,2,2.0,2,2,1,0
26751136.0,1,2,2.0,2,2,1,0
26751318.0,54,164,3.037037037037037,1,6,54,0
26751702.0,1,3,3.0,3,3,1,0
26766429.0,212,849,4.004716981132075,1,7,212,0
26771360.0,542,1641,3.0276752767527677,1,6,542,0
26772964.0,223,885,3.968609865470852,1,7,223,0
26781588.0,76,591,7.776315789473684,2,10,26,50
26792546.0,46,139,3.0217391304347827,1,6,46,0
26794541.0,35,275,7.857142857142857,3,10,8,27
26796284.0,8,50,6.25,5,8,7,1
26801977.0,2,5,2.5,2,3,2,0
26806152.0,5,22,4.4,4,5,5,0
26806670.0,208,1379,6.6298076923076925,2,9,152,56
26808591.0,85,669,7.870588235294117,2,10,30,55
26809818.0,62,319,5.145161290322581,3,7,62,0
26810169.0,29,58,2.0,1,4,29,0
26810355.0,116,588,5.068965517241379,2,7,116,0
26814776.0,56,287,5.125,2,8,55,1
26820244.0,113,222,1.9646017699115044,1,4,113,0
26826102.0,72,543,7.541666666666667,2,11,29,43
26830349.0,145,300,2.0689655172413794,1,4,145,0
26837596.0,172,852,4.953488372093023,2,8,169,3
26844795.0,40,77,1.925,1,4,40,0
26851372.0,81,619,7.6419753086419755,3,11,31,50
26853827.0,306,908,2.9673202614379086,1,6,306,0
26854788.0,73,728,9.972602739726028,2,12,3,70
26857807.0,151,319,2.1125827814569536,1,5,151,0
26858682.0,611,5904,9.662847790507366,2,13,39,572
26860511.0,42,59,1.4047619047619047,1,3,42,0
26870993.0,12,85,7.083333333333333,6,9,9,3
26871728.0,6,11,1.8333333333333333,1,3,6,0
26880934.0,6,10,1.6666666666666667,1,3,6,0
26887627.0,9,18,2.0,1,3,9,0
26892159.0,435,2979,6.848275862068966,2,10,305,130
26904127.0,3,3,1.0,1,1,3,0
26905437.0,1,2,2.0,2,2,1,0
26905928.0,46,92,2.0,1,5,46,0
26908729.0,125,245,1.96,1,4,125,0
26910732.0,38,151,3.973684210526316,2,5,38,0
26915223.0,5,11,2.2,1,3,5,0
26932469.0,98,972,9.918367346938776,3,13,4,94
26933843.0,42,86,2.0476190476190474,1,4,42,0
26934005.0,2,7,3.5,3,4,2,0
26936440.0,9,65,7.222222222222222,5,9,6,3
26939341.0,288,1987,6.899305555555555,3,10,210,78
26943308.0,137,812,5.927007299270073,2,9,125,12
26944611.0,233,491,2.107296137339056,1,5,233,0
26947331.0,142,733,5.161971830985915,2,8,139,3
26950720.0,26,263,10.115384615384615,8,12,0,26
26951298.0,181,880,4.861878453038674,2,7,181,0
26955116.0,74,150,2.027027027027027,1,4,74,0
26957081.0,46,379,8.23913043478261,2,11,8,38
26965193.0,1,1,1.0,1,1,1,0
26968458.0,44,420,9.545454545454545,2,13,4,40
26969354.0,100,387,3.87,1,6,100,0
26972956.0,219,453,2.0684931506849313,1,4,219,0
26973493.0,49,139,2.836734693877551,1,4,49,0
26976562.0,107,1029,9.616822429906541,2,12,9,98
26981430.0,10,16,1.6,1,3,10,0
26986993.0,3,5,1.6666666666666667,1,2,3,0
26990662.0,329,1317,4.003039513677812,1,6,329,0
26991190.0,115,255,2.217391304347826,1,5,115,0
26991750.0,2,4,2.0,2,2,2,0
26992478.0,59,586,9.932203389830509,8,12,0,59
26994600.0,24,170,7.083333333333333,2,10,13,11
27005230.0,1,2,2.0,2,2,1,0
27008049.0,5,19,3.8,3,4,5,0
27013055.0,1,3,3.0,3,3,1,0
27017555.0,102,879,8.617647058823529,4,11,14,88
27020433.0,53,163,3.0754716981132075,1,6,53,0
27020857.0,268,2129,7.9440298507462686,2,12,88,180
27021442.0,210,1828,8.704761904761904,2,12,24,186
27022584.0,3,4,1.3333333333333333,1,2,3,0
27022831.0,398,1968,4.944723618090452,2,8,396,2
27023118.0,545,1151,2.1119266055045873,1,5,545,0
27025972.0,429,2917,6.799533799533799,2,10,310,119
27027546.0,204,1932,9.470588235294118,2,13,20,184
27038308.0,179,724,4.044692737430168,1,7,179,0
27042508.0,10,18,1.8,1,3,10,0
27042559.0,30,57,1.9,1,4,30,0
27042943.0,9,17,1.8888888888888888,1,3,9,0
27043012.0,129,640,4.961240310077519,2,7,129,0
27043136.0,4,5,1.25,1,2,4,0
27043611.0,60,125,2.0833333333333335,1,4,60,0
27047777.0,97,292,3.0103092783505154,1,7,97,0
27051315.0,36,102,2.8333333333333335,1,5,36,0
27052530.0,2,6,3.0,3,3,2,0
27052854.0,83,250,3.0120481927710845,1,6,83,0
27053569.0,122,598,4.901639344262295,1,8,121,1
27054553.0,131,910,6.9465648854961835,4,10,100,31
27058839.0,1,7,7.0,7,7,1,0
27059387.0,159,795,5.0,2,8,158,1
27066292.0,63,320,5.079365079365079,2,8,62,1
27066758.0,89,182,2.044943820224719,1,4,89,0
27066857.0,32,159,4.96875,3,7,32,0
27067158.0,60,118,1.9666666666666666,1,4,60,0
27067242.0,97,104,1.0721649484536082,1,2,97,0
27067372.0,100,112,1.12,1,3,100,0
27067534.0,25,29,1.16,1,3,25,0
27067662.0,39,39,1.0,1,1,39,0
27070285.0,70,471,6.728571428571429,2,9,54,16
27077805.0,69,197,2.8550724637681157,1,5,69,0
27077816.0,44,337,7.659090909090909,6,10,20,24
27082740.0,85,585,6.882352941176471,2,9,55,30
27085242.0,66,423,6.409090909090909,2,9,51,15
27086601.0,215,432,2.0093023255813955,1,5,215,0
27109745.0,39,298,7.641025641025641,4,10,15,24
27111785.0,3,12,4.0,3,5,3,0
27116728.0,17,162,9.529411764705882,5,11,1,16
27120565.0,63,190,3.015873015873016,1,5,63,0
27130156.0,26,266,10.23076923076923,7,12,1,25
27132392.0,280,2702,9.65,2,14,19,261
27133481.0,323,670,2.0743034055727554,1,5,323,0
27133915.0,310,2152,6.941935483870968,2,10,216,94
27136111.0,17,114,6.705882352941177,4,9,14,3
27137089.0,144,555,3.8541666666666665,2,7,144,0
27141824.0,124,832,6.709677419354839,2,9,96,28
27148755.0,2,3,1.5,1,2,2,0
27150439.0,80,787,9.8375,4,12,5,75
27151850.0,172,679,3.947674418604651,1,6,172,0
27152672.0,312,1528,4.897435897435898,2,8,311,1
27153191.0,347,1706,4.916426512968299,2,7,347,0
27153691.0,74,155,2.0945945945945947,1,4,74,0
27153699.0,10,11,1.1,1,2,10,0
27153703.0,3,6,2.0,1,3,3,0
27157531.0,151,597,3.9536423841059603,1,7,151,0
27159225.0,197,1356,6.883248730964467,2,10,140,57
27159248.0,234,1590,6.794871794871795,2,10,163,71
27177926.0,126,871,6.912698412698413,5,9,91,35
27180274.0,343,718,2.0932944606413995,1,5,343,0
27182024.0,130,893,6.869230769230769,2,10,93,37
27187208.0,3,15,5.0,4,6,3,0
27191779.0,88,600,6.818181818181818,2,10,59,29
27194034.0,8,17,2.125,1,4,8,0
27210634.0,18,56,3.111111111111111,1,5,18,0
27213990.0,245,2132,8.70204081632653,2,12,31,214
27214449.0,92,201,2.1847826086956523,1,4,92,0
27218910.0,122,364,2.9836065573770494,1,6,122,0
27219826.0,17,39,2.2941176470588234,1,4,17,0
27222530.0,74,225,3.0405405405405403,1,6,74,0
27230520.0,2,3,1.5,1,2,2,0
27240417.0,5,6,1.2,1,2,5,0
27240518.0,1,2,2.0,2,2,1,0
27240605.0,5,5,1.0,1,1,5,0
27240646.0,1,1,1.0,1,1,1,0
27241406.0,9,29,3.2222222222222223,2,5,9,0
27242442.0,1,3,3.0,3,3,1,0
27242607.0,92,699,7.5978260869565215,3,10,40,52
27243122.0,2,8,4.0,4,4,2,0
27246464.0,204,818,4.009803921568627,1,7,204,0
27246528.0,3,11,3.6666666666666665,2,6,3,0
27248509.0,35,104,2.9714285714285715,1,6,35,0
27253931.0,88,279,3.1704545454545454,1,6,88,0
27255443.0,414,4050,9.782608695652174,2,13,26,388
27258463.0,114,877,7.692982456140351,2,12,42,72
27258733.0,238,938,3.9411764705882355,1,7,238,0
27267953.0,9,22,2.4444444444444446,2,4,9,0
27273988.0,174,1712,9.839080459770114,2,12,7,167
27275877.0,379,2598,6.854881266490765,2,10,264,115
27281907.0,206,1005,4.878640776699029,2,7,206,0
27282238.0,73,360,4.931506849315069,2,8,72,1
27282515.0,291,1975,6.786941580756014,2,10,223,68
27284094.0,363,718,1.977961432506887,1,4,363,0
27286176.0,27,252,9.333333333333334,2,12,3,24
27289799.0,3,4,1.3333333333333333,1,2,3,0
27293198.0,46,59,1.2826086956521738,1,3,46,0
27294421.0,30,42,1.4,1,3,30,0
27297704.0,264,1316,4.984848484848484,2,8,261,3
27299012.0,439,3033,6.908883826879271,2,10,305,134
27300103.0,423,2858,6.756501182033097,2,10,302,121
27302443.0,5,10,2.0,1,3,5,0
27303515.0,26,61,2.3461538461538463,1,4,26,0
27307475.0,151,1432,9.483443708609272,2,12,12,139
27318970.0,307,2117,6.8957654723127035,2,10,208,99
27320542.0,2,7,3.5,3,4,2,0
27320892.0,4,19,4.75,4,5,4,0
27321061.0,104,514,4.9423076923076925,2,8,103,1
27322921.0,48,422,8.791666666666666,3,10,3,45
27328770.0,10,63,6.3,3,8,8,2
27331321.0,70,610,8.714285714285714,3,11,7,63
27333708.0,148,1431,9.66891891891892,2,14,6,142
27350300.0,169,507,3.0,1,5,169,0
27353439.0,24,161,6.708333333333333,4,9,18,6
27355331.0,2,4,2.0,1,3,2,0
27358064.0,121,243,2.0082644628099175,1,4,121,0
27360200.0,59,522,8.847457627118644,3,12,5,54
27360275.0,76,723,9.513157894736842,2,12,6,70
27360515.0,113,1122,9.929203539823009,2,13,4,109
27361304.0,277,2704,9.76173285198556,2,13,15,262
27363120.0,7,15,2.142857142857143,1,3,7,0
27364971.0,94,475,5.053191489361702,2,7,94,0
27365144.0,50,438,8.76,5,11,3,47
27369694.0,145,437,3.013793103448276,1,5,145,0
27382564.0,284,854,3.007042253521127,1,6,284,0
27385916.0,58,231,3.9827586206896552,2,6,58,0
27386719.0,146,432,2.958904109589041,1,5,146,0
27387500.0,1,2,2.0,2,2,1,0
27389393.0,218,2084,9.559633027522937,2,13,12,206
27389454.0,24,129,5.375,3,7,24,0
27389815.0,54,255,4.722222222222222,2,7,54,0
27391084.0,41,77,1.8780487804878048,1,4,41,0
27391283.0,42,319,7.595238095238095,5,9,19,23
27392140.0,87,200,2.2988505747126435,1,5,87,0
27412764.0,9,86,9.555555555555555,8,12,0,9
27417335.0,6,27,4.5,3,6,6,0
27418573.0,89,358,4.022471910112359,1,8,88,1
27420708.0,109,707,6.486238532110092,2,11,91,18
27426276.0,77,309,4.012987012987013,2,7,77,0
27426816.0,363,3472,9.56473829201102,2,12,23,340
27426821.0,60,578,9.633333333333333,2,12,4,56
27427057.0,59,237,4.016949152542373,2,7,59,0
27448165.0,2,2,1.0,1,1,2,0
27448310.0,7,13,1.8571428571428572,1,3,7,0
27448401.0,11,24,2.1818181818181817,1,4,11,0
27449083.0,52,113,2.173076923076923,1,4,52,0
27453695.0,198,435,2.196969696969697,1,5,198,0
27473911.0,117,584,4.9914529914529915,3,8,116,1
27474776.0,546,3743,6.855311355311355,2,9,386,160
27476688.0,318,1527,4.80188679245283,2,8,316,2
27479786.0,12,83,6.916666666666667,4,10,8,4
27482229.0,114,556,4.87719298245614,2,7,114,0
27482987.0,19,177,9.31578947368421,2,11,1,18
27485127.0,68,474,6.970588235294118,3,10,46,22
27492876.0,14,28,2.0,1,4,14,0
27499063.0,119,335,2.8151260504201683,1,5,119,0
27513528.0,3,7,2.3333333333333335,1,3,3,0
27515095.0,370,1855,5.013513513513513,1,8,367,3
27521513.0,46,133,2.891304347826087,1,5,46,0
27524149.0,335,690,2.0597014925373136,1,5,335,0
27524939.0,1,4,4.0,4,4,1,0
27535442.0,54,256,4.7407407407407405,3,7,54,0
27538146.0,15,62,4.133333333333334,2,6,15,0
27538775.0,13,29,2.230769230769231,1,4,13,0
27544636.0,197,1345,6.8274111675126905,2,10,144,53
27548089.0,311,2147,6.903536977491961,2,10,215,96
27563227.0,320,3055,9.546875,2,13,26,294
27564347.0,59,128,2.169491525423729,1,5,59,0
27564903.0,185,889,4.805405405405406,2,8,184,1
27565531.0,1,4,4.0,4,4,1,0
27565769.0,29,92,3.1724137931034484,1,5,29,0
27571562.0,14,26,1.8571428571428572,1,3,14,0
27572545.0,34,78,2.2941176470588234,1,5,34,0
27572813.0,53,209,3.943396226415094,2,7,53,0
27572842.0,64,322,5.03125,3,7,64,0
27579072.0,33,309,9.363636363636363,2,12,4,29
27585383.0,21,93,4.428571428571429,3,7,21,0
27586940.0,70,343,4.9,2,8,69,1
27589208.0,221,447,2.02262443438914,1,4,221,0
27590065.0,27,258,9.555555555555555,6,11,1,26
27594853.0,226,1556,6.884955752212389,2,9,156,70
27596030.0,116,782,6.741379310344827,2,9,84,32
27621240.0,501,3954,7.892215568862276,2,11,162,339
27623473.0,130,636,4.892307692307693,2,7,130,0
27647396.0,2,5,2.5,1,4,2,0
27651761.0,159,632,3.9748427672955975,1,6,159,0
27665040.0,131,908,6.931297709923665,3,10,89,42
27668673.0,1,1,1.0,1,1,1,0
27670844.0,1,3,3.0,3,3,1,0
27672240.0,120,256,2.1333333333333333,1,5,120,0
27676327.0,136,1322,9.720588235294118,2,13,8,128
27677003.0,506,4955,9.792490118577074,2,13,25,481
27678606.0,102,685,6.715686274509804,2,10,73,29
27686070.0,21,104,4.9523809523809526,3,6,21,0
27687813.0,205,1966,9.590243902439024,2,14,16,189
27689510.0,375,2911,7.762666666666667,2,10,126,249
27709869.0,75,715,9.533333333333333,3,12,9,66
27714694.0,251,1240,4.940239043824701,2,8,250,1
27724486.0,75,355,4.733333333333333,3,8,73,2
27725092.0,101,517,5.118811881188119,3,7,101,0
27736231.0,205,609,2.970731707317073,1,5,205,0
27754172.0,81,169,2.0864197530864197,1,5,81,0
27754697.0,223,463,2.0762331838565022,1,5,223,0
27773270.0,3,25,8.333333333333334,8,9,0,3
27774209.0,521,1581,3.034548944337812,1,6,521,0
27774424.0,305,2359,7.7344262295081965,2,11,120,185
27775153.0,396,1927,4.866161616161616,2,7,396,0
27776018.0,20,43,2.15,1,4,20,0
27778267.0,51,109,2.1372549019607843,1,4,51,0
27780116.0,191,1287,6.738219895287958,2,10,135,56
27783525.0,7,68,9.714285714285714,8,11,0,7
27787279.0,52,159,3.0576923076923075,1,5,52,0
27791052.0,57,360,6.315789473684211,2,8,51,6
27802050.0,38,174,4.578947368421052,2,7,38,0
27819111.0,21,38,1.8095238095238095,1,3,21,0
27819112.0,73,161,2.2054794520547945,1,5,73,0
27820414.0,1,1,1.0,1,1,1,0
27820676.0,63,101,1.6031746031746033,1,4,63,0
27821435.0,42,63,1.5,1,3,42,0
27822341.0,229,642,2.8034934497816595,1,6,229,0
27851118.0,150,872,5.8133333333333335,2,8,142,8
27851783.0,73,563,7.712328767123288,2,10,24,49
27853870.0,1,3,3.0,3,3,1,0
27855292.0,80,788,9.85,2,12,4,76
27873155.0,160,340,2.125,1,5,160,0
27876207.0,19,126,6.631578947368421,5,8,17,2
27882493.0,41,350,8.536585365853659,3,11,6,35
27888194.0,119,247,2.0756302521008405,1,5,119,0
27889441.0,86,443,5.151162790697675,3,8,85,1
27889484.0,2,2,1.0,1,1,2,0
27889509.0,1,1,1.0,1,1,1,0
27889614.0,428,4114,9.61214953271028,2,13,26,402
27894364.0,3,7,2.3333333333333335,2,3,3,0
27896987.0,1,4,4.0,4,4,1,0
27899892.0,11,12,1.0909090909090908,1,2,11,0
27911462.0,61,411,6.737704918032787,3,9,46,15
27926494.0,27,33,1.2222222222222223,1,3,27,0
27927293.0,358,3454,9.64804469273743,2,13,21,337
27928425.0,2,6,3.0,1,5,2,0
27929258.0,14,23,1.6428571428571428,1,3,14,0
27944589.0,49,181,3.693877551020408,2,6,49,0
27947672.0,106,316,2.981132075471698,1,5,106,0
27954718.0,6,44,7.333333333333333,6,8,3,3
27978607.0,57,77,1.3508771929824561,1,3,57,0
27978869.0,271,1843,6.800738007380073,2,10,194,77
27979885.0,324,2247,6.935185185185185,3,10,230,94
27980291.0,186,393,2.1129032258064515,1,5,186,0
27981144.0,92,639,6.945652173913044,2,9,60,32
27985952.0,70,94,1.3428571428571427,1,4,70,0
27997330.0,2,7,3.5,3,4,2,0
27998829.0,38,48,1.263157894736842,1,3,38,0
27999941.0,21,53,2.5238095238095237,1,4,21,0
28003301.0,193,960,4.974093264248705,2,7,193,0
28021785.0,5,32,6.4,5,8,4,1
28025202.0,13,126,9.692307692307692,8,12,0,13
28027042.0,62,445,7.17741935483871,4,11,38,24
28027599.0,316,3089,9.775316455696203,2,13,19,297
28030168.0,150,595,3.966666666666667,2,6,150,0
28033931.0,122,1055,8.647540983606557,2,11,17,105
28042269.0,63,375,5.9523809523809526,3,8,59,4
28042547.0,36,48,1.3333333333333333,1,3,36,0
28043670.0,163,958,5.877300613496932,2,8,155,8
28045848.0,3,3,1.0,1,1,3,0
28047743.0,49,103,2.1020408163265305,1,4,49,0
28049357.0,360,3125,8.680555555555555,2,12,43,317
28050289.0,1,3,3.0,3,3,1,0
28055541.0,46,396,8.608695652173912,5,11,7,39
28062308.0,192,556,2.8958333333333335,1,6,192,0
28097054.0,164,637,3.8841463414634148,1,7,164,0
28097933.0,24,47,1.9583333333333333,1,5,24,0
28106967.0,259,1249,4.822393822393822,2,8,258,1
28114384.0,411,2044,4.97323600973236,1,8,408,3
28120654.0,106,113,1.0660377358490567,1,3,106,0
28120790.0,225,472,2.097777777777778,1,5,225,0
28120823.0,6,7,1.1666666666666667,1,2,6,0
28121571.0,43,46,1.069767441860465,1,2,43,0
28129951.0,2,3,1.5,1,2,2,0
28130028.0,26,28,1.0769230769230769,1,2,26,0
28130214.0,108,117,1.0833333333333333,1,2,108,0
28130302.0,147,1259,8.564625850340136,2,11,21,126
28130390.0,4,5,1.25,1,2,4,0
28130734.0,7,8,1.1428571428571428,1,2,7,0
28130778.0,4,4,1.0,1,1,4,0
28130815.0,40,42,1.05,1,2,40,0
28141817.0,116,587,5.060344827586207,2,7,116,0
28144025.0,33,75,2.272727272727273,1,5,33,0
28145712.0,143,840,5.874125874125874,2,9,130,13
28146754.0,22,46,2.090909090909091,1,4,22,0
28149357.0,356,3431,9.637640449438202,2,12,25,331
28158413.0,347,3366,9.70028818443804,2,13,18,329
28169958.0,91,198,2.1758241758241756,1,4,91,0
28171624.0,53,360,6.7924528301886795,3,9,39,14
28173380.0,2,18,9.0,9,9,0,2
28173727.0,41,129,3.1463414634146343,1,5,41,0
28174042.0,209,1041,4.980861244019139,2,8,207,2
28174622.0,24,49,2.0416666666666665,1,3,24,0
28174624.0,87,184,2.1149425287356323,1,5,87,0
28174625.0,20,45,2.25,1,4,20,0
28177624.0,21,69,3.2857142857142856,2,5,21,0
28196328.0,158,320,2.0253164556962027,1,5,158,0
28204341.0,245,1700,6.938775510204081,2,9,169,76
28204467.0,3,7,2.3333333333333335,2,3,3,0
28212304.0,38,156,4.105263157894737,2,7,38,0
28216620.0,3,10,3.3333333333333335,3,4,3,0
28219382.0,1,2,2.0,2,2,1,0
28225841.0,2,5,2.5,2,3,2,0
28232125.0,100,136,1.36,1,4,100,0
28236700.0,118,1023,8.669491525423728,2,12,15,103
28237489.0,837,3314,3.959378733572282,1,7,837,0
28242849.0,42,86,2.0476190476190474,1,4,42,0
28243068.0,1,3,3.0,3,3,1,0
28243544.0,1,3,3.0,3,3,1,0
28243613.0,4,10,2.5,1,3,4,0
28243710.0,2,6,3.0,3,3,2,0
28244399.0,2,7,3.5,3,4,2,0
28244627.0,1,3,3.0,3,3,1,0
28265991.0,147,298,2.0272108843537415,1,4,147,0
28267061.0,165,823,4.987878787878788,2,8,164,1
28269479.0,65,325,5.0,3,7,65,0
28269762.0,422,2901,6.874407582938389,2,10,296,126
28276924.0,28,75,2.6785714285714284,1,5,28,0
28277565.0,387,2660,6.873385012919897,2,10,262,125
28277572.0,25,95,3.8,2,5,25,0
28281711.0,270,549,2.033333333333333,1,5,270,0
28294421.0,185,895,4.837837837837838,2,7,185,0
28294427.0,120,240,2.0,1,4,120,0
28295122.0,72,358,4.972222222222222,2,7,72,0
28295823.0,84,331,3.9404761904761907,1,6,84,0
28296586.0,96,484,5.041666666666667,2,8,95,1
28297360.0,238,941,3.953781512605042,1,7,238,0
28297452.0,127,263,2.0708661417322833,1,4,127,0
28298754.0,265,1068,4.030188679245283,2,7,265,0
28300557.0,253,1008,3.984189723320158,1,7,253,0
28303813.0,34,48,1.411764705882353,1,3,34,0
28310239.0,6,9,1.5,1,2,6,0
28310729.0,19,30,1.5789473684210527,1,3,19,0
28322488.0,3,4,1.3333333333333333,1,2,3,0
28323311.0,233,1582,6.789699570815451,2,9,165,68
28324814.0,95,449,4.726315789473684,2,7,95,0
28330061.0,98,208,2.122448979591837,1,4,98,0
28331330.0,10,69,6.9,5,9,7,3
28331494.0,114,233,2.043859649122807,1,5,114,0
28332678.0,15,32,2.1333333333333333,1,4,15,0
28335965.0,88,263,2.9886363636363638,1,6,88,0
28337826.0,21,190,9.047619047619047,4,11,3,18
28341525.0,280,1670,5.964285714285714,2,9,264,16
28357458.0,11,81,7.363636363636363,6,9,6,5
28358297.0,27,262,9.703703703703704,4,11,1,26
28359189.0,186,374,2.010752688172043,1,5,186,0
28366576.0,36,284,7.888888888888889,3,10,8,28
28376350.0,1,1,1.0,1,1,1,0
28379440.0,93,286,3.075268817204301,1,6,93,0
28383745.0,90,685,7.611111111111111,3,11,39,51
28384365.0,50,250,5.0,2,7,50,0
28388357.0,101,499,4.9405940594059405,2,8,99,2
28395067.0,115,668,5.808695652173913,2,8,105,10
28396979.0,126,993,7.880952380952381,3,11,49,77
28397924.0,24,163,6.791666666666667,5,9,21,3
28398208.0,58,391,6.741379310344827,2,10,44,14
28406519.0,69,144,2.0869565217391304,1,4,69,0
28407635.0,6,13,2.1666666666666665,1,3,6,0
28410710.0,146,1004,6.876712328767123,2,10,107,39
28417941.0,46,366,7.956521739130435,4,10,11,35
28420430.0,235,479,2.0382978723404257,1,5,235,0
28423651.0,168,805,4.791666666666667,2,7,168,0
28425383.0,13,15,1.1538461538461537,1,2,13,0
28425385.0,113,161,1.424778761061947,1,3,113,0
28425390.0,10,20,2.0,1,4,10,0
28426907.0,80,766,9.575,2,12,8,72
28436814.0,7,20,2.857142857142857,2,4,7,0
28449632.0,103,526,5.106796116504855,2,8,102,1
28451053.0,74,376,5.081081081081081,3,8,73,1
28451687.0,90,462,5.133333333333334,3,9,89,1
28460900.0,14,25,1.7857142857142858,1,3,14,0
28466748.0,171,861,5.035087719298246,3,8,170,1
28472512.0,23,33,1.434782608695652,1,3,23,0
28476239.0,161,334,2.0745341614906834,1,4,161,0
28482100.0,3,9,3.0,2,4,3,0
28487493.0,248,2369,9.55241935483871,2,13,13,235
28488938.0,243,1195,4.917695473251029,1,8,242,1
28506448.0,75,288,3.84,2,6,75,0
28510556.0,30,115,3.8333333333333335,1,6,30,0
28510972.0,59,287,4.864406779661017,2,7,59,0
28514297.0,94,263,2.797872340425532,1,6,94,0
28528647.0,48,237,4.9375,2,8,47,1
28530059.0,294,2023,6.880952380952381,2,10,201,93
28533266.0,65,522,8.03076923076923,6,11,22,43
28533267.0,40,305,7.625,2,10,12,28
28533268.0,101,781,7.732673267326732,3,10,37,64
28553327.0,525,2589,4.9314285714285715,1,8,522,3
28554991.0,65,635,9.76923076923077,2,12,2,63
28555237.0,51,474,9.294117647058824,2,12,6,45
28555278.0,80,774,9.675,3,13,4,76
28555312.0,81,762,9.407407407407407,3,12,5,76
28555330.0,45,433,9.622222222222222,5,11,1,44
28559480.0,43,137,3.186046511627907,1,5,43,0
28582649.0,85,839,9.870588235294118,4,12,3,82
28585107.0,7,12,1.7142857142857142,1,3,7,0
28593752.0,33,95,2.878787878787879,1,5,33,0
28593906.0,20,79,3.95,2,5,20,0
28597308.0,102,206,2.019607843137255,1,4,102,0
28602205.0,60,456,7.6,4,11,26,34
28606014.0,106,1014,9.566037735849056,3,13,10,96
28606738.0,171,1498,8.760233918128655,3,12,20,151
28610401.0,150,740,4.933333333333334,2,8,148,2
28621986.0,164,1292,7.878048780487805,2,11,50,114
28624437.0,112,154,1.375,1,3,112,0
28624466.0,42,179,4.261904761904762,1,6,42,0
28624972.0,146,739,5.061643835616438,2,8,144,2
28625075.0,109,143,1.311926605504587,1,3,109,0
28625184.0,50,331,6.62,2,9,32,18
28630368.0,47,72,1.5319148936170213,1,3,47,0
28631895.0,2,7,3.5,3,4,2,0
28633261.0,23,216,9.391304347826088,5,12,3,20
28633661.0,14,29,2.0714285714285716,1,3,14,0
28634342.0,45,219,4.866666666666666,2,7,45,0
28649852.0,244,495,2.028688524590164,1,5,244,0
28658453.0,186,390,2.096774193548387,1,4,186,0
28683485.0,166,660,3.9759036144578315,1,6,166,0
28686566.0,3,7,2.3333333333333335,2,3,3,0
28693149.0,11,14,1.2727272727272727,1,2,11,0
28707165.0,299,2861,9.568561872909699,2,13,17,282
28708466.0,41,335,8.170731707317072,5,10,13,28
28709524.0,37,315,8.513513513513514,3,11,5,32
28712157.0,36,247,6.861111111111111,4,9,25,11
28712552.0,79,625,7.9113924050632916,5,10,20,59
28714073.0,8,9,1.125,1,2,8,0
28745156.0,330,1614,4.890909090909091,2,8,329,1
28747890.0,106,507,4.783018867924528,2,7,106,0
28751331.0,123,599,4.869918699186992,2,7,123,0
28756036.0,14,40,2.857142857142857,1,5,14,0
28770026.0,15,131,8.733333333333333,3,11,3,12
28773808.0,20,24,1.2,1,2,20,0
28779315.0,2,6,3.0,3,3,2,0
28790449.0,51,342,6.705882352941177,5,9,39,12
28794472.0,77,671,8.714285714285714,4,12,10,67
28798293.0,23,149,6.478260869565218,3,9,19,4
28798473.0,33,153,4.636363636363637,2,6,33,0
28802147.0,106,217,2.047169811320755,1,4,106,0
28805678.0,15,125,8.333333333333334,7,10,3,12
28806048.0,98,204,2.0816326530612246,1,5,98,0
28810699.0,55,163,2.963636363636364,1,5,55,0
28824832.0,20,84,4.2,3,6,20,0
28829760.0,18,33,1.8333333333333333,1,3,18,0
28831969.0,11,56,5.090909090909091,2,7,11,0
28854052.0,34,136,4.0,2,6,34,0
28862918.0,26,57,2.1923076923076925,1,5,26,0
28863215.0,46,137,2.9782608695652173,1,5,46,0
28864097.0,104,714,6.865384615384615,2,9,69,35
28866819.0,103,618,6.0,2,9,90,13
28874140.0,15,43,2.8666666666666667,1,5,15,0
28878206.0,43,204,4.744186046511628,2,8,42,1
28878459.0,53,498,9.39622641509434,3,13,4,49
28879760.0,18,38,2.111111111111111,1,4,18,0
28888256.0,1,6,6.0,6,6,1,0
28889883.0,575,1192,2.0730434782608698,1,5,575,0
28890037.0,23,48,2.0869565217391304,1,4,23,0
28890516.0,28,64,2.2857142857142856,1,4,28,0
28890582.0,688,1368,1.9883720930232558,1,5,688,0
28891626.0,699,1475,2.1101573676680974,1,4,699,0
28891765.0,744,1526,2.0510752688172045,1,5,744,0
28891855.0,718,1472,2.050139275766017,1,5,718,0
28892011.0,697,1447,2.0760401721664277,1,5,697,0
28903687.0,221,1705,7.714932126696833,3,10,89,132
28904705.0,71,94,1.323943661971831,1,3,71,0
28910849.0,374,3241,8.665775401069519,2,12,48,326
28912074.0,170,347,2.041176470588235,1,5,170,0
28912936.0,135,195,1.4444444444444444,1,4,135,0
28913067.0,5,30,6.0,4,8,4,1
28915349.0,161,973,6.043478260869565,2,8,150,11
28923267.0,12,21,1.75,1,3,12,0
28925581.0,105,1013,9.647619047619047,3,12,9,96
28928344.0,34,159,4.676470588235294,3,6,34,0
28935790.0,87,519,5.9655172413793105,3,8,83,4
28936623.0,81,472,5.827160493827161,2,8,77,4
28936982.0,14,26,1.8571428571428572,1,4,14,0
28937774.0,41,289,7.048780487804878,5,9,27,14
28938326.0,64,442,6.90625,2,9,43,21
28946258.0,48,63,1.3125,1,3,48,0
28951587.0,96,195,2.03125,1,4,96,0
28952927.0,100,471,4.71,1,7,100,0
28959560.0,51,202,3.9607843137254903,1,7,51,0
28961403.0,135,186,1.3777777777777778,1,4,135,0
28973621.0,50,330,6.6,2,9,35,15
28973807.0,8,63,7.875,7,9,4,4
28976317.0,1,8,8.0,8,8,0,1
28977356.0,53,118,2.2264150943396226,1,4,53,0
28980992.0,255,543,2.1294117647058823,1,5,255,0
28986348.0,42,153,3.642857142857143,2,6,42,0
28988486.0,228,2205,9.671052631578947,2,13,12,216
29001056.0,173,819,4.734104046242774,2,8,172,1
29008799.0,228,470,2.06140350877193,1,5,228,0
29010745.0,51,200,3.9215686274509802,2,7,51,0
29011131.0,3,12,4.0,3,5,3,0
29017787.0,16,104,6.5,3,9,13,3
29023627.0,384,3371,8.778645833333334,2,12,46,338
29025037.0,194,747,3.850515463917526,1,7,194,0
29028617.0,1,2,2.0,2,2,1,0
29032140.0,5,21,4.2,3,5,5,0
29035565.0,79,778,9.848101265822784,2,12,4,75
29047105.0,11,44,4.0,2,6,11,0
29049646.0,4,5,1.25,1,2,4,0
29054264.0,3,12,4.0,4,4,3,0
29055377.0,1,1,1.0,1,1,1,0
29059024.0,5,10,2.0,1,3,5,0
29059549.0,121,1055,8.71900826446281,4,12,19,102
29069146.0,83,417,5.024096385542169,2,7,83,0
29069877.0,279,1912,6.853046594982079,2,10,197,82
29070421.0,46,168,3.652173913043478,2,6,46,0
29072057.0,45,430,9.555555555555555,2,12,2,43
29072936.0,98,761,7.76530612244898,4,10,32,66
29073951.0,21,199,9.476190476190476,2,12,2,19
29074426.0,6,49,8.166666666666666,7,9,1,5
29075998.0,32,66,2.0625,1,4,32,0
29076655.0,51,500,9.803921568627452,2,13,4,47
29078588.0,388,1894,4.881443298969073,2,8,386,2
29079026.0,1,4,4.0,4,4,1,0
29085751.0,83,779,9.385542168674698,2,13,7,76
29089129.0,91,799,8.780219780219781,4,11,7,84
29089955.0,233,1169,5.017167381974249,2,8,232,1
29094945.0,167,830,4.970059880239521,2,8,166,1
29099065.0,268,1325,4.9440298507462686,2,8,267,1
29102324.0,1,1,1.0,1,1,1,0
29117007.0,2,4,2.0,2,2,2,0
29118129.0,2,6,3.0,3,3,2,0
29118807.0,233,1131,4.854077253218884,2,7,233,0
29119475.0,247,1232,4.987854251012146,2,7,247,0
29122094.0,5,51,10.2,10,11,0,5
29124107.0,227,1108,4.881057268722467,2,8,226,1
29124688.0,275,1321,4.803636363636364,2,7,275,0
29126142.0,19,92,4.842105263157895,3,7,19,0
29126928.0,47,447,9.51063829787234,2,12,3,44
29128161.0,99,288,2.909090909090909,1,5,99,0
29140374.0,147,323,2.197278911564626,1,5,147,0
29140516.0,1,3,3.0,3,3,1,0
29149948.0,212,1448,6.830188679245283,2,10,141,71
29151044.0,1,2,2.0,2,2,1,0
29154465.0,401,2762,6.887780548628429,2,10,280,121
29164597.0,137,1288,9.401459854014599,2,13,14,123
29171091.0,247,486,1.9676113360323886,1,5,247,0
29172802.0,1080,5392,4.992592592592593,2,9,1071,9
29172812.0,107,222,2.074766355140187,1,5,107,0
29177367.0,40,318,7.95,3,10,10,30
29177458.0,210,1020,4.857142857142857,2,8,209,1
29192491.0,127,629,4.952755905511811,2,8,126,1
29195950.0,51,351,6.882352941176471,3,10,35,16
29197647.0,26,228,8.76923076923077,6,11,5,21
29202901.0,245,2091,8.534693877551021,2,11,38,207
29207481.0,59,351,5.9491525423728815,2,8,54,5
29210809.0,76,161,2.1184210526315788,1,4,76,0
29230708.0,127,512,4.031496062992126,2,6,127,0
29232685.0,9,15,1.6666666666666667,1,3,9,0
29233006.0,30,85,2.8333333333333335,1,4,30,0
29244773.0,181,554,3.0607734806629834,1,5,181,0
29248209.0,199,612,3.0753768844221105,1,5,199,0
29254249.0,95,375,3.9473684210526314,1,6,95,0
29267537.0,21,166,7.904761904761905,5,10,7,14
29267640.0,61,548,8.98360655737705,3,11,6,55
29269250.0,2,18,9.0,9,9,0,2
29276590.0,49,65,1.3265306122448979,1,3,49,0
29276955.0,232,1992,8.586206896551724,3,12,33,199
29280743.0,134,874,6.522388059701493,2,9,107,27
29281002.0,208,1988,9.557692307692308,2,13,18,190
29293910.0,29,36,1.2413793103448276,1,2,29,0
29294412.0,197,422,2.1421319796954315,1,5,197,0
29297779.0,52,354,6.8076923076923075,2,10,41,11
29298155.0,3,18,6.0,5,7,3,0
29298179.0,10,23,2.3,1,4,10,0
29298407.0,126,844,6.698412698412699,2,9,92,34
29299683.0,150,299,1.9933333333333334,1,4,150,0
29301608.0,6,20,3.3333333333333335,2,4,6,0
29302584.0,5,10,2.0,1,4,5,0
29303204.0,4,8,2.0,1,3,4,0
29304549.0,12,27,2.25,1,4,12,0
29306921.0,158,777,4.917721518987341,1,8,156,2
29309859.0,6,46,7.666666666666667,7,8,2,4
29310279.0,192,374,1.9479166666666667,1,4,192,0
29322042.0,133,408,3.0676691729323307,1,6,133,0
29323569.0,250,778,3.112,1,6,250,0
29323716.0,94,487,5.180851063829787,2,8,93,1
29324715.0,2,5,2.5,2,3,2,0
29325233.0,364,2515,6.90934065934066,2,10,243,121
29330541.0,246,538,2.186991869918699,1,4,246,0
29348013.0,2,7,3.5,2,5,2,0
29348826.0,139,689,4.956834532374101,2,7,139,0
29351395.0,41,113,2.7560975609756095,1,5,41,0
29352338.0,182,1791,9.840659340659341,2,12,7,175
29355841.0,194,415,2.1391752577319587,1,5,194,0
29357076.0,57,406,7.12280701754386,4,9,38,19
29357656.0,76,164,2.1578947368421053,1,5,76,0
29359040.0,23,128,5.565217391304348,4,7,23,0
29359316.0,530,5052,9.532075471698112,2,14,41,489
29360967.0,35,70,2.0,1,4,35,0
29362298.0,21,106,5.0476190476190474,2,7,21,0
29363304.0,20,115,5.75,4,7,20,0
29364348.0,1,1,1.0,1,1,1,0
29364881.0,8,15,1.875,1,3,8,0
29364889.0,78,733,9.397435897435898,3,11,6,72
29376909.0,51,340,6.666666666666667,2,9,37,14
29386807.0,51,125,2.450980392156863,1,4,51,0
29388403.0,220,869,3.95,2,7,220,0
29399279.0,47,102,2.1702127659574466,1,4,47,0
29402226.0,30,230,7.666666666666667,3,10,12,18
29409648.0,310,658,2.1225806451612903,1,5,310,0
29409915.0,25,235,9.4,2,12,3,22
29428186.0,78,593,7.602564102564102,4,9,36,42
29428820.0,160,1099,6.86875,2,10,120,40
29433395.0,204,1616,7.921568627450981,2,11,65,139
29448040.0,4,22,5.5,5,6,4,0
29451492.0,183,1407,7.688524590163935,2,11,71,112
29454680.0,167,1325,7.934131736526946,2,11,43,124
29474108.0,67,457,6.82089552238806,2,9,45,22
29474507.0,123,258,2.097560975609756,1,4,123,0
29474792.0,96,206,2.1458333333333335,1,4,96,0
29474954.0,201,578,2.8756218905472637,1,6,201,0
29478710.0,64,495,7.734375,2,10,22,42
29485547.0,315,1592,5.053968253968254,2,9,311,4
29486125.0,32,130,4.0625,2,6,32,0
29501876.0,371,3595,9.690026954177897,2,13,22,349
29506716.0,60,469,7.816666666666666,5,10,23,37
29508127.0,49,155,3.163265306122449,1,5,49,0
29510774.0,101,404,4.0,2,7,101,0
29513594.0,340,3275,9.632352941176471,2,13,21,319
29516650.0,21,34,1.619047619047619,1,4,21,0
29525196.0,89,609,6.842696629213483,2,10,65,24
29533376.0,2,2,1.0,1,1,2,0
29536072.0,9,19,2.111111111111111,1,4,9,0
29541101.0,234,1832,7.829059829059829,2,11,76,158
29543327.0,4,8,2.0,2,2,4,0
29556070.0,28,111,3.9642857142857144,2,6,28,0
29558661.0,1,2,2.0,2,2,1,0
29559266.0,63,548,8.698412698412698,2,13,7,56
29559642.0,8,8,1.0,1,1,8,0
29559860.0,1,1,1.0,1,1,1,0
29567988.0,76,369,4.855263157894737,3,7,76,0
29580844.0,33,99,3.0,1,5,33,0
29582447.0,24,79,3.2916666666666665,1,5,24,0
29587386.0,284,857,3.017605633802817,1,6,284,0
29588907.0,136,279,2.051470588235294,1,5,136,0
29592394.0,21,44,2.0952380952380953,1,4,21,0
29609133.0,14,27,1.9285714285714286,1,5,14,0
29610643.0,52,267,5.134615384615385,2,7,52,0
29613341.0,11,24,2.1818181818181817,1,4,11,0
29620670.0,21,44,2.0952380952380953,1,4,21,0
29622067.0,2,5,2.5,2,3,2,0
29622187.0,2,6,3.0,2,4,2,0
29624750.0,13,39,3.0,1,6,13,0
29631361.0,31,217,7.0,5,9,22,9
29631761.0,64,117,1.828125,1,4,64,0
29632358.0,2,4,2.0,1,3,2,0
29641131.0,94,469,4.98936170212766,2,8,93,1
29647110.0,21,48,2.2857142857142856,1,4,21,0
29655491.0,72,291,4.041666666666667,2,6,72,0
29670660.0,164,1118,6.817073170731708,2,10,123,41
29672149.0,71,478,6.732394366197183,2,9,55,16
29674301.0,253,511,2.0197628458498023,1,5,253,0
29675720.0,60,130,2.1666666666666665,1,4,60,0
29675785.0,35,79,2.257142857142857,1,4,35,0
29675845.0,57,126,2.210526315789474,1,3,57,0
29675864.0,16,32,2.0,1,3,16,0
29676377.0,25,195,7.8,5,10,9,16
29676744.0,256,1764,6.890625,3,10,180,76
29677141.0,47,326,6.9361702127659575,3,10,31,16
29677936.0,9,18,2.0,1,3,9,0
29681089.0,38,62,1.631578947368421,1,4,38,0
29684657.0,152,601,3.9539473684210527,1,6,152,0
29693243.0,68,143,2.1029411764705883,1,4,68,0
29698282.0,171,371,2.1695906432748537,1,5,171,0
29701261.0,32,164,5.125,2,7,32,0
29701262.0,4,17,4.25,3,7,4,0
29702873.0,75,735,9.8,2,13,4,71
29705003.0,164,1569,9.567073170731707,2,13,13,151
29705339.0,15,110,7.333333333333333,6,9,9,6
29706436.0,33,244,7.393939393939394,3,10,16,17
29723696.0,84,555,6.607142857142857,2,10,61,23
29724752.0,196,1915,9.770408163265307,2,13,8,188
29724882.0,222,674,3.036036036036036,1,5,222,0
29728622.0,27,37,1.3703703703703705,1,3,27,0
29728896.0,21,28,1.3333333333333333,1,3,21,0
29734611.0,18,37,2.0555555555555554,1,4,18,0
29737094.0,130,261,2.0076923076923077,1,4,130,0
29742587.0,13,105,8.076923076923077,7,10,3,10
29750482.0,2,3,1.5,1,2,2,0
29754712.0,126,1229,9.753968253968255,2,12,4,122
29758678.0,259,1282,4.94980694980695,2,9,255,4
29759705.0,20,82,4.1,3,6,20,0
29759741.0,21,177,8.428571428571429,3,10,2,19
29759801.0,26,110,4.230769230769231,3,6,26,0
29759850.0,38,309,8.131578947368421,3,11,9,29
29759929.0,17,74,4.352941176470588,2,6,17,0
29767289.0,13,103,7.923076923076923,7,10,4,9
29768078.0,3,6,2.0,1,3,3,0
29777267.0,185,1742,9.416216216216217,2,12,15,170
29792684.0,289,1420,4.913494809688581,2,7,289,0
29792711.0,68,548,8.058823529411764,6,10,21,47
29798791.0,10,22,2.2,1,4,10,0
29799905.0,107,739,6.906542056074766,2,11,75,32
29810117.0,162,1397,8.623456790123457,2,11,20,142
29816673.0,27,53,1.962962962962963,1,5,27,0
29820608.0,72,373,5.180555555555555,2,8,71,1
29822910.0,49,385,7.857142857142857,3,10,15,34
29827227.0,8,14,1.75,1,4,8,0
29841557.0,121,595,4.917355371900826,2,7,121,0
29841889.0,232,1372,5.913793103448276,2,8,217,15
29842048.0,89,428,4.808988764044944,2,7,89,0
29850257.0,47,189,4.0212765957446805,2,7,47,0
29867752.0,288,2763,9.59375,2,13,21,267
29871616.0,219,2120,9.680365296803654,2,12,13,206
29880199.0,58,218,3.7586206896551726,1,8,57,1
29881908.0,223,1554,6.968609865470852,2,10,150,73
29890163.0,3,9,3.0,2,4,3,0
29895518.0,64,327,5.109375,2,7,64,0
29895521.0,136,675,4.963235294117647,2,8,135,1
29895535.0,8,36,4.5,2,6,8,0
29895560.0,96,931,9.697916666666666,2,13,6,90
29899013.0,21,143,6.809523809523809,5,9,14,7
29914464.0,192,1693,8.817708333333334,3,11,18,174
29915515.0,365,772,2.115068493150685,1,5,365,0
29922954.0,14,31,2.2142857142857144,1,3,14,0
29926045.0,20,63,3.15,1,5,20,0
29927598.0,29,53,1.8275862068965518,1,4,29,0
29933637.0,130,903,6.946153846153846,2,10,86,44
29936250.0,44,177,4.0227272727272725,2,7,44,0
29938173.0,75,661,8.813333333333333,5,11,7,68
29953475.0,118,684,5.796610169491525,2,9,113,5
29957140.0,479,2332,4.8684759916492695,1,8,475,4
29957677.0,7,18,2.5714285714285716,1,4,7,0
29962701.0,156,1210,7.756410256410256,3,11,55,101
29973473.0,1,1,1.0,1,1,1,0
29977886.0,276,1370,4.963768115942029,2,7,276,0
29981080.0,144,302,2.0972222222222223,1,5,144,0
29982419.0,23,164,7.130434782608695,6,9,15,8
30000239.0,47,225,4.787234042553192,3,7,47,0
30002781.0,195,961,4.9282051282051285,2,8,193,2
30006602.0,247,978,3.9595141700404857,1,7,247,0
30010428.0,163,1163,7.134969325153374,4,9,101,62
30011086.0,106,743,7.009433962264151,2,11,70,36
30011385.0,112,795,7.098214285714286,5,9,78,34
30011887.0,56,324,5.785714285714286,2,8,51,5
30012017.0,68,397,5.838235294117647,2,8,66,2
30012109.0,309,1509,4.883495145631068,1,8,307,2
30012130.0,123,743,6.040650406504065,3,9,115,8
30027258.0,285,2798,9.817543859649122,2,13,13,272
30032049.0,345,3290,9.53623188405797,2,12,31,314
30033132.0,116,239,2.060344827586207,1,5,116,0
30034191.0,4,22,5.5,5,7,4,0
30034429.0,39,73,1.8717948717948718,1,3,39,0
30034456.0,13,65,5.0,3,8,12,1
30039450.0,80,756,9.45,4,12,5,75
30052740.0,108,228,2.111111111111111,1,5,108,0
30052958.0,193,960,4.974093264248705,2,8,192,1
30057760.0,66,437,6.621212121212121,2,8,50,16
30058424.0,86,585,6.8023255813953485,2,10,62,24
30060769.0,216,855,3.9583333333333335,1,7,216,0
30061571.0,168,489,2.9107142857142856,1,5,168,0
30062138.0,2,4,2.0,2,2,2,0
30064092.0,154,463,3.0064935064935066,1,5,154,0
30075606.0,25,169,6.76,3,8,20,5
30079802.0,98,214,2.183673469387755,1,5,98,0
30080887.0,166,507,3.0542168674698793,1,6,166,0
30088078.0,18,145,8.055555555555555,7,10,5,13
30092570.0,54,265,4.907407407407407,2,7,54,0
30101453.0,2,3,1.5,1,2,2,0
30106520.0,47,310,6.595744680851064,3,9,38,9
30106610.0,251,523,2.0836653386454183,1,4,251,0
30113767.0,27,179,6.62962962962963,3,9,20,7
30116663.0,50,496,9.92,4,12,1,49
30117434.0,104,223,2.144230769230769,1,5,104,0
30122399.0,12,42,3.5,2,5,12,0
30123401.0,67,137,2.044776119402985,1,4,67,0
30124982.0,54,362,6.703703703703703,2,9,37,17
30125320.0,101,699,6.920792079207921,4,10,67,34
30127720.0,14,42,3.0,1,4,14,0
30128837.0,298,2019,6.775167785234899,2,11,222,76
30136935.0,259,547,2.111969111969112,1,5,259,0
30136939.0,201,434,2.1592039800995027,1,5,201,0
30136973.0,218,432,1.981651376146789,1,4,218,0
30138344.0,4,10,2.5,2,3,4,0
30140315.0,16,51,3.1875,1,5,16,0
30142523.0,217,668,3.078341013824885,1,6,217,0
30143422.0,205,424,2.0682926829268293,1,5,205,0
30146528.0,374,3640,9.732620320855615,2,13,21,353
30150966.0,53,461,8.69811320754717,4,11,5,48
30152619.0,1,3,3.0,3,3,1,0
30157737.0,3,5,1.6666666666666667,1,2,3,0
30168080.0,190,1313,6.910526315789474,2,10,135,55
30170000.0,53,260,4.90566037735849,3,7,53,0
30170707.0,6,31,5.166666666666667,3,6,6,0
30172045.0,4,9,2.25,1,4,4,0
30174960.0,14,49,3.5,3,5,14,0
30178142.0,61,482,7.901639344262295,4,11,22,39
30180641.0,27,55,2.037037037037037,1,4,27,0
30180656.0,67,578,8.626865671641792,3,12,8,59
30191029.0,434,4175,9.619815668202765,2,13,38,396
30193899.0,11,32,2.909090909090909,2,5,11,0
30194347.0,9,23,2.5555555555555554,1,5,9,0
30194972.0,74,572,7.72972972972973,2,11,26,48
30195185.0,8,29,3.625,3,5,8,0
30195411.0,196,410,2.0918367346938775,1,5,196,0
30199397.0,41,83,2.024390243902439,1,4,41,0
30202353.0,198,966,4.878787878787879,2,7,198,0
30203475.0,28,139,4.964285714285714,2,7,28,0
30203911.0,341,1742,5.108504398826979,2,8,340,1
30204535.0,4,29,7.25,4,9,1,3
30211968.0,134,256,1.9104477611940298,1,4,134,0
30221476.0,44,282,6.409090909090909,2,10,35,9
30228643.0,149,736,4.939597315436242,2,8,146,3
30232678.0,7,14,2.0,1,3,7,0
30232733.0,186,1591,8.553763440860216,2,11,29,157
30239951.0,148,446,3.0135135135135136,1,6,148,0
30241656.0,2,16,8.0,7,9,1,1
30242387.0,140,951,6.792857142857143,2,10,102,38
30248658.0,150,304,2.026666666666667,1,5,150,0
30259207.0,168,1618,9.630952380952381,2,13,11,157
30265562.0,30,41,1.3666666666666667,1,3,30,0
30268642.0,295,2851,9.664406779661016,2,13,19,276
30269649.0,16,105,6.5625,4,10,14,2
30270740.0,588,5704,9.700680272108844,2,13,38,550
30273577.0,195,1521,7.8,2,11,69,126
30279544.0,156,756,4.846153846153846,2,8,155,1
30281700.0,214,1055,4.929906542056075,2,8,212,2
30283317.0,318,3066,9.641509433962264,2,13,21,297
30284619.0,293,1452,4.955631399317406,2,8,292,1
30285410.0,225,1094,4.862222222222222,2,8,224,1
30285774.0,331,3216,9.716012084592146,2,13,23,308
30286383.0,279,1365,4.89247311827957,2,8,278,1
30286826.0,176,1722,9.784090909090908,3,13,8,168
30287707.0,292,1465,5.017123287671233,2,7,292,0
30287993.0,246,1695,6.890243902439025,2,11,164,82
30288026.0,131,408,3.114503816793893,1,7,131,0
30289869.0,224,1510,6.741071428571429,2,10,161,63
30290075.0,172,342,1.9883720930232558,1,5,172,0
30302761.0,167,345,2.065868263473054,1,5,167,0
30304531.0,30,261,8.7,4,11,5,25
30304842.0,1,2,2.0,2,2,1,0
30304976.0,190,932,4.905263157894737,2,7,190,0
30306581.0,55,538,9.781818181818181,6,13,2,53
30313285.0,130,259,1.9923076923076923,1,5,130,0
30314683.0,31,222,7.161290322580645,5,9,17,14
30314696.0,108,310,2.8703703703703702,1,5,108,0
30314700.0,18,37,2.0555555555555554,1,4,18,0
30314705.0,92,188,2.0434782608695654,1,4,92,0
30314708.0,19,46,2.4210526315789473,1,4,19,0
30315199.0,175,689,3.9371428571428573,1,6,175,0
30332807.0,78,742,9.512820512820513,4,12,5,73
30335955.0,56,501,8.946428571428571,5,11,5,51
30337686.0,1,2,2.0,2,2,1,0
30342328.0,72,498,6.916666666666667,4,9,54,18
30343702.0,11,18,1.6363636363636365,1,3,11,0
30349359.0,159,805,5.062893081761007,2,8,156,3
30350157.0,18,42,2.3333333333333335,1,4,18,0
30358951.0,248,998,4.024193548387097,1,7,248,0
30361617.0,231,468,2.0259740259740258,1,4,231,0
30362207.0,25,219,8.76,2,10,1,24
30362367.0,13,19,1.4615384615384615,1,3,13,0
30364212.0,8,10,1.25,1,2,8,0
30364342.0,130,635,4.884615384615385,2,8,129,1
30365071.0,30,301,10.033333333333333,7,13,1,29
30365169.0,3,4,1.3333333333333333,1,2,3,0
30366050.0,43,394,9.162790697674419,7,11,1,42
30366581.0,62,609,9.82258064516129,5,12,2,60
30370024.0,170,1672,9.83529411764706,2,12,7,163
30370510.0,31,98,3.161290322580645,1,5,31,0
30371880.0,230,702,3.0521739130434784,1,6,230,0
30371913.0,43,351,8.162790697674419,3,11,10,33
30372931.0,1,3,3.0,3,3,1,0
30373137.0,291,594,2.0412371134020617,1,4,291,0
30375314.0,27,52,1.9259259259259258,1,3,27,0
30375580.0,82,260,3.1707317073170733,1,5,82,0
30375804.0,24,28,1.1666666666666667,1,3,24,0
30375863.0,31,258,8.32258064516129,6,12,7,24
30375972.0,18,41,2.2777777777777777,1,4,18,0
30376836.0,7,51,7.285714285714286,6,10,6,1
30385286.0,219,838,3.82648401826484,1,6,219,0
30386443.0,187,401,2.144385026737968,1,5,187,0
30390777.0,155,1053,6.7935483870967746,2,10,106,49
30391533.0,56,383,6.839285714285714,2,9,43,13
30396024.0,14,40,2.857142857142857,1,4,14,0
30415140.0,153,771,5.03921568627451,2,8,152,1
30416134.0,23,204,8.869565217391305,7,11,3,20
30416472.0,45,394,8.755555555555556,2,11,6,39
30417793.0,151,746,4.940397350993377,2,8,150,1
30418183.0,16,36,2.25,1,4,16,0
30418856.0,13,16,1.2307692307692308,1,2,13,0
30419466.0,181,871,4.8121546961325965,2,8,180,1
30434405.0,182,1752,9.626373626373626,2,12,11,171
30436265.0,188,389,2.0691489361702127,1,5,188,0
30437081.0,94,450,4.787234042553192,2,8,93,1
30439267.0,24,160,6.666666666666667,3,9,20,4
30440167.0,26,164,6.3076923076923075,3,9,22,4
30440625.0,12,93,7.75,6,9,4,8
30441615.0,2,16,8.0,7,9,1,1
30454502.0,134,255,1.9029850746268657,1,4,134,0
30457277.0,55,375,6.818181818181818,2,9,39,16
30468961.0,10,19,1.9,1,3,10,0
30469111.0,93,466,5.010752688172043,2,8,92,1
30489186.0,58,562,9.689655172413794,3,13,2,56
30492585.0,4,16,4.0,2,5,4,0
30494947.0,234,2324,9.931623931623932,2,13,5,229
30497982.0,64,622,9.71875,3,12,5,59
30498116.0,398,1958,4.919597989949748,1,8,396,2
30499377.0,1,2,2.0,2,2,1,0
30506741.0,130,1132,8.707692307692307,2,12,19,111
30509294.0,216,1064,4.925925925925926,2,7,216,0
30517121.0,297,2907,9.787878787878787,2,13,13,284
30518985.0,26,207,7.961538461538462,6,10,8,18
30519268.0,2,4,2.0,1,3,2,0
30519797.0,80,235,2.9375,1,6,80,0
30520927.0,233,1151,4.939914163090129,2,7,233,0
30529205.0,230,1130,4.913043478260869,2,7,230,0
30531644.0,16,31,1.9375,1,4,16,0
30531971.0,200,606,3.03,1,7,200,0
30536211.0,336,1687,5.020833333333333,2,7,336,0
30536448.0,188,963,5.122340425531915,2,8,187,1
30538071.0,8,10,1.25,1,2,8,0
30548271.0,21,163,7.761904761904762,5,10,8,13
30549127.0,3,6,2.0,1,3,3,0
30551594.0,1,4,4.0,4,4,1,0
30554500.0,160,1237,7.73125,2,10,60,100
30555994.0,210,646,3.0761904761904764,1,5,210,0
30558144.0,105,799,7.609523809523809,2,10,40,65
30558484.0,21,47,2.238095238095238,1,5,21,0
30561163.0,3,9,3.0,2,4,3,0
30575060.0,14,27,1.9285714285714286,1,3,14,0
30575203.0,2,3,1.5,1,2,2,0
30577028.0,309,2115,6.844660194174757,2,9,217,92
30577776.0,383,1871,4.885117493472585,2,8,380,3
30580023.0,275,1603,5.829090909090909,2,9,260,15
30580469.0,287,1650,5.7491289198606275,2,9,277,10
30580730.0,183,1250,6.830601092896175,3,10,136,47
30581980.0,50,467,9.34,2,13,5,45
30583391.0,497,4793,9.643863179074447,2,13,40,457
30584072.0,37,365,9.864864864864865,7,12,1,36
30585185.0,27,239,8.851851851851851,3,12,4,23
30589357.0,56,388,6.928571428571429,3,9,42,14
30590489.0,197,1894,9.614213197969542,2,13,15,182
30595434.0,22,68,3.090909090909091,1,7,22,0
30616019.0,228,892,3.912280701754386,1,7,228,0
30617520.0,41,158,3.8536585365853657,1,7,41,0
30628615.0,86,754,8.767441860465116,4,11,11,75
30638600.0,65,612,9.415384615384616,2,12,6,59
30668610.0,52,455,8.75,2,11,6,46
30687656.0,1,2,2.0,2,2,1,0
30689478.0,334,672,2.0119760479041915,1,5,334,0
30691003.0,142,285,2.007042253521127,1,5,142,0
30693768.0,130,1260,9.692307692307692,2,13,7,123
30700091.0,15,48,3.2,2,5,15,0
30706270.0,97,934,9.628865979381443,2,12,8,89
30707924.0,105,507,4.828571428571428,2,8,103,2
30712288.0,1,3,3.0,3,3,1,0
30714597.0,253,1987,7.853754940711463,2,11,82,171
30722916.0,142,202,1.4225352112676057,1,4,142,0
30731288.0,30,208,6.933333333333334,3,9,20,10
30733573.0,144,1007,6.993055555555555,2,9,89,55
30734070.0,64,200,3.125,1,6,64,0
30734873.0,83,424,5.108433734939759,2,7,83,0
30739473.0,268,1312,4.895522388059701,2,8,267,1
30744454.0,129,667,5.170542635658915,3,8,127,2
30755714.0,256,274,1.0703125,1,3,256,0
30756852.0,1,1,1.0,1,1,1,0
30757850.0,6,9,1.5,1,2,6,0
30761904.0,479,2387,4.98329853862213,2,8,476,3
30761941.0,135,663,4.911111111111111,2,7,135,0
30761960.0,114,540,4.7368421052631575,2,7,114,0
30761981.0,123,487,3.959349593495935,2,6,123,0
30762068.0,132,401,3.037878787878788,1,6,132,0
30762108.0,36,144,4.0,1,6,36,0
30762228.0,300,1483,4.943333333333333,2,8,299,1
30763426.0,4,10,2.5,1,4,4,0
30768647.0,50,340,6.8,3,9,34,16
30768824.0,12,19,1.5833333333333333,1,3,12,0
30784254.0,319,1890,5.924764890282131,2,9,294,25
30784618.0,471,2776,5.89384288747346,2,10,450,21
30789437.0,35,71,2.0285714285714285,1,4,35,0
30792643.0,11,37,3.3636363636363638,1,5,11,0
30805125.0,162,786,4.851851851851852,2,7,162,0
30805887.0,311,654,2.102893890675241,1,5,311,0
30809685.0,391,2656,6.792838874680307,2,11,290,101
30812519.0,1,3,3.0,3,3,1,0
30816466.0,46,82,1.7826086956521738,1,4,46,0
30820116.0,197,394,2.0,1,5,197,0
30820737.0,56,116,2.0714285714285716,1,4,56,0
30822843.0,29,165,5.689655172413793,3,7,29,0
30839966.0,107,517,4.831775700934579,2,7,107,0
30848303.0,94,209,2.223404255319149,1,5,94,0
30848334.0,90,190,2.111111111111111,1,5,90,0
30849967.0,58,127,2.189655172413793,1,5,58,0
30850552.0,214,459,2.1448598130841123,1,5,214,0
30854835.0,154,1502,9.753246753246753,2,12,9,145
30871043.0,118,574,4.864406779661017,2,8,117,1
30877342.0,117,243,2.076923076923077,1,5,117,0
30900397.0,8,12,1.5,1,3,8,0
30902346.0,243,962,3.9588477366255144,1,7,243,0
30903314.0,36,278,7.722222222222222,3,9,14,22
30903535.0,58,385,6.637931034482759,3,9,48,10
30917034.0,182,891,4.895604395604396,2,7,182,0
30919919.0,2,6,3.0,2,4,2,0
30920584.0,285,1424,4.996491228070176,1,7,285,0
30922142.0,16,49,3.0625,1,5,16,0
30922575.0,81,634,7.827160493827161,3,11,30,51
30924926.0,137,685,5.0,2,8,136,1
30925546.0,240,493,2.0541666666666667,1,5,240,0
30926888.0,31,185,5.967741935483871,4,8,30,1
30927341.0,52,310,5.961538461538462,2,8,49,3
30927588.0,62,423,6.82258064516129,2,9,45,17
30948431.0,297,625,2.1043771043771042,1,5,297,0
30949073.0,218,447,2.05045871559633,1,5,218,0
30950444.0,121,818,6.760330578512397,3,9,87,34
30952048.0,113,546,4.831858407079646,2,7,113,0
30952586.0,212,418,1.971698113207547,1,5,212,0
30953550.0,57,223,3.912280701754386,2,6,57,0
30970607.0,305,1473,4.829508196721312,2,8,304,1
30975241.0,148,1403,9.47972972972973,2,12,11,137
30981739.0,1,1,1.0,1,1,1,0
30984511.0,111,326,2.936936936936937,1,6,111,0
31008937.0,61,185,3.0327868852459017,1,5,61,0
31010888.0,51,160,3.1372549019607843,1,5,51,0
31011318.0,39,377,9.666666666666666,6,12,2,37
31026428.0,354,2429,6.861581920903955,2,10,252,102
31031841.0,9,33,3.6666666666666665,3,5,9,0
31032181.0,59,227,3.847457627118644,2,6,59,0
31036137.0,44,87,1.9772727272727273,1,4,44,0
31037799.0,136,415,3.051470588235294,1,6,136,0
31037882.0,30,60,2.0,1,4,30,0
31038229.0,103,511,4.961165048543689,2,8,101,2
31048813.0,10,99,9.9,8,11,0,10
31051926.0,216,840,3.888888888888889,1,7,216,0
31056305.0,1,4,4.0,4,4,1,0
31063056.0,7,14,2.0,1,3,7,0
31079427.0,27,257,9.518518518518519,3,12,4,23
31080587.0,31,277,8.935483870967742,3,11,3,28
31082746.0,140,1342,9.585714285714285,3,13,11,129
31084151.0,33,229,6.9393939393939394,6,9,23,10
31084205.0,126,262,2.0793650793650795,1,4,126,0
31084530.0,88,179,2.034090909090909,1,4,88,0
31086541.0,336,3287,9.782738095238095,2,12,13,323
31096178.0,10,34,3.4,2,5,10,0
31102252.0,44,360,8.181818181818182,6,10,13,31
31108830.0,75,152,2.026666666666667,1,5,75,0
31111098.0,318,3081,9.68867924528302,2,12,21,297
31114135.0,26,63,2.423076923076923,1,4,26,0
31115421.0,295,2002,6.786440677966102,2,10,214,81
31115906.0,203,1417,6.980295566502463,2,10,143,60
31116055.0,200,429,2.145,1,5,200,0
31116159.0,274,589,2.1496350364963503,1,5,274,0
31119930.0,230,917,3.9869565217391303,2,7,230,0
31124671.0,15,20,1.3333333333333333,1,3,15,0
31132507.0,7,23,3.2857142857142856,3,4,7,0
31137348.0,281,1638,5.829181494661921,2,8,271,10
31139423.0,8,38,4.75,4,6,8,0
31141654.0,250,482,1.928,1,5,250,0
31141987.0,114,558,4.894736842105263,2,7,114,0
31147472.0,12,63,5.25,3,7,12,0
31157447.0,2,5,2.5,2,3,2,0
31160607.0,311,651,2.0932475884244375,1,5,311,0
31164846.0,301,621,2.0631229235880397,1,4,301,0
31164847.0,299,637,2.130434782608696,1,6,299,0
31164848.0,326,676,2.0736196319018405,1,5,326,0
31166704.0,129,374,2.89922480620155,1,5,129,0
31166920.0,39,119,3.051282051282051,1,5,39,0
31180712.0,137,668,4.875912408759124,2,7,137,0
31180902.0,179,1726,9.64245810055866,2,12,12,167
31187151.0,300,2900,9.666666666666666,2,14,20,280
31195855.0,249,733,2.9437751004016066,1,6,249,0
31199127.0,152,1432,9.421052631578947,2,12,12,140
31205844.0,38,117,3.0789473684210527,1,7,38,0
31214955.0,107,198,1.8504672897196262,1,4,107,0
31219023.0,218,1063,4.876146788990826,2,8,217,1
31224544.0,81,786,9.703703703703704,5,13,2,79
31229045.0,165,816,4.945454545454545,2,8,163,2
31233743.0,23,53,2.3043478260869565,1,4,23,0
31246748.0,88,260,2.9545454545454546,1,5,88,0
31248415.0,107,433,4.046728971962617,2,6,107,0
31253955.0,37,81,2.189189189189189,1,4,37,0
31254199.0,26,61,2.3461538461538463,1,5,26,0
31254291.0,65,191,2.9384615384615387,1,6,65,0
31254294.0,41,87,2.1219512195121952,1,4,41,0
31254300.0,19,36,1.894736842105263,1,4,19,0
31272151.0,17,157,9.235294117647058,2,12,2,15
31272786.0,141,1112,7.886524822695035,2,10,45,96
31273010.0,27,266,9.851851851851851,6,11,1,26
31274212.0,127,624,4.913385826771654,2,8,125,2
31275179.0,227,1145,5.044052863436123,2,8,226,1
31278140.0,296,616,2.081081081081081,1,5,296,0
31279955.0,82,652,7.951219512195122,2,11,25,57
31290063.0,283,2464,8.706713780918728,3,12,32,251
31290141.0,104,415,3.9903846153846154,1,6,104,0
31292221.0,7,16,2.2857142857142856,1,3,7,0
31299764.0,321,671,2.0903426791277258,1,5,321,0
31299765.0,272,563,2.0698529411764706,1,5,272,0
31299766.0,270,550,2.037037037037037,1,5,270,0
31299769.0,282,601,2.131205673758865,1,5,282,0
31300825.0,95,912,9.6,2,12,5,90
31301233.0,40,396,9.9,8,12,0,40
31302201.0,285,1413,4.957894736842105,2,8,284,1
31312574.0,69,148,2.1449275362318843,1,4,69,0
31328568.0,165,1609,9.751515151515152,3,13,8,157
31328881.0,1,3,3.0,3,3,1,0
31331929.0,48,245,5.104166666666667,3,8,47,1
31355685.0,140,688,4.914285714285715,3,7,140,0
31355945.0,3,12,4.0,3,5,3,0
31368629.0,89,861,9.674157303370787,2,12,6,83
31370797.0,12,24,2.0,1,3,12,0
31371214.0,9,28,3.111111111111111,1,5,9,0
31378106.0,300,611,2.0366666666666666,1,4,300,0
31385105.0,324,3123,9.63888888888889,2,12,21,303
31385165.0,47,334,7.1063829787234045,5,9,28,19
31395218.0,324,672,2.074074074074074,1,5,324,0
31395926.0,1,2,2.0,2,2,1,0
31397885.0,4,9,2.25,2,3,4,0
31402925.0,40,263,6.575,2,10,32,8
31405685.0,10,20,2.0,1,4,10,0
31415776.0,93,373,4.010752688172043,1,6,93,0
31425429.0,99,492,4.96969696969697,3,8,98,1
31426123.0,156,307,1.9679487179487178,1,4,156,0
31426937.0,284,580,2.0422535211267605,1,5,284,0
31426964.0,285,575,2.017543859649123,1,4,285,0
31426965.0,270,567,2.1,1,4,270,0
31431634.0,299,605,2.0234113712374584,1,5,299,0
31431636.0,296,610,2.060810810810811,1,5,296,0
31431637.0,285,560,1.9649122807017543,1,5,285,0
31431638.0,296,624,2.108108108108108,1,5,296,0
31432644.0,104,817,7.855769230769231,2,11,31,73
31433212.0,74,373,5.04054054054054,3,7,74,0
31435497.0,34,243,7.147058823529412,4,9,22,12
31450371.0,369,512,1.3875338753387534,1,4,369,0
31454392.0,265,1817,6.856603773584905,2,10,192,73
31454840.0,92,459,4.989130434782608,2,7,92,0
31455674.0,138,1337,9.68840579710145,2,13,9,129
31463952.0,1,3,3.0,3,3,1,0
31465584.0,10,37,3.7,2,5,10,0
31477860.0,146,743,5.089041095890411,3,7,146,0
31477870.0,17,34,2.0,1,3,17,0
31479573.0,78,101,1.294871794871795,1,3,78,0
31482659.0,228,1108,4.859649122807017,2,7,228,0
31482685.0,94,385,4.095744680851064,2,7,94,0
31482838.0,288,847,2.9409722222222223,1,5,288,0
31483156.0,157,1074,6.840764331210191,2,9,112,45
31486255.0,143,699,4.888111888111888,2,7,143,0
31502704.0,354,3457,9.765536723163843,2,13,23,331
31505010.0,270,1073,3.974074074074074,1,7,270,0
31505704.0,56,161,2.875,1,5,56,0
31509474.0,323,468,1.4489164086687307,1,5,323,0
31509785.0,257,351,1.3657587548638133,1,4,257,0
31509913.0,209,281,1.3444976076555024,1,4,209,0
31514998.0,4,25,6.25,6,7,4,0
31535174.0,415,2030,4.891566265060241,2,8,414,1
31538902.0,87,95,1.0919540229885059,1,3,87,0
31539295.0,1,5,5.0,5,5,1,0
31546953.0,421,2076,4.931116389548694,2,8,420,1
31558430.0,185,915,4.945945945945946,2,8,182,3
31558633.0,129,262,2.0310077519379846,1,5,129,0
31558756.0,370,1831,4.948648648648649,2,8,368,2
31558982.0,328,449,1.3689024390243902,1,4,328,0
31559298.0,114,348,3.0526315789473686,1,5,114,0
31559314.0,3,4,1.3333333333333333,1,2,3,0
31560654.0,344,466,1.3546511627906976,1,4,344,0
31560695.0,223,1104,4.95067264573991,2,8,222,1
31560802.0,179,258,1.441340782122905,1,4,179,0
31560982.0,349,472,1.3524355300859598,1,3,349,0
31561260.0,287,385,1.3414634146341464,1,3,287,0
31563379.0,266,529,1.9887218045112782,1,5,266,0
31564129.0,36,351,9.75,5,13,3,33
31564606.0,22,173,7.863636363636363,2,10,8,14
31564704.0,11,33,3.0,1,5,11,0
31577909.0,25,124,4.96,3,7,25,0
31579349.0,12,22,1.8333333333333333,1,4,12,0
31580242.0,44,62,1.4090909090909092,1,4,44,0
31581833.0,4,24,6.0,4,7,4,0
31586177.0,23,44,1.9130434782608696,1,4,23,0
31591994.0,191,560,2.931937172774869,1,6,191,0
31593508.0,15,59,3.933333333333333,2,5,15,0
31594484.0,34,60,1.7647058823529411,1,4,34,0
31605573.0,18,35,1.9444444444444444,1,3,18,0
31605653.0,128,264,2.0625,1,5,128,0
31606052.0,110,210,1.9090909090909092,1,4,110,0
31606140.0,52,102,1.9615384615384615,1,4,52,0
31606181.0,37,78,2.108108108108108,1,4,37,0
31608783.0,77,749,9.727272727272727,3,13,4,73
31610133.0,237,1654,6.9789029535864975,2,10,159,78
31614341.0,284,2765,9.735915492957746,2,13,18,266
31620720.0,36,309,8.583333333333334,4,10,5,31
31625499.0,323,2222,6.879256965944273,2,10,231,92
31631356.0,2,10,5.0,3,7,2,0
31634050.0,53,201,3.792452830188679,2,5,53,0
31634065.0,77,294,3.8181818181818183,1,6,77,0
31634086.0,89,329,3.696629213483146,2,6,89,0
31634102.0,41,162,3.951219512195122,1,6,41,0
31634121.0,26,98,3.769230769230769,2,5,26,0
31636256.0,96,475,4.947916666666667,2,8,93,3
31636293.0,164,799,4.871951219512195,2,7,164,0
31636317.0,22,109,4.954545454545454,3,7,22,0
31639638.0,3,10,3.3333333333333335,3,4,3,0
31641039.0,33,77,2.3333333333333335,1,4,33,0
31641075.0,58,127,2.189655172413793,1,4,58,0
31641111.0,50,98,1.96,1,5,50,0
31641127.0,72,140,1.9444444444444444,1,5,72,0
31641175.0,39,72,1.8461538461538463,1,4,39,0
31641205.0,99,216,2.1818181818181817,1,5,99,0
31641245.0,16,34,2.125,1,4,16,0
31641276.0,21,51,2.4285714285714284,1,4,21,0
31641468.0,105,239,2.276190476190476,1,5,105,0
31641499.0,130,262,2.0153846153846153,1,4,130,0
31641556.0,82,174,2.1219512195121952,1,5,82,0
31641587.0,10,23,2.3,1,4,10,0
31641619.0,5,14,2.8,2,4,5,0
31647996.0,6,38,6.333333333333333,5,7,6,0
31659379.0,15,34,2.2666666666666666,1,4,15,0
31659491.0,72,145,2.013888888888889,1,4,72,0
31659925.0,225,1111,4.937777777777778,2,9,223,2
31660571.0,42,124,2.9523809523809526,1,5,42,0
31662916.0,296,1463,4.9425675675675675,2,8,295,1
31665979.0,47,181,3.851063829787234,2,6,47,0
31666033.0,10,47,4.7,4,6,10,0
31666053.0,79,402,5.0886075949367084,3,7,79,0
31667952.0,6,57,9.5,8,10,0,6
31672518.0,21,189,9.0,7,11,2,19
31685274.0,82,167,2.0365853658536586,1,5,82,0
31688364.0,142,297,2.091549295774648,1,4,142,0
31690847.0,18,58,3.2222222222222223,1,6,18,0
31694475.0,3,7,2.3333333333333335,2,3,3,0
31705944.0,235,1118,4.757446808510639,1,8,234,1
31709777.0,11,72,6.545454545454546,4,8,9,2
31716236.0,31,266,8.580645161290322,3,11,5,26
31717467.0,46,89,1.934782608695652,1,4,46,0
31733824.0,48,370,7.708333333333333,3,10,19,29
31740352.0,27,54,2.0,1,4,27,0
31774050.0,94,462,4.914893617021277,2,7,94,0
31775212.0,376,1900,5.053191489361702,2,8,374,2
31795308.0,60,118,1.9666666666666666,1,4,60,0
31801704.0,4,5,1.25,1,2,4,0
31801770.0,112,756,6.75,2,10,83,29
31801902.0,8,12,1.5,1,2,8,0
31807291.0,141,829,5.879432624113475,2,10,132,9
31813160.0,201,803,3.9950248756218905,1,7,201,0
31816052.0,63,439,6.968253968253968,4,9,43,20
31817789.0,2,4,2.0,2,2,2,0
31820104.0,2,15,7.5,7,8,1,1
31820135.0,41,314,7.658536585365853,3,10,17,24
31823249.0,1,4,4.0,4,4,1,0
31826201.0,20,63,3.15,1,5,20,0
31845600.0,316,635,2.009493670886076,1,5,316,0
31845882.0,251,488,1.9442231075697212,1,5,251,0
31846151.0,294,2584,8.789115646258503,2,12,27,267
31847180.0,16,118,7.375,6,9,9,7
31847373.0,102,304,2.980392156862745,1,6,102,0
31848146.0,26,52,2.0,1,4,26,0
31850427.0,12,108,9.0,8,11,0,12
31852595.0,101,303,3.0,1,6,101,0
31855938.0,65,257,3.953846153846154,2,6,65,0
31856481.0,3,4,1.3333333333333333,1,2,3,0
31868402.0,31,280,9.03225806451613,5,11,3,28
31870605.0,21,45,2.142857142857143,1,3,21,0
31871973.0,2,4,2.0,2,2,2,0
31872857.0,21,61,2.9047619047619047,1,5,21,0
31873841.0,114,453,3.973684210526316,1,7,114,0
31875498.0,63,425,6.746031746031746,2,10,46,17
31876366.0,242,2298,9.49586776859504,2,13,20,222
31877657.0,79,766,9.69620253164557,4,12,5,74
31890838.0,404,3855,9.542079207920793,2,13,32,372
31890931.0,1,3,3.0,3,3,1,0
31891695.0,14,114,8.142857142857142,6,10,4,10
31894940.0,496,1018,2.0524193548387095,1,5,496,0
31897573.0,2,6,3.0,3,3,2,0
31916507.0,12,36,3.0,2,4,12,0
31921920.0,11,17,1.5454545454545454,1,4,11,0
31922250.0,8,10,1.25,1,2,8,0
31923146.0,271,2380,8.782287822878228,2,12,29,242
31929230.0,96,575,5.989583333333333,2,9,88,8
31929550.0,112,676,6.035714285714286,4,9,106,6
31930015.0,118,718,6.084745762711864,2,8,105,13
31943647.0,188,1816,9.659574468085106,2,12,11,177
31954947.0,324,683,2.1080246913580245,1,5,324,0
31958726.0,48,327,6.8125,5,9,38,10
31967105.0,51,106,2.0784313725490198,1,4,51,0
31977943.0,355,2824,7.954929577464789,2,11,113,242
31981157.0,81,179,2.2098765432098766,1,5,81,0
31982837.0,194,1704,8.783505154639176,2,12,22,172
31983597.0,171,376,2.198830409356725,1,5,171,0
31984491.0,25,208,8.32,2,10,3,22
31984985.0,39,87,2.230769230769231,1,4,39,0
31985529.0,24,175,7.291666666666667,5,10,13,11
31998345.0,209,2052,9.818181818181818,2,13,10,199
32001644.0,27,207,7.666666666666667,4,10,12,15
32002225.0,48,336,7.0,2,9,30,18
32002758.0,6,11,1.8333333333333333,1,3,6,0
32005108.0,205,1990,9.707317073170731,2,13,13,192
32005782.0,248,2419,9.754032258064516,3,13,15,233
32011891.0,107,520,4.859813084112149,3,7,107,0
32011956.0,151,314,2.0794701986754967,1,5,151,0
32012177.0,6,9,1.5,1,2,6,0
32012492.0,74,514,6.945945945945946,2,9,48,26
32016526.0,20,143,7.15,6,9,14,6
32017580.0,154,877,5.694805194805195,2,8,144,10
32017857.0,80,468,5.85,3,8,78,2
32019760.0,71,202,2.8450704225352115,1,5,71,0
32030804.0,91,605,6.648351648351649,2,10,69,22
32031513.0,206,983,4.771844660194175,2,7,206,0
32034540.0,240,1204,5.016666666666667,2,8,239,1
32035214.0,5,7,1.4,1,2,5,0
32040485.0,148,1163,7.858108108108108,3,10,45,103
32040793.0,132,1026,7.7727272727272725,2,12,48,84
32052101.0,161,1529,9.496894409937887,2,12,11,150
32060229.0,74,228,3.081081081081081,1,7,74,0
32060527.0,24,56,2.3333333333333335,1,4,24,0
32060927.0,78,447,5.730769230769231,2,8,75,3
32075608.0,82,185,2.2560975609756095,1,5,82,0
32079296.0,74,512,6.918918918918919,2,9,47,27
32083132.0,340,1662,4.8882352941176475,2,8,338,2
32084720.0,424,2110,4.976415094339623,2,8,422,2
32084978.0,227,1960,8.634361233480176,2,12,30,197
32096557.0,65,320,4.923076923076923,2,7,65,0
32096721.0,14,20,1.4285714285714286,1,3,14,0
32106606.0,24,73,3.0416666666666665,1,5,24,0
32109275.0,56,482,8.607142857142858,2,11,8,48
32113299.0,25,76,3.04,1,6,25,0
32119504.0,1,4,4.0,4,4,1,0
32120589.0,2,4,2.0,2,2,2,0
32120785.0,3,7,2.3333333333333335,1,3,3,0
32121856.0,60,416,6.933333333333334,4,9,42,18
32122730.0,3,20,6.666666666666667,6,7,3,0
32123252.0,54,112,2.074074074074074,1,5,54,0
32123511.0,1,5,5.0,5,5,1,0
32123521.0,59,407,6.898305084745763,3,10,43,16
32123717.0,2,7,3.5,3,4,2,0
32123912.0,1,1,1.0,1,1,1,0
32124103.0,9,27,3.0,2,4,9,0
32124233.0,2,8,4.0,3,5,2,0
32127098.0,13,93,7.153846153846154,4,10,8,5
32131838.0,201,427,2.1243781094527363,1,5,201,0
32133730.0,330,2879,8.724242424242425,2,12,47,283
32138832.0,10,19,1.9,1,3,10,0
32150306.0,11,18,1.6363636363636365,1,3,11,0
32151585.0,31,71,2.2903225806451615,1,4,31,0
32155948.0,71,210,2.9577464788732395,1,6,71,0
32157686.0,152,743,4.8881578947368425,2,8,151,1
32159120.0,2,3,1.5,1,2,2,0
32160036.0,411,867,2.1094890510948905,1,5,411,0
32167076.0,83,157,1.891566265060241,1,4,83,0
32174029.0,103,211,2.0485436893203883,1,5,103,0
32174979.0,413,3179,7.697336561743342,2,11,147,266
32176448.0,52,116,2.230769230769231,1,4,52,0
32181969.0,281,1115,3.9679715302491103,1,7,281,0
32183804.0,71,337,4.746478873239437,2,7,71,0
32183809.0,183,1776,9.704918032786885,2,13,9,174
32185693.0,22,178,8.090909090909092,6,10,6,16
32200153.0,43,94,2.186046511627907,1,4,43,0
32203745.0,29,222,7.655172413793103,2,10,9,20
32203833.0,7,12,1.7142857142857142,1,3,7,0
32207692.0,462,934,2.0216450216450217,1,5,462,0
32210710.0,122,1179,9.663934426229508,3,12,7,115
32226813.0,1,9,9.0,9,9,0,1
32229006.0,64,319,4.984375,3,7,64,0
32249677.0,44,166,3.772727272727273,2,7,44,0
32253828.0,49,360,7.346938775510204,2,10,20,29
32269156.0,205,1417,6.912195121951219,2,10,133,72
32277204.0,278,1380,4.9640287769784175,2,8,275,3
32280369.0,133,278,2.0902255639097747,1,5,133,0
32288131.0,16,123,7.6875,5,9,7,9
32288177.0,562,1159,2.0622775800711746,1,5,562,0
32299248.0,47,148,3.148936170212766,1,6,47,0
32301151.0,8,54,6.75,6,8,6,2
32305083.0,58,182,3.1379310344827585,1,6,58,0
32306195.0,118,242,2.0508474576271185,1,5,118,0
32309549.0,150,748,4.986666666666666,2,8,148,2
32312609.0,210,2036,9.695238095238095,2,13,15,195
32325527.0,16,117,7.3125,5,9,6,10
32329922.0,21,84,4.0,1,7,21,0
32331487.0,117,587,5.017094017094017,2,7,117,0
32334205.0,142,698,4.915492957746479,2,7,142,0
32336227.0,199,1337,6.71859296482412,2,10,151,48
32336589.0,94,461,4.904255319148936,2,8,93,1
32337810.0,129,270,2.0930232558139537,1,5,129,0
32345229.0,16,82,5.125,3,7,16,0
32348740.0,125,625,5.0,2,8,123,2
32353232.0,115,1109,9.643478260869566,2,13,7,108
32356399.0,4,9,2.25,1,3,4,0
32357176.0,34,172,5.0588235294117645,3,7,34,0
32360679.0,110,254,2.309090909090909,1,6,110,0
32374255.0,132,265,2.007575757575758,1,5,132,0
32376351.0,14,31,2.2142857142857144,1,4,14,0
32376471.0,281,838,2.98220640569395,1,6,281,0
32393154.0,86,655,7.616279069767442,2,11,33,53
32395622.0,207,1781,8.603864734299517,2,13,27,180
32396574.0,134,392,2.925373134328358,1,6,134,0
32397207.0,47,330,7.0212765957446805,5,9,31,16
32402930.0,87,192,2.206896551724138,1,5,87,0
32402933.0,60,123,2.05,1,4,60,0
32406953.0,105,219,2.085714285714286,1,4,105,0
32410299.0,49,385,7.857142857142857,3,10,19,30
32411926.0,11,36,3.272727272727273,2,5,11,0
32413731.0,108,741,6.861111111111111,2,9,76,32
32414144.0,62,299,4.82258064516129,2,7,62,0
32414198.0,94,277,2.9468085106382977,1,5,94,0
32414685.0,142,297,2.091549295774648,1,5,142,0
32417293.0,77,457,5.935064935064935,3,8,74,3
32432265.0,20,201,10.05,9,13,0,20
32432931.0,47,225,4.787234042553192,2,8,46,1
32442838.0,407,3943,9.687960687960688,2,13,23,384
32453235.0,21,31,1.4761904761904763,1,3,21,0
32461290.0,166,343,2.066265060240964,1,5,166,0
32463338.0,32,68,2.125,1,3,32,0
32466881.0,129,1241,9.62015503875969,2,13,12,117
32472418.0,175,1684,9.622857142857143,2,13,10,165
32481470.0,8,10,1.25,1,2,8,0
32482765.0,32,259,8.09375,2,11,9,23
32482845.0,92,726,7.891304347826087,5,11,34,58
32485016.0,9,28,3.111111111111111,2,5,9,0
32485027.0,182,1743,9.576923076923077,2,13,15,167
32497056.0,11,21,1.9090909090909092,1,4,11,0
32510952.0,1,3,3.0,3,3,1,0
32511729.0,206,443,2.150485436893204,1,5,206,0
32512782.0,101,304,3.00990099009901,1,5,101,0
32513538.0,49,478,9.755102040816327,7,11,1,48
32513575.0,31,281,9.064516129032258,8,11,0,31
32516459.0,313,662,2.1150159744408947,1,5,313,0
32518486.0,117,233,1.9914529914529915,1,5,117,0
32518907.0,15,16,1.0666666666666667,1,2,15,0
32520356.0,62,127,2.0483870967741935,1,4,62,0
32522543.0,11,13,1.1818181818181819,1,2,11,0
32522584.0,21,162,7.714285714285714,7,9,10,11
32524733.0,250,2413,9.652,2,13,18,232
32525605.0,116,788,6.793103448275862,4,10,86,30
32531313.0,53,266,5.018867924528302,2,7,53,0
32534674.0,86,184,2.13953488372093,1,4,86,0
32546500.0,6,13,2.1666666666666665,1,3,6,0
32547649.0,89,410,4.606741573033708,2,8,88,1
32550212.0,319,1549,4.855799373040752,2,8,317,2
32563725.0,5,17,3.4,2,4,5,0
32568095.0,155,766,4.941935483870968,2,8,154,1
32579674.0,15,154,10.266666666666667,8,12,0,15
32582408.0,98,587,5.989795918367347,2,8,92,6
32585157.0,228,692,3.0350877192982457,1,5,228,0
32587708.0,4,19,4.75,4,6,4,0
32589761.0,46,89,1.934782608695652,1,4,46,0
32592749.0,167,1128,6.754491017964072,2,9,125,42
32606898.0,20,28,1.4,1,3,20,0
32607883.0,219,449,2.050228310502283,1,5,219,0
32609102.0,113,569,5.035398230088496,3,8,112,1
32611348.0,35,201,5.742857142857143,3,8,33,2
32628197.0,107,943,8.813084112149532,3,11,11,96
32631109.0,214,440,2.05607476635514,1,4,214,0
32634089.0,235,331,1.4085106382978723,1,5,235,0
32635665.0,41,80,1.951219512195122,1,4,41,0
32636144.0,1,2,2.0,2,2,1,0
32649434.0,223,303,1.358744394618834,1,3,223,0
32649496.0,8,43,5.375,4,7,8,0
32649552.0,262,361,1.3778625954198473,1,3,262,0
32649762.0,150,1486,9.906666666666666,6,14,3,147
32649918.0,278,373,1.341726618705036,1,4,278,0
32650034.0,249,349,1.4016064257028114,1,3,249,0
32650458.0,215,294,1.3674418604651162,1,4,215,0
32650553.0,327,454,1.3883792048929664,1,4,327,0
32653090.0,39,195,5.0,3,7,39,0
32657988.0,22,44,2.0,1,3,22,0
32663763.0,183,903,4.934426229508197,2,7,183,0
32663867.0,273,1862,6.82051282051282,2,10,199,74
32666185.0,311,1233,3.964630225080386,1,7,311,0
32676418.0,22,177,8.045454545454545,6,10,6,16
32677196.0,186,1813,9.74731182795699,3,12,9,177
32677321.0,8,54,6.75,5,9,6,2
32677573.0,282,1410,5.0,2,8,281,1
32681946.0,8,65,8.125,7,9,1,7
32686280.0,9,60,6.666666666666667,2,8,6,3
32693367.0,118,246,2.0847457627118646,1,5,118,0
32696671.0,72,132,1.8333333333333333,1,4,72,0
32706564.0,10,17,1.7,1,4,10,0
32706567.0,6,8,1.3333333333333333,1,2,6,0
32707895.0,1,4,4.0,4,4,1,0
32708796.0,201,1962,9.761194029850746,2,13,8,193
32714968.0,21,47,2.238095238095238,1,3,21,0
32730333.0,158,320,2.0253164556962027,1,4,158,0
32735001.0,182,873,4.7967032967032965,2,8,181,1
32738774.0,181,885,4.889502762430939,2,8,180,1
32744430.0,462,3105,6.720779220779221,2,10,339,123
32754242.0,64,442,6.90625,2,9,46,18
32759628.0,320,2243,7.009375,2,10,199,121
32764783.0,62,539,8.693548387096774,2,11,8,54
32768596.0,79,396,5.012658227848101,2,7,79,0
32797246.0,255,2020,7.921568627450981,4,11,80,175
32802184.0,232,1354,5.836206896551724,2,9,217,15
32802493.0,235,1390,5.914893617021277,2,9,214,21
32808028.0,152,315,2.0723684210526314,1,4,152,0
32811122.0,303,2937,9.693069306930694,2,13,21,282
32814756.0,372,1814,4.876344086021505,2,8,370,2
32823090.0,8,79,9.875,8,11,0,8
32826430.0,14,89,6.357142857142857,5,7,14,0
32829020.0,190,1867,9.826315789473684,2,13,6,184
32830297.0,67,199,2.970149253731343,1,6,67,0
32831148.0,28,221,7.892857142857143,2,11,8,20
32832202.0,155,765,4.935483870967742,2,7,155,0
32838886.0,97,209,2.154639175257732,1,5,97,0
32839328.0,32,67,2.09375,1,4,32,0
32839950.0,161,1110,6.894409937888199,2,9,113,48
32840421.0,295,623,2.111864406779661,1,5,295,0
32841822.0,56,493,8.803571428571429,4,12,5,51
32852581.0,46,363,7.891304347826087,4,11,19,27
32854726.0,69,142,2.0579710144927534,1,4,69,0
32858556.0,260,1036,3.9846153846153847,2,7,260,0
32862088.0,126,271,2.1507936507936507,1,4,126,0
32877064.0,20,149,7.45,5,10,11,9
32880197.0,136,674,4.955882352941177,2,7,136,0
32883897.0,6,41,6.833333333333333,6,8,5,1
32886235.0,39,80,2.051282051282051,1,5,39,0
32888351.0,219,651,2.9726027397260273,1,5,219,0
32892473.0,123,857,6.967479674796748,2,9,83,40
32894636.0,51,158,3.0980392156862746,1,6,51,0
32895763.0,1,4,4.0,4,4,1,0
32898631.0,54,80,1.4814814814814814,1,4,54,0
32904842.0,39,280,7.17948717948718,4,10,25,14
32906611.0,88,338,3.840909090909091,1,7,88,0
32919757.0,65,258,3.9692307692307693,2,6,65,0
32929381.0,201,390,1.9402985074626866,1,5,201,0
32929468.0,65,101,1.5538461538461539,1,4,65,0
32929872.0,4,16,4.0,4,4,4,0
32930083.0,1,4,4.0,4,4,1,0
32935156.0,12,24,2.0,1,5,12,0
32947994.0,60,241,4.016666666666667,1,6,60,0
32949239.0,286,584,2.041958041958042,1,5,286,0
32949914.0,252,990,3.9285714285714284,1,7,252,0
32952035.0,39,86,2.2051282051282053,1,4,39,0
32959556.0,93,729,7.838709677419355,2,10,32,61
32962478.0,103,420,4.077669902912621,1,6,103,0
32972704.0,59,172,2.9152542372881354,1,5,59,0
32972819.0,298,2058,6.906040268456376,2,10,213,85
32978360.0,163,352,2.1595092024539877,1,5,163,0
32979174.0,82,172,2.097560975609756,1,6,82,0
32979635.0,216,416,1.9259259259259258,1,5,216,0
32983117.0,138,671,4.86231884057971,2,9,137,1
32998177.0,52,445,8.557692307692308,2,11,9,43
33002415.0,3,5,1.6666666666666667,1,2,3,0
33002419.0,210,1259,5.995238095238095,2,10,194,16
33003460.0,299,2611,8.732441471571907,2,12,50,249
33005257.0,50,99,1.98,1,4,50,0
33006350.0,4,6,1.5,1,2,4,0
33010416.0,332,1621,4.882530120481928,2,8,330,2
33011170.0,48,104,2.1666666666666665,1,4,48,0
33013896.0,116,474,4.086206896551724,1,6,116,0
33015208.0,180,388,2.1555555555555554,1,5,180,0
33018544.0,25,226,9.04,2,12,4,21
33018721.0,329,2272,6.905775075987842,2,10,215,114
33029336.0,160,339,2.11875,1,5,160,0
33031271.0,30,120,4.0,2,7,30,0
33040219.0,26,209,8.038461538461538,5,10,6,20
33042208.0,279,1900,6.810035842293907,2,10,198,81
33062412.0,299,2069,6.919732441471572,2,10,201,98
33071039.0,47,230,4.8936170212765955,2,7,47,0
33071601.0,23,125,5.434782608695652,4,7,23,0
33072057.0,10,48,4.8,3,7,10,0
33072369.0,5,27,5.4,5,6,5,0
33083330.0,51,355,6.96078431372549,3,9,35,16
33085069.0,306,1530,5.0,2,8,303,3
33087403.0,169,340,2.0118343195266273,1,5,169,0
33092354.0,67,661,9.865671641791044,6,12,3,64
33096423.0,19,126,6.631578947368421,3,8,13,6
33096812.0,386,1540,3.989637305699482,1,7,386,0
33124938.0,2,7,3.5,3,4,2,0
33130357.0,4,10,2.5,1,4,4,0
33131028.0,6,14,2.3333333333333335,2,3,6,0
33133598.0,12,41,3.4166666666666665,3,4,12,0
33133767.0,7,18,2.5714285714285716,1,4,7,0
33134101.0,9,23,2.5555555555555554,1,3,9,0
33134229.0,5,51,10.2,9,11,0,5
33134411.0,16,142,8.875,2,12,3,13
33145944.0,59,396,6.711864406779661,2,10,46,13
33147521.0,313,1534,4.900958466453674,1,7,313,0
33148358.0,364,3460,9.505494505494505,2,13,24,340
33148762.0,5,14,2.8,2,4,5,0
33150113.0,60,284,4.733333333333333,2,6,60,0
33151818.0,81,776,9.580246913580247,4,13,3,78
33152222.0,197,1887,9.578680203045685,2,13,15,182
33152512.0,138,1324,9.594202898550725,2,13,8,130
33152755.0,214,2050,9.57943925233645,2,13,14,200
33153675.0,355,1729,4.870422535211268,2,8,354,1
33156034.0,38,291,7.657894736842105,4,10,19,19
33163418.0,4,14,3.5,2,5,4,0
33173113.0,8,12,1.5,1,3,8,0
33174673.0,297,2866,9.64983164983165,2,13,17,280
33179520.0,121,502,4.148760330578512,2,6,121,0
33179688.0,4,5,1.25,1,2,4,0
33180649.0,166,802,4.831325301204819,2,8,165,1
33188407.0,5,17,3.4,3,4,5,0
33193010.0,65,444,6.8307692307692305,2,9,49,16
33204060.0,53,323,6.09433962264151,2,8,49,4
33204699.0,250,1239,4.956,2,8,248,2
33207485.0,221,1550,7.013574660633484,3,10,150,71
33209105.0,241,2315,9.605809128630705,2,13,16,225
33215168.0,13,23,1.7692307692307692,1,3,13,0
33216190.0,291,1443,4.958762886597938,2,8,288,3
33218434.0,2,6,3.0,2,4,2,0
33218890.0,6,23,3.8333333333333335,2,5,6,0
33219107.0,161,338,2.099378881987578,1,5,161,0
33219972.0,41,89,2.1707317073170733,1,4,41,0
33220972.0,349,3349,9.595988538681949,2,13,25,324
33223592.0,11,13,1.1818181818181819,1,2,11,0
33224318.0,16,17,1.0625,1,2,16,0
33226350.0,58,162,2.793103448275862,1,5,58,0
33233083.0,113,548,4.849557522123894,2,7,113,0
33233842.0,158,338,2.1392405063291138,1,6,158,0
33236195.0,3,22,7.333333333333333,7,8,2,1
33237776.0,181,882,4.87292817679558,2,8,180,1
33258974.0,41,202,4.926829268292683,3,7,41,0
33259337.0,3,3,1.0,1,1,3,0
33259628.0,263,517,1.9657794676806084,1,4,263,0
33259933.0,15,121,8.066666666666666,7,9,2,13
33266020.0,2,4,2.0,2,2,2,0
33266798.0,25,82,3.28,1,5,25,0
33281038.0,153,1500,9.803921568627452,2,13,7,146
33281969.0,164,1589,9.689024390243903,2,12,7,157
33282807.0,44,222,5.045454545454546,2,7,44,0
33284369.0,69,351,5.086956521739131,3,7,69,0
33286160.0,40,65,1.625,1,3,40,0
33287123.0,87,835,9.597701149425287,2,13,7,80
33287794.0,31,187,6.032258064516129,4,8,28,3
33302178.0,55,315,5.7272727272727275,2,8,51,4
33302311.0,113,554,4.902654867256637,2,7,113,0
33311625.0,196,1498,7.642857142857143,2,10,70,126
33311665.0,53,352,6.6415094339622645,2,9,39,14
33326044.0,139,680,4.892086330935252,2,8,137,2
33330590.0,1,4,4.0,4,4,1,0
33338634.0,20,151,7.55,6,9,8,12
33345814.0,568,3827,6.737676056338028,2,10,419,149
33356801.0,34,70,2.0588235294117645,1,4,34,0
33358273.0,185,380,2.054054054054054,1,4,185,0
33372756.0,180,1222,6.788888888888889,2,11,134,46
33381431.0,158,344,2.1772151898734178,1,5,158,0
33383647.0,28,196,7.0,2,9,16,12
33389179.0,156,776,4.9743589743589745,2,8,155,1
33389189.0,61,248,4.065573770491803,2,7,61,0
33391877.0,306,2984,9.751633986928105,2,13,15,291
33392539.0,175,691,3.9485714285714284,1,6,175,0
33394636.0,309,1519,4.915857605177994,2,8,308,1
33395090.0,118,1038,8.796610169491526,2,11,15,103
33395490.0,230,1576,6.852173913043479,2,9,159,71
33396369.0,354,1775,5.0141242937853105,2,8,353,1
33396807.0,433,2162,4.993071593533488,2,8,426,7
33397194.0,345,1657,4.802898550724637,2,8,342,3
33398841.0,5,8,1.6,1,2,5,0
33409248.0,88,424,4.818181818181818,2,6,88,0
33416413.0,7,21,3.0,1,4,7,0
33418608.0,50,352,7.04,4,9,32,18
33419570.0,277,2446,8.830324909747292,2,12,34,243
33420473.0,19,140,7.368421052631579,2,9,6,13
33422034.0,309,2351,7.608414239482201,2,11,130,179
33423009.0,123,259,2.105691056910569,1,5,123,0
33423467.0,155,1197,7.72258064516129,2,10,52,103
33424015.0,44,220,5.0,3,7,44,0
33424805.0,15,109,7.266666666666667,6,8,10,5
33424861.0,4,12,3.0,1,5,4,0
33426544.0,4,6,1.5,1,2,4,0
33429516.0,19,56,2.9473684210526314,1,5,19,0
33431074.0,525,3588,6.8342857142857145,2,10,384,141
33439081.0,4,8,2.0,1,3,4,0
33439920.0,2,5,2.5,2,3,2,0
33445587.0,7,17,2.4285714285714284,1,4,7,0
33446662.0,214,1066,4.981308411214953,1,7,214,0
33453204.0,4,25,6.25,5,7,4,0
33459348.0,190,964,5.073684210526316,2,9,187,3
33460641.0,40,306,7.65,2,10,13,27
33462736.0,193,1653,8.564766839378239,2,12,30,163
33467390.0,116,783,6.75,2,9,89,27
33468754.0,50,239,4.78,2,7,50,0
33470255.0,55,169,3.0727272727272728,1,5,55,0
33479343.0,4,6,1.5,1,3,4,0
33480664.0,276,1912,6.927536231884058,3,10,191,85
33480961.0,82,576,7.024390243902439,4,9,57,25
33481070.0,79,531,6.7215189873417724,2,9,61,18
33481275.0,78,624,8.0,4,10,19,59
33481838.0,120,908,7.566666666666666,2,10,43,77
33481966.0,61,442,7.245901639344262,5,9,33,28
33483889.0,183,1240,6.775956284153006,2,9,137,46
33484341.0,125,961,7.688,2,10,52,73
33485249.0,75,509,6.786666666666667,3,9,58,17
33486396.0,1,1,1.0,1,1,1,0
33491649.0,149,454,3.046979865771812,1,6,149,0
33492452.0,336,2633,7.836309523809524,2,11,116,220
33492568.0,63,251,3.984126984126984,2,8,62,1
33507487.0,196,1919,9.790816326530612,4,13,10,186
33509951.0,198,980,4.94949494949495,2,8,197,1
33512958.0,36,85,2.361111111111111,1,5,36,0
33515059.0,187,937,5.010695187165775,2,9,185,2
33517068.0,101,505,5.0,3,7,101,0
33518462.0,175,876,5.005714285714285,2,8,172,3
33519495.0,102,506,4.96078431372549,2,8,101,1
33521402.0,303,2062,6.805280528052806,2,9,223,80
33535483.0,431,3368,7.814385150812065,2,11,149,282
33537761.0,99,874,8.828282828282829,2,11,10,89
33543408.0,17,168,9.882352941176471,3,13,1,16
33544954.0,253,2464,9.73913043478261,2,13,15,238
33547303.0,176,353,2.0056818181818183,1,5,176,0
33550020.0,219,1096,5.004566210045662,3,7,219,0
33550210.0,62,304,4.903225806451613,2,7,62,0
33555124.0,35,322,9.2,2,12,4,31
33565063.0,20,101,5.05,4,7,20,0
33565942.0,387,1892,4.888888888888889,2,8,386,1
33566125.0,204,413,2.0245098039215685,1,5,204,0
33568078.0,241,345,1.4315352697095436,1,3,241,0
33569149.0,370,388,1.0486486486486486,1,3,370,0
33571341.0,57,384,6.7368421052631575,2,9,37,20
33571875.0,232,1128,4.862068965517241,2,7,232,0
33575129.0,282,2730,9.680851063829786,2,13,13,269
33575299.0,383,1872,4.8877284595300265,2,8,382,1
33575979.0,163,676,4.147239263803681,1,7,163,0
33577015.0,206,1218,5.912621359223301,2,8,199,7
33577415.0,221,447,2.02262443438914,1,5,221,0
33581524.0,38,112,2.9473684210526314,1,5,38,0
33583103.0,16,32,2.0,1,4,16,0
33586215.0,19,56,2.9473684210526314,2,5,19,0
33595046.0,45,216,4.8,1,7,45,0
33595870.0,6,9,1.5,1,3,6,0
33596988.0,4,12,3.0,2,4,4,0
33598125.0,2,6,3.0,3,3,2,0
33598437.0,72,619,8.597222222222221,2,11,11,61
33599313.0,78,690,8.846153846153847,3,12,8,70
33600136.0,8,50,6.25,3,8,6,2
33605612.0,153,1065,6.96078431372549,2,10,103,50
33607061.0,180,1745,9.694444444444445,2,13,12,168
33608367.0,103,796,7.728155339805825,2,10,32,71
33624020.0,22,160,7.2727272727272725,6,8,13,9
33624348.0,160,808,5.05,2,8,157,3
33630972.0,45,134,2.977777777777778,1,5,45,0
33634004.0,162,1560,9.62962962962963,2,13,9,153
33636471.0,238,2293,9.634453781512605,2,13,19,219
33639768.0,19,133,7.0,6,8,13,6
33646553.0,264,2551,9.662878787878787,3,13,16,248
33648861.0,219,2035,9.292237442922374,2,12,19,200
33649610.0,112,1071,9.5625,2,13,6,106
33655278.0,259,2474,9.552123552123552,2,12,16,243
33657359.0,302,2904,9.6158940397351,2,12,21,281
33658165.0,2,2,1.0,1,1,2,0
33659756.0,23,61,2.652173913043478,1,4,23,0
33668273.0,102,495,4.852941176470588,2,7,102,0
33668317.0,68,464,6.823529411764706,3,9,47,21
33671987.0,4,4,1.0,1,1,4,0
33673875.0,15,146,9.733333333333333,8,11,0,15
33675830.0,7,24,3.4285714285714284,2,5,7,0
33680474.0,16,44,2.75,1,4,16,0
33681492.0,26,126,4.846153846153846,3,7,26,0
33681550.0,22,58,2.6363636363636362,1,4,22,0
33681864.0,33,72,2.1818181818181817,1,4,33,0
33681972.0,42,330,7.857142857142857,3,11,12,30
33682006.0,14,26,1.8571428571428572,1,4,14,0
33682813.0,14,31,2.2142857142857144,1,4,14,0
33683822.0,27,233,8.62962962962963,7,11,3,24
33686014.0,22,28,1.2727272727272727,1,2,22,0
33686878.0,9,24,2.6666666666666665,1,5,9,0
33687073.0,1,1,1.0,1,1,1,0
33699654.0,158,335,2.1202531645569622,1,5,158,0
33702566.0,1,5,5.0,5,5,1,0
33703171.0,146,444,3.041095890410959,1,5,146,0
33706771.0,189,1269,6.714285714285714,2,11,141,48
33707301.0,20,100,5.0,2,7,20,0
33708702.0,82,177,2.158536585365854,1,5,82,0
33709665.0,36,73,2.0277777777777777,1,4,36,0
33710054.0,108,554,5.12962962962963,3,7,108,0
33715182.0,273,2652,9.714285714285714,2,13,16,257
33715390.0,78,391,5.012820512820513,2,7,78,0
33718630.0,342,1014,2.9649122807017543,1,6,342,0
33728612.0,401,3876,9.665835411471322,2,13,30,371
33730119.0,10,17,1.7,1,3,10,0
33730768.0,58,392,6.758620689655173,2,9,42,16
33730770.0,86,588,6.837209302325581,2,10,55,31
33731094.0,5,10,2.0,1,3,5,0
33735202.0,318,3032,9.534591194968554,2,13,23,295
33735501.0,53,264,4.981132075471698,3,7,53,0
33736696.0,236,717,3.038135593220339,1,6,236,0
33737695.0,9,41,4.555555555555555,2,6,9,0
33737762.0,30,67,2.2333333333333334,1,4,30,0
33739080.0,207,1405,6.78743961352657,2,10,151,56
33739154.0,153,1457,9.522875816993464,2,12,12,141
33742566.0,366,3534,9.655737704918034,2,13,20,346
33744896.0,129,270,2.0930232558139537,1,4,129,0
33746831.0,148,294,1.9864864864864864,1,5,148,0
33759095.0,75,208,2.7733333333333334,1,5,75,0
33761630.0,184,1060,5.760869565217392,3,9,167,17
33764094.0,117,472,4.034188034188034,1,6,117,0
33769390.0,369,3564,9.658536585365853,2,13,24,345
33772099.0,62,129,2.0806451612903225,1,4,62,0
33775442.0,125,960,7.68,3,10,51,74
33778102.0,246,1922,7.813008130081301,2,10,82,164
33778867.0,12,16,1.3333333333333333,1,3,12,0
33788629.0,148,320,2.1621621621621623,1,5,148,0
33788956.0,62,422,6.806451612903226,4,8,48,14
33793791.0,19,40,2.1052631578947367,1,4,19,0
33796162.0,59,124,2.1016949152542375,1,5,59,0
33796626.0,51,485,9.509803921568627,2,12,4,47
33797586.0,101,198,1.9603960396039604,1,4,101,0
33801693.0,1,1,1.0,1,1,1,0
33802451.0,84,444,5.285714285714286,3,8,82,2
33803851.0,152,301,1.980263157894737,1,4,152,0
33804884.0,8,12,1.5,1,2,8,0
33807961.0,25,154,6.16,5,8,23,2
33816859.0,34,105,3.088235294117647,1,5,34,0
33818689.0,275,1871,6.803636363636364,2,10,204,71
33818982.0,301,2330,7.740863787375416,2,11,108,193
33820455.0,1,2,2.0,2,2,1,0
33821799.0,3,7,2.3333333333333335,2,3,3,0
33821833.0,5,13,2.6,2,4,5,0
33825328.0,275,1350,4.909090909090909,2,8,271,4
33825351.0,13,30,2.3076923076923075,1,3,13,0
33830004.0,270,573,2.1222222222222222,1,5,270,0
33832693.0,148,1150,7.77027027027027,2,11,50,98
33834925.0,31,150,4.838709677419355,3,7,31,0
33838118.0,106,228,2.150943396226415,1,6,106,0
33840583.0,106,513,4.839622641509434,2,8,105,1
33840899.0,31,257,8.290322580645162,6,10,7,24
33841083.0,76,676,8.894736842105264,2,11,5,71
33845617.0,242,505,2.0867768595041323,1,5,242,0
33848339.0,230,2215,9.630434782608695,2,13,11,219
33854778.0,30,33,1.1,1,2,30,0
33854794.0,201,777,3.8656716417910446,1,7,201,0
33856155.0,156,760,4.871794871794871,2,8,155,1
33864688.0,5,43,8.6,8,10,0,5
33865179.0,21,65,3.0952380952380953,1,5,21,0
33865785.0,42,332,7.904761904761905,5,10,16,26
33866673.0,175,361,2.0628571428571427,1,5,175,0
33868313.0,300,1478,4.926666666666667,2,8,297,3
33873338.0,17,130,7.647058823529412,5,9,8,9
33874679.0,21,28,1.3333333333333333,1,3,21,0
33875225.0,77,158,2.051948051948052,1,5,77,0
33875467.0,2,15,7.5,6,9,1,1
33877038.0,71,704,9.915492957746478,2,13,3,68
33877142.0,1,3,3.0,3,3,1,0
33880432.0,256,2492,9.734375,2,13,12,244
33881866.0,376,1858,4.941489361702128,2,9,371,5
33891311.0,37,70,1.8918918918918919,1,4,37,0
33896781.0,96,669,6.96875,2,10,71,25
33918542.0,51,451,8.843137254901961,2,12,5,46
33919776.0,2,5,2.5,2,3,2,0
33920503.0,9,21,2.3333333333333335,1,4,9,0
33921059.0,57,122,2.1403508771929824,1,4,57,0
33921583.0,25,48,1.92,1,3,25,0
33923454.0,190,1302,6.852631578947369,2,9,136,54
33925601.0,188,1629,8.664893617021276,2,11,22,166
33926396.0,116,789,6.801724137931035,2,9,83,33
33934386.0,189,1477,7.814814814814815,2,10,65,124
33935555.0,181,1752,9.679558011049723,2,12,9,172
33936746.0,290,2801,9.658620689655173,2,12,21,269
33951438.0,137,680,4.963503649635037,2,7,137,0
33951615.0,138,280,2.028985507246377,1,4,138,0
33951946.0,135,409,3.0296296296296297,1,5,135,0
33954358.0,15,31,2.066666666666667,1,4,15,0
33956377.0,14,26,1.8571428571428572,1,4,14,0
33956749.0,7,52,7.428571428571429,6,9,3,4
33958982.0,70,210,3.0,1,5,70,0
33960071.0,32,42,1.3125,1,3,32,0
33960092.0,131,394,3.0076335877862594,1,6,131,0
33962295.0,335,2284,6.817910447761194,2,10,233,102
33965971.0,177,863,4.875706214689266,2,8,176,1
33969451.0,145,719,4.958620689655173,2,7,145,0
33979952.0,15,21,1.4,1,3,15,0
33980088.0,3,4,1.3333333333333333,1,2,3,0
33984608.0,195,1862,9.548717948717949,3,13,13,182
33988704.0,5,26,5.2,3,6,5,0
33990666.0,638,3110,4.87460815047022,2,8,633,5
33992175.0,124,247,1.9919354838709677,1,5,124,0
33993380.0,32,258,8.0625,3,10,8,24
34006106.0,7,16,2.2857142857142856,1,3,7,0
34010016.0,43,168,3.9069767441860463,2,7,43,0
34010711.0,86,330,3.8372093023255816,2,7,86,0
34016925.0,25,43,1.72,1,3,25,0
34020526.0,155,208,1.3419354838709678,1,3,155,0
34027669.0,159,1086,6.830188679245283,2,9,109,50
34028051.0,174,859,4.936781609195402,2,8,173,1
34029782.0,240,1378,5.741666666666666,2,9,229,11
34030215.0,309,2979,9.640776699029127,2,13,14,295
34031160.0,85,586,6.894117647058824,3,10,60,25
34041869.0,2,3,1.5,1,2,2,0
34048163.0,122,1188,9.737704918032787,3,13,8,114
34049627.0,225,1114,4.9511111111111115,2,8,224,1
34050321.0,194,1323,6.819587628865979,2,10,144,50
34051026.0,84,567,6.75,2,9,64,20
34051857.0,28,257,9.178571428571429,8,11,0,28
34056019.0,8,22,2.75,2,4,8,0
34056883.0,29,258,8.89655172413793,6,11,3,26
34060521.0,355,1780,5.014084507042254,2,8,351,4
34061859.0,23,145,6.304347826086956,5,8,21,2
34064518.0,26,246,9.461538461538462,5,12,1,25
34069373.0,13,132,10.153846153846153,9,11,0,13
34070734.0,100,963,9.63,3,12,4,96
34071040.0,223,909,4.076233183856503,1,7,223,0
34073014.0,55,117,2.1272727272727274,1,5,55,0
34075578.0,2,4,2.0,2,2,2,0
34076848.0,41,359,8.75609756097561,2,11,4,37
34079249.0,28,34,1.2142857142857142,1,2,28,0
34081159.0,207,1010,4.879227053140097,2,8,206,1
34081621.0,15,39,2.6,1,4,15,0
34099888.0,192,1832,9.541666666666666,2,13,15,177
34105261.0,145,428,2.9517241379310346,1,6,145,0
34106258.0,364,779,2.14010989010989,1,5,364,0
34107543.0,232,2224,9.586206896551724,2,13,18,214
34109147.0,4,6,1.5,1,2,4,0
34112118.0,1,3,3.0,3,3,1,0
34114128.0,161,1404,8.720496894409937,2,12,20,141
34123888.0,127,1101,8.669291338582678,2,11,21,106
34132088.0,140,706,5.042857142857143,2,8,139,1
34132865.0,129,887,6.875968992248062,4,9,95,34
34133380.0,3,6,2.0,1,3,3,0
34134130.0,33,98,2.9696969696969697,1,5,33,0
34135775.0,81,397,4.901234567901234,2,8,80,1
34144861.0,7,61,8.714285714285714,7,10,1,6
34144863.0,4,35,8.75,8,10,0,4
34144883.0,2,19,9.5,9,10,0,2
34144977.0,2,12,6.0,2,10,1,1
34144987.0,4,39,9.75,9,11,0,4
34144991.0,2,18,9.0,8,10,0,2
34145216.0,3,29,9.666666666666666,9,10,0,3
34168267.0,262,1334,5.091603053435114,2,7,262,0
34172591.0,13,125,9.615384615384615,6,11,1,12
34174828.0,263,2334,8.874524714828897,2,12,22,241
34175411.0,265,543,2.049056603773585,1,5,265,0
34175754.0,73,649,8.89041095890411,4,11,8,65
34177679.0,28,59,2.107142857142857,1,4,28,0
34179535.0,34,228,6.705882352941177,3,9,24,10
34193640.0,105,131,1.2476190476190476,1,3,105,0
34198850.0,36,144,4.0,2,6,36,0
34202423.0,19,25,1.3157894736842106,1,3,19,0
34229699.0,79,558,7.063291139240507,5,9,52,27
34247579.0,7,10,1.4285714285714286,1,3,7,0
34268100.0,98,936,9.551020408163266,2,12,10,88
34268737.0,120,603,5.025,2,8,119,1
34271242.0,19,138,7.2631578947368425,4,9,11,8
34277552.0,41,282,6.878048780487805,5,9,31,10
34285181.0,261,1296,4.9655172413793105,2,8,259,2
34285874.0,90,178,1.9777777777777779,1,5,90,0
34299065.0,1,1,1.0,1,1,1,0
34301077.0,14,41,2.9285714285714284,1,5,14,0
34301335.0,22,32,1.4545454545454546,1,3,22,0
34301844.0,39,114,2.923076923076923,1,5,39,0
34304207.0,16,46,2.875,2,4,16,0
34306844.0,1,2,2.0,2,2,1,0
34323670.0,45,226,5.022222222222222,2,7,45,0
34325065.0,1,2,2.0,2,2,1,0
34325382.0,1,3,3.0,3,3,1,0
34327334.0,8,64,8.0,7,9,2,6
34329689.0,1,3,3.0,3,3,1,0
34331083.0,102,517,5.068627450980392,3,7,102,0
34331299.0,7,12,1.7142857142857142,1,2,7,0
34331863.0,1,4,4.0,4,4,1,0
34332052.0,1,3,3.0,3,3,1,0
34332172.0,1,2,2.0,2,2,1,0
34334802.0,2,8,4.0,4,4,2,0
34338034.0,19,170,8.947368421052632,2,11,3,16
34339600.0,58,246,4.241379310344827,2,7,58,0
34346348.0,10,40,4.0,3,5,10,0
34346734.0,22,26,1.1818181818181819,1,2,22,0
34352115.0,219,2155,9.840182648401827,3,13,13,206
34352357.0,2,6,3.0,2,4,2,0
34353268.0,246,2383,9.6869918699187,2,13,17,229
34354591.0,9,14,1.5555555555555556,1,3,9,0
34361321.0,181,1551,8.569060773480663,2,11,22,159
34361887.0,96,922,9.604166666666666,2,12,7,89
34367013.0,3,6,2.0,1,3,3,0
34376725.0,61,122,2.0,1,6,61,0
34377763.0,36,147,4.083333333333333,2,6,36,0
34377899.0,39,258,6.615384615384615,2,8,29,10
34380130.0,1,1,1.0,1,1,1,0
34383756.0,175,1522,8.697142857142858,2,12,20,155
34384791.0,227,1094,4.819383259911894,2,8,226,1
34390728.0,143,326,2.2797202797202796,1,5,143,0
34391423.0,31,265,8.548387096774194,4,11,3,28
34407740.0,5,24,4.8,3,7,5,0
34409906.0,71,359,5.056338028169014,2,7,71,0
34410885.0,10,86,8.6,7,10,2,8
34412460.0,113,539,4.769911504424779,2,7,113,0
34413240.0,50,432,8.64,3,12,4,46
34416268.0,59,576,9.76271186440678,2,12,3,56
34436459.0,235,678,2.8851063829787233,1,6,235,0
34436843.0,17,167,9.823529411764707,8,11,0,17
34462830.0,8,20,2.5,1,4,8,0
34466595.0,67,137,2.044776119402985,1,5,67,0
34466597.0,113,767,6.787610619469026,2,10,79,34
34469805.0,102,988,9.686274509803921,2,13,4,98
34471505.0,1,3,3.0,3,3,1,0
34482581.0,158,766,4.848101265822785,2,8,156,2
34487036.0,35,235,6.714285714285714,3,10,28,7
34487131.0,1,1,1.0,1,1,1,0
34494408.0,1,2,2.0,2,2,1,0
34495541.0,18,38,2.111111111111111,1,4,18,0
34501041.0,98,669,6.826530612244898,3,10,69,29
34507790.0,1,1,1.0,1,1,1,0
34509222.0,1,2,2.0,2,2,1,0
34510107.0,235,2335,9.936170212765957,2,13,16,219
34517963.0,162,781,4.820987654320987,2,8,160,2
34527714.0,2,3,1.5,1,2,2,0
34528061.0,57,278,4.87719298245614,2,7,57,0
34533573.0,111,768,6.918918918918919,2,10,78,33
34534589.0,315,1540,4.888888888888889,2,8,313,2
34536252.0,184,404,2.1956521739130435,1,4,184,0
34536289.0,94,637,6.776595744680851,2,10,68,26
34542120.0,1,2,2.0,2,2,1,0
34542800.0,96,654,6.8125,2,10,65,31
34542906.0,30,259,8.633333333333333,3,11,5,25
34551767.0,1,3,3.0,3,3,1,0
34552285.0,4,14,3.5,2,5,4,0
34554457.0,2,4,2.0,2,2,2,0
34554879.0,12,65,5.416666666666667,2,7,12,0
34555434.0,1,5,5.0,5,5,1,0
34555804.0,49,151,3.0816326530612246,1,6,49,0
34564312.0,3,7,2.3333333333333335,2,3,3,0
34564785.0,101,694,6.871287128712871,3,10,68,33
34564940.0,84,419,4.988095238095238,2,7,84,0
34566779.0,1,3,3.0,3,3,1,0
34568392.0,3,5,1.6666666666666667,1,2,3,0
34568397.0,2,7,3.5,3,4,2,0
34569100.0,1,5,5.0,5,5,1,0
34569192.0,54,519,9.61111111111111,3,12,3,51
34570478.0,117,236,2.017094017094017,1,4,117,0
34572681.0,1,2,2.0,2,2,1,0
34582508.0,20,42,2.1,1,4,20,0
34584559.0,12,15,1.25,1,2,12,0
34584940.0,1,2,2.0,2,2,1,0
34587760.0,113,336,2.9734513274336285,1,6,113,0
34592663.0,1,1,1.0,1,1,1,0
34592932.0,9,18,2.0,1,4,9,0
34593580.0,144,421,2.923611111111111,1,5,144,0
34593610.0,39,342,8.76923076923077,4,11,9,30
34594600.0,73,284,3.8904109589041096,1,7,73,0
34595954.0,94,655,6.968085106382978,3,9,65,29
34597706.0,119,1154,9.697478991596638,2,13,8,111
34599187.0,103,693,6.728155339805825,4,9,76,27
34599290.0,3,11,3.6666666666666665,3,5,3,0
34599363.0,53,351,6.622641509433962,2,9,36,17
34599620.0,124,1189,9.588709677419354,2,13,10,114
34600353.0,78,533,6.833333333333333,2,10,52,26
34601783.0,39,320,8.205128205128204,6,11,9,30
34601798.0,30,202,6.733333333333333,2,9,22,8
34609539.0,38,158,4.157894736842105,2,6,38,0
34609751.0,61,415,6.80327868852459,3,10,48,13
34610126.0,1,3,3.0,3,3,1,0
34611325.0,8,14,1.75,1,3,8,0
34611549.0,85,774,9.105882352941176,6,12,5,80
34612457.0,83,572,6.891566265060241,2,10,60,23
34613589.0,118,817,6.923728813559322,2,10,80,38
34618029.0,60,589,9.816666666666666,4,12,2,58
34618997.0,9,12,1.3333333333333333,1,3,9,0
34620632.0,127,1216,9.5748031496063,2,13,10,117
34621817.0,2,3,1.5,1,2,2,0
34623195.0,7,60,8.571428571428571,2,11,1,6
34627115.0,8,18,2.25,1,3,8,0
34627277.0,40,63,1.575,1,4,40,0
34630508.0,6,40,6.666666666666667,3,9,4,2
34633044.0,4,31,7.75,7,9,2,2
34635072.0,100,981,9.81,2,12,6,94
34635684.0,1,1,1.0,1,1,1,0
34635866.0,1,2,2.0,2,2,1,0
34636625.0,469,4149,8.846481876332623,2,13,50,419
34640500.0,78,380,4.871794871794871,2,7,78,0
34642115.0,13,24,1.8461538461538463,1,3,13,0
34645268.0,115,1104,9.6,2,12,4,111
34645331.0,1,2,2.0,2,2,1,0
34645780.0,514,3980,7.743190661478599,2,10,194,320
34648702.0,1,3,3.0,3,3,1,0
34649346.0,5,7,1.4,1,3,5,0
34649770.0,2,10,5.0,5,5,2,0
34650504.0,3,5,1.6666666666666667,1,2,3,0
34653864.0,2,20,10.0,10,10,0,2
34661268.0,1,4,4.0,4,4,1,0
34661656.0,16,30,1.875,1,4,16,0
34661765.0,18,53,2.9444444444444446,1,5,18,0
34662112.0,9,19,2.111111111111111,1,4,9,0
34662636.0,3,3,1.0,1,1,3,0
34664022.0,158,323,2.0443037974683542,1,5,158,0
34665751.0,1,3,3.0,3,3,1,0
34667052.0,117,254,2.1709401709401708,1,4,117,0
34668091.0,2,8,4.0,4,4,2,0
34669106.0,15,125,8.333333333333334,6,10,3,12
34669693.0,181,378,2.088397790055249,1,5,181,0
34671594.0,1,2,2.0,2,2,1,0
34672755.0,1,3,3.0,3,3,1,0
34673791.0,3,7,2.3333333333333335,1,3,3,0
34674163.0,1,4,4.0,4,4,1,0
34676730.0,3,7,2.3333333333333335,1,4,3,0
34681047.0,2,5,2.5,1,4,2,0
34681525.0,6,21,3.5,2,6,6,0
34683464.0,159,806,5.069182389937107,3,7,159,0
34686802.0,58,513,8.844827586206897,2,11,6,52
34695881.0,1,3,3.0,3,3,1,0
34697419.0,2,5,2.5,1,4,2,0
34698625.0,148,312,2.108108108108108,1,5,148,0
34698877.0,31,117,3.774193548387097,2,6,31,0
34705853.0,145,988,6.813793103448276,2,10,102,43
34707071.0,214,437,2.042056074766355,1,5,214,0
34708113.0,1,1,1.0,1,1,1,0
34711274.0,70,554,7.914285714285715,3,11,18,52
34711592.0,36,80,2.2222222222222223,1,4,36,0
34712527.0,95,284,2.9894736842105263,1,5,95,0
34713449.0,479,3268,6.822546972860125,2,10,338,141
34716374.0,24,42,1.75,1,4,24,0
34716515.0,1,1,1.0,1,1,1,0
34716848.0,1,2,2.0,2,2,1,0
34718360.0,65,520,8.0,2,10,16,49
34728535.0,1,3,3.0,3,3,1,0
34732572.0,161,328,2.0372670807453415,1,5,161,0
34732780.0,12,15,1.25,1,3,12,0
34732993.0,1,1,1.0,1,1,1,0
34733021.0,10,49,4.9,3,6,10,0
34733051.0,17,23,1.3529411764705883,1,3,17,0
34734214.0,1,3,3.0,3,3,1,0
34737025.0,1,2,2.0,2,2,1,0
34737688.0,50,195,3.9,2,6,50,0
34738146.0,3,6,2.0,1,3,3,0
34738662.0,1,3,3.0,3,3,1,0
34738867.0,3,4,1.3333333333333333,1,2,3,0
34739591.0,116,240,2.0689655172413794,1,6,116,0
34740985.0,117,570,4.871794871794871,2,7,117,0
34745318.0,5,16,3.2,2,4,5,0
34745951.0,114,878,7.701754385964913,3,10,48,66
34747673.0,1,3,3.0,3,3,1,0
34749835.0,5,7,1.4,1,2,5,0
34751158.0,429,3352,7.813519813519814,2,10,144,285
34751602.0,1,3,3.0,3,3,1,0
34764120.0,100,206,2.06,1,5,100,0
34767374.0,126,1080,8.571428571428571,2,11,16,110
34767618.0,106,731,6.89622641509434,2,10,78,28
34768515.0,122,1049,8.598360655737705,2,12,18,104
34770008.0,231,494,2.1385281385281387,1,5,231,0
34773815.0,225,1107,4.92,2,8,224,1
34774177.0,36,245,6.805555555555555,5,9,28,8
34774505.0,168,508,3.0238095238095237,1,5,168,0
34781334.0,1,3,3.0,3,3,1,0
34781453.0,1,4,4.0,4,4,1,0
34783971.0,14,89,6.357142857142857,3,8,12,2
34792915.0,406,824,2.0295566502463056,1,5,406,0
34798607.0,18,38,2.111111111111111,1,3,18,0
34803606.0,27,187,6.925925925925926,5,9,18,9
34804715.0,12,47,3.9166666666666665,3,5,12,0
34806169.0,27,245,9.074074074074074,7,11,2,25
34806436.0,37,326,8.81081081081081,5,10,5,32
34807229.0,66,272,4.121212121212121,2,6,66,0
34811354.0,1,2,2.0,2,2,1,0
34812107.0,246,1653,6.719512195121951,2,10,177,69
34813103.0,100,707,7.07,4,10,66,34
34814968.0,44,123,2.7954545454545454,1,4,44,0
34815926.0,45,98,2.1777777777777776,1,5,45,0
34827304.0,222,1499,6.752252252252252,2,9,160,62
34833275.0,46,185,4.021739130434782,1,6,46,0
34834376.0,3,6,2.0,1,3,3,0
34837369.0,170,863,5.076470588235294,2,7,170,0
34837710.0,2,4,2.0,1,3,2,0
34837964.0,10,14,1.4,1,3,10,0
34838238.0,33,130,3.9393939393939394,2,6,33,0
34839756.0,49,204,4.163265306122449,3,5,49,0
34841122.0,54,484,8.962962962962964,2,12,3,51
34845252.0,64,641,10.015625,6,12,1,63
34849494.0,1,1,1.0,1,1,1,0
34850645.0,2,5,2.5,2,3,2,0
34850999.0,105,415,3.9523809523809526,2,6,105,0
34851597.0,1,3,3.0,3,3,1,0
34851815.0,36,88,2.4444444444444446,1,6,36,0
34857325.0,134,283,2.111940298507463,1,4,134,0
34858973.0,4,7,1.75,1,3,4,0
34861366.0,13,30,2.3076923076923075,2,3,13,0
34861610.0,2,4,2.0,2,2,2,0
34861739.0,1,2,2.0,2,2,1,0
34862268.0,524,4070,7.767175572519084,2,12,188,336
34863336.0,100,980,9.8,5,12,5,95
34876208.0,3,5,1.6666666666666667,1,2,3,0
34876680.0,3,12,4.0,3,5,3,0
34877482.0,3,6,2.0,1,3,3,0
34880917.0,2,7,3.5,3,4,2,0
34887858.0,7,48,6.857142857142857,5,8,5,2
34888211.0,258,2272,8.806201550387597,2,12,25,233
34888358.0,129,270,2.0930232558139537,1,5,129,0
34889670.0,83,798,9.614457831325302,2,12,5,78
34889868.0,2,5,2.5,2,3,2,0
34889952.0,56,221,3.9464285714285716,2,7,56,0
34894763.0,2,17,8.5,8,9,0,2
34895653.0,1,2,2.0,2,2,1,0
34896285.0,271,559,2.062730627306273,1,4,271,0
34896772.0,3,7,2.3333333333333335,1,3,3,0
34897239.0,218,450,2.0642201834862384,1,5,218,0
34898617.0,22,182,8.272727272727273,2,11,3,19
34916604.0,1,2,2.0,2,2,1,0
34917572.0,1,2,2.0,2,2,1,0
34918512.0,253,2427,9.59288537549407,2,12,19,234
34921861.0,57,411,7.2105263157894735,4,10,38,19
34922275.0,104,417,4.009615384615385,2,6,104,0
34923255.0,3,9,3.0,2,4,3,0
34923291.0,75,289,3.8533333333333335,1,6,75,0
34924837.0,124,1215,9.798387096774194,3,13,6,118
34927870.0,48,339,7.0625,2,9,28,20
34930020.0,196,1702,8.683673469387756,2,11,24,172
34932680.0,38,335,8.81578947368421,2,11,2,36
34934042.0,21,58,2.761904761904762,1,4,21,0
34936272.0,1,3,3.0,3,3,1,0
34936451.0,44,312,7.090909090909091,5,9,32,12
34941394.0,11,16,1.4545454545454546,1,2,11,0
34952546.0,223,466,2.0896860986547083,1,5,223,0
34953775.0,202,448,2.217821782178218,1,5,202,0
34954638.0,177,866,4.892655367231638,2,8,175,2
34956200.0,2,2,1.0,1,1,2,0
34957374.0,211,431,2.042654028436019,1,4,211,0
34958003.0,345,3317,9.614492753623189,2,13,27,318
34958704.0,53,217,4.09433962264151,2,7,53,0
34958903.0,23,34,1.4782608695652173,1,4,23,0
34962052.0,35,250,7.142857142857143,2,10,21,14
34963176.0,49,110,2.2448979591836733,1,5,49,0
34966581.0,1,6,6.0,6,6,1,0
34966625.0,184,381,2.0706521739130435,1,5,184,0
34966686.0,1,5,5.0,5,5,1,0
34967113.0,2,6,3.0,2,4,2,0
34968945.0,11,31,2.8181818181818183,1,4,11,0
34970298.0,24,76,3.1666666666666665,2,5,24,0
34970786.0,4,5,1.25,1,2,4,0
34970987.0,124,1198,9.661290322580646,4,13,8,116
34971548.0,3,5,1.6666666666666667,1,3,3,0
34971868.0,46,142,3.0869565217391304,1,5,46,0
34971869.0,21,58,2.761904761904762,1,5,21,0
34972278.0,375,757,2.018666666666667,1,6,375,0
34974444.0,14,19,1.3571428571428572,1,2,14,0
34974648.0,258,2211,8.569767441860465,2,12,33,225
34988688.0,74,100,1.3513513513513513,1,3,74,0
34988693.0,121,347,2.8677685950413223,1,6,121,0
34988982.0,18,169,9.38888888888889,8,12,0,18
34990295.0,2,8,4.0,4,4,2,0
34990851.0,1,2,2.0,2,2,1,0
34991186.0,20,46,2.3,1,4,20,0
34993849.0,2,3,1.5,1,2,2,0
34994825.0,170,363,2.135294117647059,1,5,170,0
34997116.0,173,862,4.982658959537572,2,8,172,1
35000252.0,242,947,3.9132231404958677,1,7,242,0
35000613.0,13,44,3.3846153846153846,2,4,13,0
35001357.0,1,3,3.0,3,3,1,0
35003359.0,45,429,9.533333333333333,5,11,2,43
35003550.0,145,716,4.937931034482759,2,8,144,1
35004614.0,45,88,1.9555555555555555,1,4,45,0
35004689.0,126,256,2.0317460317460316,1,4,126,0
35017691.0,118,232,1.9661016949152543,1,5,118,0
35017941.0,278,604,2.172661870503597,1,5,278,0
35018963.0,29,142,4.896551724137931,2,7,29,0
35021118.0,5,40,8.0,7,9,1,4
35028089.0,145,1376,9.489655172413793,2,13,12,133
35029230.0,232,460,1.9827586206896552,1,5,232,0
35029265.0,360,1799,4.997222222222222,2,8,357,3
35029568.0,286,1932,6.755244755244755,2,10,209,77
35030004.0,245,1669,6.812244897959184,2,10,179,66
35030766.0,1,1,1.0,1,1,1,0
35030885.0,6,21,3.5,2,4,6,0
35030943.0,5,6,1.2,1,2,5,0
35032943.0,175,1206,6.8914285714285715,2,11,124,51
35034659.0,136,404,2.9705882352941178,1,6,136,0
35036029.0,10,48,4.8,4,6,10,0
35038567.0,13,24,1.8461538461538463,1,4,13,0
35043899.0,1,10,10.0,10,10,0,1
35046591.0,119,1156,9.714285714285714,3,12,4,115
35046899.0,195,1890,9.692307692307692,2,12,13,182
35046982.0,26,53,2.0384615384615383,1,4,26,0
35048837.0,3,7,2.3333333333333335,1,3,3,0
35049750.0,285,1675,5.87719298245614,2,9,272,13
35058792.0,46,104,2.260869565217391,1,4,46,0
35064814.0,281,1908,6.790035587188612,2,10,200,81
35065843.0,104,918,8.826923076923077,4,12,14,90
35067184.0,167,1460,8.74251497005988,3,12,20,147
35076939.0,189,1290,6.825396825396825,3,10,139,50
35077737.0,1,3,3.0,3,3,1,0
35078955.0,6,9,1.5,1,2,6,0
35082110.0,144,718,4.986111111111111,2,9,140,4
35084051.0,249,1729,6.943775100401607,4,9,174,75
35087093.0,27,109,4.037037037037037,2,6,27,0
35089318.0,6,19,3.1666666666666665,2,4,6,0
35090927.0,14,92,6.571428571428571,2,8,10,4
35098315.0,203,1189,5.857142857142857,2,8,186,17
35101578.0,14,87,6.214285714285714,3,8,12,2
35102393.0,7,14,2.0,1,4,7,0
35102424.0,2,2,1.0,1,1,2,0
35102467.0,19,35,1.8421052631578947,1,4,19,0
35102516.0,2,5,2.5,2,3,2,0
35102734.0,20,44,2.2,1,4,20,0
35102775.0,13,25,1.9230769230769231,1,4,13,0
35102863.0,25,49,1.96,1,4,25,0
35103087.0,2,5,2.5,2,3,2,0
35103132.0,7,18,2.5714285714285716,1,4,7,0
35103178.0,2,4,2.0,2,2,2,0
35103338.0,21,168,8.0,5,10,6,15
35103394.0,1,4,4.0,4,4,1,0
35103434.0,3,7,2.3333333333333335,1,3,3,0
35103476.0,27,57,2.111111111111111,1,4,27,0
35103767.0,15,35,2.3333333333333335,1,4,15,0
35103828.0,2,6,3.0,2,4,2,0
35103883.0,5,14,2.8,2,4,5,0
35104104.0,3,4,1.3333333333333333,1,2,3,0
35104153.0,2,8,4.0,3,5,2,0
35104208.0,39,83,2.128205128205128,1,5,39,0
35104418.0,14,24,1.7142857142857142,1,3,14,0
35104452.0,6,11,1.8333333333333333,1,3,6,0
35104467.0,7,13,1.8571428571428572,1,3,7,0
35105003.0,25,54,2.16,1,5,25,0
35105960.0,1,3,3.0,3,3,1,0
35120295.0,21,66,3.142857142857143,1,5,21,0
35121302.0,52,114,2.1923076923076925,1,4,52,0
35121463.0,364,3553,9.760989010989011,2,13,15,349
35123419.0,1,2,2.0,2,2,1,0
35137928.0,100,405,4.05,1,7,100,0
35140069.0,1,2,2.0,2,2,1,0
35148992.0,45,394,8.755555555555556,3,12,5,40
35149095.0,168,234,1.3928571428571428,1,3,168,0
35149343.0,67,325,4.850746268656716,3,7,67,0
35151407.0,107,648,6.05607476635514,4,8,100,7
35153815.0,31,300,9.67741935483871,5,12,3,28
35154413.0,46,366,7.956521739130435,4,11,11,35
35155560.0,7,21,3.0,1,5,7,0
35156393.0,1,1,1.0,1,1,1,0
35157261.0,272,1890,6.948529411764706,2,10,177,95
35158135.0,1,2,2.0,2,2,1,0
35158187.0,22,43,1.9545454545454546,1,4,22,0
35159483.0,9,72,8.0,3,9,1,8
35161479.0,38,187,4.921052631578948,2,7,38,0
35172698.0,30,38,1.2666666666666666,1,3,30,0
35174432.0,178,377,2.1179775280898876,1,5,178,0
35175776.0,65,253,3.8923076923076922,1,7,65,0
35175794.0,22,62,2.8181818181818183,1,5,22,0
35177106.0,1,1,1.0,1,1,1,0
35178793.0,500,2434,4.868,2,9,497,3
35179082.0,57,391,6.859649122807017,3,9,41,16
35179676.0,1,3,3.0,3,3,1,0
35180905.0,4,9,2.25,1,3,4,0
35181780.0,9,57,6.333333333333333,5,8,6,3
35181812.0,110,568,5.163636363636364,3,8,109,1
35181843.0,1,2,2.0,2,2,1,0
35183903.0,2,5,2.5,2,3,2,0
35185989.0,134,1170,8.73134328358209,2,12,14,120
35187014.0,133,666,5.007518796992481,2,7,133,0
35188614.0,6,19,3.1666666666666665,2,4,6,0
35193153.0,8,22,2.75,2,4,8,0
35194623.0,259,534,2.0617760617760617,1,5,259,0
35210615.0,1,1,1.0,1,1,1,0
35211536.0,35,65,1.8571428571428572,1,4,35,0
35212629.0,107,536,5.009345794392523,2,7,107,0
35214774.0,1,2,2.0,2,2,1,0
35216136.0,184,366,1.9891304347826086,1,5,184,0
35216537.0,71,366,5.154929577464789,2,8,70,1
35219864.0,159,453,2.849056603773585,1,6,159,0
35220866.0,4,7,1.75,1,3,4,0
35222327.0,95,298,3.136842105263158,1,5,95,0
35225459.0,147,855,5.816326530612245,3,9,141,6
35225904.0,220,1721,7.822727272727272,2,11,75,145
35228798.0,1,3,3.0,3,3,1,0
35234037.0,32,64,2.0,1,4,32,0
35234868.0,77,384,4.987012987012987,3,7,77,0
35241016.0,276,1344,4.869565217391305,2,8,274,2
35245547.0,130,519,3.9923076923076923,1,7,130,0
35254795.0,73,229,3.136986301369863,1,6,73,0
35254833.0,112,329,2.9375,1,6,112,0
35262240.0,2,4,2.0,1,3,2,0
35270541.0,13,36,2.769230769230769,1,5,13,0
35274218.0,126,963,7.642857142857143,2,10,47,79
35279099.0,130,647,4.976923076923077,2,8,128,2
35280824.0,74,356,4.8108108108108105,2,7,74,0
35281707.0,35,238,6.8,2,9,25,10
35282269.0,96,481,5.010416666666667,2,8,95,1
35284912.0,61,462,7.573770491803279,2,11,21,40
35285172.0,11,34,3.090909090909091,1,5,11,0
35285226.0,15,41,2.7333333333333334,2,4,15,0
35299565.0,22,46,2.090909090909091,1,4,22,0
35304140.0,10,17,1.7,1,3,10,0
35310619.0,219,2126,9.707762557077626,2,13,11,208
35311344.0,106,739,6.971698113207547,5,10,69,37
35313254.0,95,669,7.042105263157895,5,9,68,27
35316187.0,51,412,8.07843137254902,5,10,13,38
35327933.0,29,115,3.9655172413793105,2,6,29,0
35330038.0,42,208,4.9523809523809526,2,7,42,0
35332651.0,1,4,4.0,4,4,1,0
35333060.0,118,454,3.847457627118644,1,6,118,0
35339534.0,44,331,7.5227272727272725,2,10,16,28
35339573.0,127,646,5.086614173228346,3,8,126,1
35340773.0,2,4,2.0,1,3,2,0
35346324.0,27,55,2.037037037037037,1,4,27,0
35346328.0,22,61,2.772727272727273,1,4,22,0
35347288.0,21,30,1.4285714285714286,1,3,21,0
35348769.0,1,1,1.0,1,1,1,0
35348842.0,144,1002,6.958333333333333,2,10,98,46
35356583.0,119,156,1.3109243697478992,1,4,119,0
35358000.0,10,45,4.5,3,6,10,0
35360207.0,9,56,6.222222222222222,2,8,8,1
35361337.0,116,572,4.931034482758621,2,7,116,0
35362490.0,61,357,5.852459016393443,2,8,57,4
35365249.0,252,742,2.9444444444444446,1,6,252,0
35366413.0,1,4,4.0,4,4,1,0
35368111.0,43,86,2.0,1,5,43,0
35371265.0,61,120,1.9672131147540983,1,4,61,0
35372549.0,3,10,3.3333333333333335,2,4,3,0
35374416.0,11,46,4.181818181818182,2,6,11,0
35379245.0,21,36,1.7142857142857142,1,5,21,0
35379745.0,16,46,2.875,2,4,16,0
35379830.0,224,666,2.9732142857142856,1,6,224,0
35383676.0,1,3,3.0,3,3,1,0
35398499.0,2,7,3.5,2,5,2,0
35399104.0,54,156,2.888888888888889,1,6,54,0
35399861.0,10,80,8.0,7,9,2,8
35415776.0,198,292,1.4747474747474747,1,4,198,0
35419979.0,156,1504,9.64102564102564,2,13,12,144
35422453.0,104,983,9.451923076923077,2,13,10,94
35423353.0,10,43,4.3,3,6,10,0
35423558.0,4,4,1.0,1,1,4,0
35423821.0,9,29,3.2222222222222223,2,4,9,0
35424837.0,8,30,3.75,2,5,8,0
35432563.0,36,211,5.861111111111111,2,8,32,4
35432750.0,310,1541,4.970967741935484,1,8,309,1
35433102.0,56,333,5.946428571428571,3,8,53,3
35436490.0,237,2059,8.68776371308017,3,11,33,204
35437665.0,18,31,1.7222222222222223,1,3,18,0
35439773.0,107,149,1.3925233644859814,1,3,107,0
35445885.0,30,304,10.133333333333333,8,13,0,30
35451606.0,1,8,8.0,8,8,0,1
35453455.0,75,104,1.3866666666666667,1,4,75,0
35453793.0,27,55,2.037037037037037,1,5,27,0
35454936.0,4,5,1.25,1,2,4,0
35455872.0,97,205,2.11340206185567,1,5,97,0
35461470.0,35,106,3.0285714285714285,1,5,35,0
35464332.0,161,1376,8.546583850931677,2,11,23,138
35475484.0,14,103,7.357142857142857,2,9,5,9
35478322.0,61,172,2.819672131147541,1,6,61,0
35478712.0,5,18,3.6,3,4,5,0
35479011.0,114,225,1.9736842105263157,1,4,114,0
35482681.0,118,803,6.805084745762712,3,9,84,34
35492727.0,16,128,8.0,6,10,4,12
35493195.0,69,346,5.0144927536231885,2,7,69,0
35494341.0,27,74,2.740740740740741,1,5,27,0
35504260.0,276,1089,3.9456521739130435,1,7,276,0
35512092.0,23,220,9.565217391304348,2,12,2,21
35512382.0,1,2,2.0,2,2,1,0
35512607.0,1,1,1.0,1,1,1,0
35516226.0,60,587,9.783333333333333,4,12,3,57
35518098.0,4,31,7.75,6,9,1,3
35526973.0,171,1618,9.461988304093568,2,13,10,161
35533988.0,75,149,1.9866666666666666,1,4,75,0
35536596.0,97,284,2.9278350515463916,1,5,97,0
35538319.0,17,21,1.2352941176470589,1,2,17,0
35544400.0,47,94,2.0,1,4,47,0
35544516.0,67,530,7.91044776119403,4,11,22,45
35547871.0,122,599,4.909836065573771,2,7,122,0
35552174.0,160,1542,9.6375,3,13,10,150
35561901.0,288,2520,8.75,3,12,29,259
35589270.0,168,353,2.1011904761904763,1,4,168,0
35590888.0,233,1162,4.987124463519313,2,8,231,2
35590960.0,2,17,8.5,8,9,0,2
35592304.0,38,190,5.0,3,7,38,0
35592585.0,58,168,2.896551724137931,1,5,58,0
35599315.0,6,10,1.6666666666666667,1,3,6,0
35599860.0,243,958,3.94238683127572,2,6,243,0
35600359.0,27,28,1.037037037037037,1,2,27,0
35600644.0,6,7,1.1666666666666667,1,2,6,0
35601926.0,3,4,1.3333333333333333,1,2,3,0
35602525.0,37,49,1.3243243243243243,1,3,37,0
35607565.0,20,39,1.95,1,4,20,0
35612754.0,9,75,8.333333333333334,8,9,0,9
35644051.0,29,86,2.9655172413793105,1,5,29,0
35659019.0,31,89,2.870967741935484,1,5,31,0
35659415.0,7,52,7.428571428571429,5,9,2,5
35662402.0,1,1,1.0,1,1,1,0
35663856.0,34,296,8.705882352941176,2,11,4,30
35665610.0,92,785,8.532608695652174,2,12,16,76
35670892.0,213,830,3.896713615023474,2,8,212,1
35671473.0,17,127,7.470588235294118,3,9,7,10
35673321.0,4,19,4.75,3,6,4,0
35674496.0,169,984,5.822485207100592,2,9,155,14
35680053.0,79,290,3.670886075949367,2,6,79,0
35681122.0,4,4,1.0,1,1,4,0
35687410.0,74,103,1.3918918918918919,1,3,74,0
35692919.0,9,29,3.2222222222222223,1,5,9,0
35696289.0,173,1163,6.722543352601156,2,9,142,31
35701967.0,68,462,6.794117647058823,4,9,60,8
35702581.0,3,6,2.0,1,3,3,0
35705961.0,504,4912,9.746031746031745,2,13,25,479
35710006.0,93,377,4.053763440860215,2,8,92,1
35714125.0,53,501,9.452830188679245,3,12,5,48
35719997.0,9,29,3.2222222222222223,1,6,9,0
35735895.0,65,641,9.861538461538462,3,13,2,63
35736356.0,45,217,4.822222222222222,2,7,45,0
35761336.0,1,3,3.0,3,3,1,0
35766955.0,14,99,7.071428571428571,5,9,9,5
35778907.0,4,10,2.5,1,4,4,0
35781474.0,51,259,5.078431372549019,3,10,50,1
35781656.0,6,15,2.5,1,4,6,0
35783734.0,323,1579,4.8885448916408665,2,8,317,6
35784276.0,140,276,1.9714285714285715,1,4,140,0
35786576.0,383,1521,3.971279373368146,1,6,383,0
35787513.0,109,199,1.8256880733944953,1,4,109,0
35793643.0,341,1679,4.92375366568915,2,8,338,3
35794634.0,1,1,1.0,1,1,1,0
35797926.0,245,980,4.0,1,7,245,0
35797948.0,10,59,5.9,4,8,9,1
35799535.0,119,779,6.546218487394958,2,10,92,27
35800851.0,44,409,9.295454545454545,4,12,4,40
35800947.0,26,197,7.576923076923077,6,9,12,14
35801057.0,151,755,5.0,2,8,147,4
35811449.0,94,672,7.148936170212766,4,10,59,35
35815573.0,2,2,1.0,1,1,2,0
35821392.0,189,1497,7.920634920634921,3,11,60,129
35821482.0,495,2948,5.955555555555556,2,9,463,32
35826119.0,162,648,4.0,2,7,162,0
35832605.0,55,219,3.981818181818182,1,6,55,0
35836726.0,8,9,1.125,1,2,8,0
35836881.0,88,179,2.034090909090909,1,5,88,0
35838490.0,294,1435,4.880952380952381,2,8,292,2
35840673.0,5,12,2.4,1,4,5,0
35852677.0,19,57,3.0,1,5,19,0
35855258.0,35,313,8.942857142857143,3,11,2,33
35859066.0,77,154,2.0,1,5,77,0
35860083.0,17,34,2.0,1,4,17,0
35862272.0,207,1928,9.31400966183575,2,12,23,184
35863521.0,334,3171,9.494011976047904,2,13,29,305
35865767.0,88,433,4.920454545454546,2,9,87,1
35866326.0,173,1518,8.77456647398844,2,11,13,160
35868790.0,11,46,4.181818181818182,3,6,11,0
35885180.0,38,121,3.1842105263157894,1,5,38,0
35888557.0,7,13,1.8571428571428572,1,4,7,0
35890347.0,39,264,6.769230769230769,2,9,29,10
35890350.0,66,512,7.757575757575758,3,10,21,45
35890630.0,57,280,4.912280701754386,3,7,57,0
35894090.0,29,151,5.206896551724138,3,7,29,0
35896099.0,156,466,2.9871794871794872,1,5,156,0
35897208.0,28,53,1.8928571428571428,1,4,28,0
35900162.0,5,8,1.6,1,2,5,0
35901182.0,1,1,1.0,1,1,1,0
35906878.0,126,847,6.722222222222222,2,9,96,30
35910680.0,29,144,4.9655172413793105,3,7,29,0
35912049.0,3,18,6.0,5,7,3,0
35926648.0,189,1276,6.751322751322752,2,10,138,51
35932441.0,229,2241,9.786026200873362,2,13,14,215
35934929.0,14,71,5.071428571428571,4,6,14,0
35935234.0,2,7,3.5,3,4,2,0
35938711.0,138,1342,9.72463768115942,3,13,9,129
35938901.0,202,970,4.801980198019802,2,7,202,0
35945406.0,3,14,4.666666666666667,4,6,3,0
35946071.0,150,606,4.04,1,7,150,0
35957287.0,17,83,4.882352941176471,3,6,17,0
35959863.0,3,4,1.3333333333333333,1,2,3,0
35967354.0,195,1368,7.015384615384615,3,9,134,61
35968261.0,200,1530,7.65,2,10,79,121
35969514.0,21,35,1.6666666666666667,1,3,21,0
35980507.0,2,6,3.0,2,4,2,0
35986027.0,141,1362,9.659574468085106,3,13,11,130
35990283.0,115,161,1.4,1,4,115,0
35991965.0,166,1633,9.837349397590362,3,13,8,158
35997809.0,7,11,1.5714285714285714,1,3,7,0
36014743.0,81,641,7.91358024691358,5,10,25,56
36015171.0,114,242,2.1228070175438596,1,4,114,0
36015472.0,15,74,4.933333333333334,3,7,15,0
36019985.0,7,12,1.7142857142857142,1,3,7,0
36025783.0,71,479,6.746478873239437,3,9,54,17
36030084.0,17,38,2.235294117647059,1,3,17,0
36035664.0,39,159,4.076923076923077,1,6,39,0
36037883.0,15,102,6.8,4,9,10,5
36046203.0,82,322,3.926829268292683,2,6,82,0
36047252.0,264,1330,5.037878787878788,2,8,262,2
36050085.0,143,303,2.1188811188811187,1,4,143,0
36052410.0,8,31,3.875,3,5,8,0
36053507.0,76,660,8.68421052631579,6,11,11,65
36054381.0,60,574,9.566666666666666,4,12,4,56
36054428.0,20,98,4.9,2,8,19,1
36056740.0,10,24,2.4,1,4,10,0
36057967.0,8,13,1.625,1,3,8,0
36064202.0,35,143,4.085714285714285,3,6,35,0
36064778.0,93,808,8.688172043010752,2,11,12,81
36067721.0,4,9,2.25,1,3,4,0
36071725.0,176,730,4.1477272727272725,1,7,176,0
36075069.0,409,1595,3.899755501222494,1,7,409,0
36075156.0,12,117,9.75,8,11,0,12
36083320.0,11,87,7.909090909090909,6,10,4,7
36083857.0,1,3,3.0,3,3,1,0
36094925.0,6,10,1.6666666666666667,1,2,6,0
36094996.0,8,12,1.5,1,3,8,0
36095034.0,56,78,1.3928571428571428,1,3,56,0
36100988.0,9,46,5.111111111111111,4,6,9,0
36101714.0,260,1310,5.038461538461538,3,8,256,4
36102446.0,5,18,3.6,3,5,5,0
36110676.0,108,830,7.685185185185185,2,10,42,66
36122231.0,82,784,9.560975609756097,2,12,4,78
36125539.0,9,31,3.4444444444444446,3,4,9,0
36125775.0,66,136,2.0606060606060606,1,4,66,0
36126160.0,3,14,4.666666666666667,4,5,3,0
36127910.0,4,15,3.75,3,5,4,0
36128575.0,2,5,2.5,2,3,2,0
36128683.0,6,26,4.333333333333333,2,6,6,0
36130141.0,68,141,2.073529411764706,1,5,68,0
36130261.0,48,326,6.791666666666667,3,9,35,13
36134208.0,19,36,1.894736842105263,1,3,19,0
36137508.0,9,11,1.2222222222222223,1,2,9,0
36140919.0,5,51,10.2,9,12,0,5
36142186.0,71,350,4.929577464788732,2,7,71,0
36142365.0,216,635,2.939814814814815,1,6,216,0
36142402.0,155,462,2.9806451612903224,1,6,155,0
36144579.0,3,9,3.0,3,3,3,0
36145788.0,150,324,2.16,1,4,150,0
36145845.0,3,10,3.3333333333333335,3,4,3,0
36146938.0,110,323,2.9363636363636365,1,5,110,0
36147345.0,9,18,2.0,1,3,9,0
36158423.0,35,239,6.828571428571428,4,8,25,10
36161373.0,333,1606,4.822822822822823,2,7,333,0
36161741.0,34,308,9.058823529411764,7,11,4,30
36169247.0,68,278,4.088235294117647,2,7,68,0
36169500.0,175,876,5.005714285714285,3,8,174,1
36174176.0,106,314,2.9622641509433962,1,5,106,0
36174745.0,8,39,4.875,3,6,8,0
36191151.0,178,1739,9.769662921348315,2,12,6,172
36194117.0,30,62,2.066666666666667,1,4,30,0
36194131.0,15,29,1.9333333333333333,1,4,15,0
36194505.0,151,590,3.9072847682119205,1,7,151,0
36199203.0,65,451,6.938461538461539,3,9,44,21
36202818.0,16,90,5.625,4,7,16,0
36204716.0,416,3661,8.80048076923077,2,12,41,375
36220421.0,285,865,3.0350877192982457,1,6,285,0
36224715.0,36,133,3.6944444444444446,2,6,36,0
36224720.0,19,23,1.2105263157894737,1,2,19,0
36227570.0,165,1132,6.86060606060606,3,10,113,52
36229069.0,239,954,3.99163179916318,1,7,239,0
36244090.0,9,22,2.4444444444444446,1,4,9,0
36250917.0,1,4,4.0,4,4,1,0
36252670.0,23,119,5.173913043478261,4,7,23,0
36254899.0,166,494,2.9759036144578315,1,5,166,0
36255061.0,79,149,1.8860759493670887,1,4,79,0
36255908.0,1,4,4.0,4,4,1,0
36259455.0,5,41,8.2,7,10,2,3
36262390.0,142,574,4.042253521126761,1,7,142,0
36262409.0,12,54,4.5,2,6,12,0
36262428.0,209,828,3.9617224880382773,2,7,209,0
36262482.0,12,52,4.333333333333333,2,6,12,0
36264663.0,159,644,4.050314465408805,1,7,159,0
36266089.0,41,81,1.975609756097561,1,4,41,0
36266300.0,241,1886,7.825726141078838,2,11,83,158
36270356.0,124,1225,9.879032258064516,2,13,7,117
36274041.0,1,1,1.0,1,1,1,0
36284712.0,209,1643,7.861244019138756,2,11,67,142
36285521.0,8,54,6.75,5,8,6,2
36291110.0,19,36,1.894736842105263,1,4,19,0
36291710.0,108,344,3.185185185185185,1,6,108,0
36293453.0,6,24,4.0,3,5,6,0
36293840.0,8,23,2.875,2,4,8,0
36294301.0,4,16,4.0,3,5,4,0
36300305.0,192,981,5.109375,2,8,190,2
36305725.0,3,6,2.0,2,2,3,0
36306345.0,60,539,8.983333333333333,6,11,4,56
36315758.0,137,914,6.671532846715328,2,9,102,35
36316809.0,13,93,7.153846153846154,3,9,6,7
36329948.0,9,29,3.2222222222222223,2,4,9,0
36332503.0,80,549,6.8625,2,10,59,21
36332808.0,69,136,1.9710144927536233,1,4,69,0
36334930.0,1,4,4.0,4,4,1,0
36337859.0,204,630,3.088235294117647,1,6,204,0
36344063.0,1,2,2.0,2,2,1,0
36346903.0,2,8,4.0,4,4,2,0
36349561.0,1,2,2.0,2,2,1,0
36349845.0,122,614,5.032786885245901,3,7,122,0
36351918.0,2,3,1.5,1,2,2,0
36353134.0,10,17,1.7,1,3,10,0
36353544.0,1,2,2.0,2,2,1,0
36369224.0,275,2394,8.705454545454545,3,12,37,238
36369431.0,202,1407,6.965346534653466,2,10,132,70
36372164.0,3,4,1.3333333333333333,1,2,3,0
36377122.0,9,36,4.0,2,5,9,0
36378589.0,9,17,1.8888888888888888,1,4,9,0
36379083.0,248,2174,8.766129032258064,3,12,24,224
36382152.0,469,4140,8.8272921108742,2,12,49,420
36382465.0,212,2060,9.716981132075471,2,13,12,200
36393316.0,49,385,7.857142857142857,2,10,16,33
36398841.0,3,3,1.0,1,1,3,0
36399333.0,122,368,3.0163934426229506,1,6,122,0
36409714.0,11,104,9.454545454545455,8,11,0,11
36411404.0,181,396,2.1878453038674035,1,5,181,0
36411521.0,36,172,4.777777777777778,2,7,36,0
36414117.0,12,38,3.1666666666666665,2,5,12,0
36415149.0,55,115,2.090909090909091,1,5,55,0
36415378.0,29,69,2.3793103448275863,1,4,29,0
36430032.0,60,577,9.616666666666667,3,13,3,57
36432528.0,129,1278,9.906976744186046,6,13,3,126
36433822.0,95,730,7.684210526315789,2,10,32,63
36435022.0,79,174,2.2025316455696204,1,5,79,0
36438750.0,335,686,2.047761194029851,1,4,335,0
36439913.0,2,4,2.0,1,3,2,0
36440918.0,429,2101,4.897435897435898,2,8,424,5
36450661.0,48,420,8.75,2,12,5,43
36451266.0,128,292,2.28125,1,4,128,0
36451964.0,322,1620,5.031055900621118,1,8,321,1
36463263.0,46,214,4.6521739130434785,2,8,45,1
36463383.0,70,613,8.757142857142858,3,11,4,66
36465293.0,224,487,2.174107142857143,1,5,224,0
36466477.0,1,3,3.0,3,3,1,0
36467352.0,2,2,1.0,1,1,2,0
36469415.0,115,1113,9.678260869565218,5,12,6,109
36474737.0,18,18,1.0,1,1,18,0
36485114.0,2,11,5.5,3,8,1,1
36500437.0,141,313,2.219858156028369,1,5,141,0
36504271.0,19,59,3.1052631578947367,1,5,19,0
36511648.0,339,711,2.0973451327433628,1,5,339,0
36511731.0,318,655,2.059748427672956,1,5,318,0
36516464.0,1,1,1.0,1,1,1,0
36521818.0,271,2336,8.619926199261993,2,12,35,236
36527902.0,97,952,9.814432989690722,6,12,3,94
36534586.0,250,1252,5.008,2,8,247,3
36535329.0,10,93,9.3,7,11,1,9
36540095.0,9,28,3.111111111111111,1,5,9,0
36540385.0,120,161,1.3416666666666666,1,4,120,0
36543839.0,1,4,4.0,4,4,1,0
36545146.0,9,64,7.111111111111111,5,8,5,4
36548380.0,169,1644,9.727810650887575,2,13,12,157
36561593.0,426,2074,4.868544600938967,2,8,423,3
36575446.0,8,55,6.875,2,9,3,5
36583547.0,145,433,2.986206896551724,1,6,145,0
36587505.0,61,236,3.8688524590163933,1,6,61,0
36614600.0,119,579,4.8655462184873945,2,7,119,0
36617637.0,8,59,7.375,6,9,5,3
36621597.0,2,3,1.5,1,2,2,0
36624897.0,39,304,7.794871794871795,4,10,14,25
36625436.0,2,4,2.0,1,3,2,0
36626892.0,45,129,2.8666666666666667,1,5,45,0
36630350.0,110,975,8.863636363636363,2,12,11,99
36631484.0,48,233,4.854166666666667,3,7,48,0
36634345.0,111,747,6.72972972972973,2,9,78,33
36636547.0,63,143,2.2698412698412698,1,5,63,0
36643872.0,120,471,3.925,1,7,120,0
36649102.0,67,143,2.1343283582089554,1,4,67,0
36667483.0,165,1287,7.8,2,11,53,112
36670375.0,5,8,1.6,1,3,5,0
36679434.0,52,159,3.0576923076923075,1,5,52,0
36696178.0,15,35,2.3333333333333335,1,5,15,0
36699013.0,8,65,8.125,6,10,2,6
36710017.0,108,769,7.12037037037037,5,9,63,45
36716254.0,125,597,4.776,2,7,125,0
36716485.0,132,286,2.1666666666666665,1,5,132,0
36727647.0,2,2,1.0,1,1,2,0
36740330.0,258,525,2.0348837209302326,1,4,258,0
36747221.0,6,37,6.166666666666667,4,8,5,1
36755539.0,10,22,2.2,1,3,10,0
36757263.0,27,77,2.8518518518518516,1,5,27,0
36758200.0,203,1968,9.694581280788178,3,12,11,192
36759091.0,148,1437,9.70945945945946,2,12,5,143
36760070.0,183,729,3.9836065573770494,2,7,183,0
36761240.0,149,459,3.0805369127516777,1,6,149,0
36770132.0,1,3,3.0,3,3,1,0
36778702.0,3,5,1.6666666666666667,1,2,3,0
36784754.0,125,257,2.056,1,4,125,0
36784994.0,33,149,4.515151515151516,2,7,33,0
36785557.0,162,805,4.969135802469136,2,7,162,0
36786434.0,78,607,7.782051282051282,2,10,27,51
36789333.0,1,1,1.0,1,1,1,0
36789885.0,202,1741,8.618811881188119,2,12,29,173
36793575.0,121,454,3.7520661157024793,1,6,121,0
36793635.0,23,46,2.0,1,4,23,0
36801863.0,366,1816,4.961748633879782,3,8,365,1
36809009.0,98,683,6.969387755102041,2,10,67,31
36816172.0,17,30,1.7647058823529411,1,3,17,0
36818172.0,3,7,2.3333333333333335,1,3,3,0
36819056.0,6,12,2.0,1,3,6,0
36823891.0,8,26,3.25,1,5,8,0
36824365.0,28,226,8.071428571428571,6,10,6,22
36824524.0,65,131,2.0153846153846153,1,5,65,0
36824908.0,44,94,2.1363636363636362,1,4,44,0
36826720.0,37,133,3.5945945945945947,2,7,37,0
36831624.0,158,464,2.9367088607594938,1,5,158,0
36834925.0,168,816,4.857142857142857,2,7,168,0
36835122.0,7,70,10.0,9,12,0,7
36854978.0,113,570,5.04424778761062,2,7,113,0
36855745.0,30,40,1.3333333333333333,1,3,30,0
36856411.0,3,4,1.3333333333333333,1,2,3,0
36872262.0,83,563,6.783132530120482,4,10,65,18
36877251.0,94,929,9.882978723404255,5,13,6,88
36878455.0,110,739,6.718181818181818,2,9,80,30
36895132.0,68,329,4.838235294117647,2,8,67,1
36901513.0,1,1,1.0,1,1,1,0
36901843.0,4,4,1.0,1,1,4,0
36903220.0,1,1,1.0,1,1,1,0
36905271.0,1,1,1.0,1,1,1,0
36910286.0,151,737,4.880794701986755,2,8,150,1
36912217.0,209,1442,6.899521531100478,3,9,148,61
36924333.0,166,984,5.927710843373494,2,9,154,12
36925733.0,14,99,7.071428571428571,5,9,9,5
36926747.0,16,129,8.0625,6,9,3,13
36927912.0,89,617,6.932584269662922,3,9,63,26
36934706.0,119,355,2.9831932773109244,1,5,119,0
36944892.0,181,1223,6.7569060773480665,3,9,139,42
36955233.0,11,15,1.3636363636363635,1,3,11,0
36956577.0,361,1809,5.011080332409972,2,8,360,1
36960778.0,212,2004,9.452830188679245,3,12,20,192
36968099.0,8,38,4.75,3,6,8,0
36969394.0,11,40,3.6363636363636362,2,5,11,0
36969586.0,2,3,1.5,1,2,2,0
36969951.0,53,516,9.735849056603774,2,12,4,49
36970307.0,3,4,1.3333333333333333,1,2,3,0
36970745.0,78,527,6.756410256410256,3,9,60,18
36971200.0,16,29,1.8125,1,3,16,0
36971262.0,2,2,1.0,1,1,2,0
36971322.0,113,760,6.725663716814159,2,9,82,31
36972141.0,74,584,7.891891891891892,5,10,24,50
36974011.0,15,89,5.933333333333334,3,8,13,2
36993159.0,2,3,1.5,1,2,2,0
36993248.0,84,426,5.071428571428571,2,8,83,1
36995115.0,33,64,1.9393939393939394,1,5,33,0
36996184.0,2,2,1.0,1,1,2,0
36996659.0,5,11,2.2,2,3,5,0
37001713.0,133,269,2.0225563909774436,1,5,133,0
37003907.0,88,256,2.909090909090909,1,5,88,0
37007643.0,223,1535,6.883408071748879,2,10,155,68
37009498.0,4,6,1.5,1,2,4,0
37010845.0,2,4,2.0,2,2,2,0
37014111.0,11,59,5.363636363636363,4,7,11,0
37028877.0,18,29,1.6111111111111112,1,3,18,0
37035504.0,2,2,1.0,1,1,2,0
37037584.0,241,2332,9.676348547717842,2,13,15,226
37040404.0,279,2675,9.587813620071685,2,12,18,261
37042662.0,1,2,2.0,2,2,1,0
37043508.0,47,233,4.957446808510638,2,7,47,0
37045880.0,63,569,9.031746031746032,4,12,6,57
37046050.0,36,180,5.0,3,7,36,0
37047413.0,73,216,2.958904109589041,1,5,73,0
37048735.0,63,438,6.9523809523809526,2,9,40,23
37048807.0,4,5,1.25,1,2,4,0
37049239.0,3,4,1.3333333333333333,1,2,3,0
37050052.0,2,6,3.0,2,4,2,0
37050860.0,4,4,1.0,1,1,4,0
37053950.0,1,1,1.0,1,1,1,0
37054307.0,2,2,1.0,1,1,2,0
37054813.0,1,1,1.0,1,1,1,0
37055744.0,55,118,2.1454545454545455,1,4,55,0
37064895.0,39,382,9.794871794871796,7,12,1,38
37067245.0,59,401,6.796610169491525,2,9,39,20
37070639.0,10,31,3.1,2,5,10,0
37071786.0,134,919,6.858208955223881,2,10,94,40
37074370.0,112,750,6.696428571428571,2,9,82,30
37084412.0,56,115,2.0535714285714284,1,5,56,0
37084921.0,96,280,2.9166666666666665,1,5,96,0
37087762.0,35,80,2.2857142857142856,1,4,35,0
37101518.0,86,184,2.13953488372093,1,5,86,0
37101967.0,1,4,4.0,4,4,1,0
37106154.0,21,81,3.857142857142857,2,6,21,0
37108692.0,2,4,2.0,2,2,2,0
37115604.0,1,1,1.0,1,1,1,0
37120993.0,192,574,2.9895833333333335,1,6,192,0
37132040.0,91,535,5.8791208791208796,3,8,85,6
37135019.0,96,207,2.15625,1,5,96,0
37140917.0,1,2,2.0,2,2,1,0
37141373.0,186,1277,6.865591397849462,2,10,135,51
37143548.0,57,441,7.7368421052631575,3,11,24,33
37148541.0,3,6,2.0,1,3,3,0
37152536.0,123,359,2.9186991869918697,1,6,123,0
37153661.0,26,125,4.8076923076923075,2,7,26,0
37161797.0,3,24,8.0,7,9,1,2
37164456.0,104,518,4.980769230769231,2,7,104,0
37166909.0,30,40,1.3333333333333333,1,3,30,0
37168584.0,283,1129,3.989399293286219,1,7,283,0
37171006.0,234,711,3.0384615384615383,1,6,234,0
37171278.0,96,479,4.989583333333333,2,7,96,0
37171358.0,33,44,1.3333333333333333,1,3,33,0
37174995.0,4,5,1.25,1,2,4,0
37175643.0,32,218,6.8125,4,9,26,6
37178084.0,12,22,1.8333333333333333,1,4,12,0
37194661.0,14,62,4.428571428571429,3,6,14,0
37201702.0,15,50,3.3333333333333335,2,6,15,0
37203317.0,131,269,2.053435114503817,1,4,131,0
37204248.0,11,21,1.9090909090909092,1,4,11,0
37206309.0,23,223,9.695652173913043,2,12,1,22
37207477.0,39,111,2.8461538461538463,1,5,39,0
37207941.0,31,279,9.0,6,12,5,26
37208116.0,76,526,6.921052631578948,3,9,51,25
37208906.0,70,100,1.4285714285714286,1,3,70,0
37223838.0,5,8,1.6,1,3,5,0
37224745.0,21,42,2.0,1,4,21,0
37231727.0,21,32,1.5238095238095237,1,3,21,0
37244960.0,415,1656,3.9903614457831327,1,7,415,0
37245339.0,62,294,4.741935483870968,2,8,61,1
37247780.0,343,1350,3.935860058309038,1,6,343,0
37248114.0,60,404,6.733333333333333,2,9,43,17
37248869.0,47,231,4.914893617021277,2,7,47,0
37249317.0,338,1355,4.008875739644971,1,7,338,0
37249948.0,334,1335,3.997005988023952,1,7,334,0
37250617.0,319,1249,3.915360501567398,1,7,319,0
37250869.0,2,7,3.5,3,4,2,0
37251104.0,2,20,10.0,9,11,0,2
37251669.0,13,30,2.3076923076923075,1,4,13,0
37251688.0,1,10,10.0,10,10,0,1
37251987.0,109,228,2.091743119266055,1,5,109,0
37252015.0,4,36,9.0,8,10,0,4
37252131.0,1,10,10.0,10,10,0,1
37252327.0,3,28,9.333333333333334,9,10,0,3
37252437.0,1,9,9.0,9,9,0,1
37252509.0,2,17,8.5,8,9,0,2
37260234.0,139,676,4.863309352517986,2,8,138,1
37265851.0,339,1661,4.899705014749262,2,8,338,1
37269115.0,181,1251,6.911602209944752,2,10,120,61
37270948.0,9,90,10.0,9,11,0,9
37272013.0,5,11,2.2,1,3,5,0
37274664.0,173,364,2.1040462427745665,1,4,173,0
37283437.0,176,1228,6.9772727272727275,3,10,119,57
37283862.0,83,160,1.927710843373494,1,6,83,0
37287008.0,37,184,4.972972972972973,3,7,37,0
37293411.0,91,180,1.978021978021978,1,5,91,0
37304252.0,33,47,1.4242424242424243,1,3,33,0
37305672.0,210,444,2.1142857142857143,1,4,210,0
37307999.0,3,3,1.0,1,1,3,0
37308003.0,1,1,1.0,1,1,1,0
37308010.0,2,2,1.0,1,1,2,0
37312787.0,7,25,3.5714285714285716,2,5,7,0
37314001.0,4,22,5.5,5,6,4,0
37314454.0,41,318,7.7560975609756095,3,10,18,23
37317872.0,200,403,2.015,1,5,200,0
37317946.0,224,449,2.0044642857142856,1,5,224,0
37322344.0,175,349,1.9942857142857142,1,4,175,0
37343354.0,157,1552,9.885350318471337,3,13,4,153
37344250.0,13,24,1.8461538461538463,1,3,13,0
37345543.0,26,257,9.884615384615385,5,12,2,24
37355676.0,5,15,3.0,2,4,5,0
37355839.0,127,848,6.677165354330708,2,9,93,34
37381788.0,93,721,7.752688172043011,2,10,27,66
37386433.0,53,267,5.037735849056604,3,7,53,0
37420322.0,184,379,2.0597826086956523,1,6,184,0
37423145.0,81,423,5.222222222222222,2,8,80,1
37441389.0,34,99,2.911764705882353,1,5,34,0
37443970.0,39,275,7.051282051282051,4,9,24,15
37444466.0,203,1807,8.901477832512315,2,12,20,183
37445379.0,321,2836,8.834890965732088,2,12,41,280
37445393.0,12,82,6.833333333333333,4,9,8,4
37447379.0,1,3,3.0,3,3,1,0
37447835.0,10,94,9.4,2,11,1,9
37449930.0,1,4,4.0,4,4,1,0
37451102.0,2,8,4.0,3,5,2,0
37455416.0,15,111,7.4,6,9,8,7
37458926.0,383,1913,4.994778067885117,2,8,379,4
37463460.0,344,2984,8.674418604651162,2,12,50,294
37469756.0,360,2485,6.902777777777778,2,10,241,119
37469803.0,357,2427,6.798319327731092,2,10,254,103
37475514.0,75,149,1.9866666666666666,1,5,75,0
37477467.0,238,488,2.0504201680672267,1,5,238,0
37477616.0,14,40,2.857142857142857,1,4,14,0
37478859.0,102,506,4.96078431372549,2,8,101,1
37478868.0,92,448,4.869565217391305,2,7,92,0
37480609.0,9,46,5.111111111111111,4,7,9,0
37482928.0,1,3,3.0,3,3,1,0
37487246.0,70,335,4.785714285714286,2,7,70,0
37490703.0,13,30,2.3076923076923075,1,3,13,0
37490784.0,27,54,2.0,1,4,27,0
37494030.0,108,1018,9.425925925925926,2,12,9,99
37494274.0,143,1271,8.888111888111888,3,12,11,132
37504688.0,52,457,8.788461538461538,4,11,7,45
37511724.0,108,1045,9.675925925925926,2,12,4,104
37512662.0,26,36,1.3846153846153846,1,2,26,0
37514534.0,98,699,7.13265306122449,2,10,57,41
37514567.0,18,121,6.722222222222222,5,9,13,5
37529331.0,324,2857,8.817901234567902,2,12,33,291
37529655.0,7,10,1.4285714285714286,1,3,7,0
37530291.0,7,44,6.285714285714286,5,7,7,0
37530292.0,12,117,9.75,7,11,1,11
37530813.0,9,59,6.555555555555555,5,8,7,2
37530844.0,230,1998,8.68695652173913,2,12,29,201
37530877.0,22,192,8.727272727272727,2,11,2,20
37542178.0,91,279,3.065934065934066,1,6,91,0
37544196.0,1,3,3.0,3,3,1,0
37545717.0,140,568,4.057142857142857,1,6,140,0
37548074.0,44,316,7.181818181818182,4,10,29,15
37548309.0,94,464,4.9361702127659575,3,7,94,0
37548343.0,55,268,4.872727272727273,3,7,55,0
37548744.0,2,6,3.0,3,3,2,0
37550173.0,1,10,10.0,10,10,0,1
37550231.0,1,3,3.0,3,3,1,0
37560274.0,98,937,9.561224489795919,2,12,5,93
37565327.0,4,6,1.5,1,2,4,0
37565859.0,120,355,2.9583333333333335,1,5,120,0
37579202.0,37,296,8.0,6,10,14,23
37579459.0,147,1312,8.92517006802721,2,12,14,133
37581704.0,258,277,1.073643410852713,1,3,258,0
37583562.0,69,463,6.7101449275362315,4,9,52,17
37585850.0,10,26,2.6,1,4,10,0
37586382.0,4,15,3.75,3,5,4,0
37588604.0,47,50,1.0638297872340425,1,2,47,0
37588686.0,239,1191,4.98326359832636,2,8,235,4
37593346.0,121,251,2.074380165289256,1,4,121,0
37595950.0,9,63,7.0,4,8,5,4
37598111.0,213,466,2.187793427230047,1,6,213,0
37598924.0,195,389,1.994871794871795,1,5,195,0
37604098.0,217,1466,6.755760368663594,2,10,155,62
37605095.0,239,1667,6.97489539748954,2,10,152,87
37612413.0,13,55,4.230769230769231,2,6,13,0
37614083.0,2,8,4.0,3,5,2,0
37614735.0,133,395,2.969924812030075,1,6,133,0
37614939.0,13,63,4.846153846153846,3,7,13,0
37619688.0,3,29,9.666666666666666,9,10,0,3
37620268.0,11,53,4.818181818181818,3,6,11,0
37621669.0,117,468,4.0,2,6,117,0
37624591.0,4,20,5.0,4,6,4,0
37624802.0,7,22,3.142857142857143,2,4,7,0
37624885.0,6,26,4.333333333333333,3,6,6,0
37625386.0,8,37,4.625,3,6,8,0
37628981.0,55,320,5.818181818181818,3,7,55,0
37632033.0,2,7,3.5,3,4,2,0
37638728.0,51,330,6.470588235294118,2,10,39,12
37641577.0,139,711,5.115107913669065,2,7,139,0
37642418.0,203,1389,6.842364532019705,2,10,152,51
37650603.0,14,62,4.428571428571429,2,6,14,0
37662178.0,131,922,7.038167938931298,3,11,89,42
37670080.0,28,227,8.107142857142858,3,10,7,21
37674433.0,119,179,1.504201680672269,1,3,119,0
37675582.0,4,7,1.75,1,3,4,0
37675893.0,247,2432,9.846153846153847,2,12,11,236
37679489.0,3,4,1.3333333333333333,1,2,3,0
37679551.0,61,123,2.0163934426229506,1,5,61,0
37696198.0,66,322,4.878787878787879,2,7,66,0
37696573.0,4,28,7.0,3,9,1,3
37700332.0,153,1049,6.856209150326797,2,10,100,53
37701252.0,157,1062,6.764331210191083,2,10,114,43
37702506.0,171,1181,6.906432748538012,2,10,122,49
37704089.0,50,107,2.14,1,6,50,0
37706633.0,131,879,6.709923664122138,2,10,99,32
37707353.0,448,2202,4.915178571428571,2,8,444,4
37711264.0,90,360,4.0,2,6,90,0
37714618.0,55,366,6.654545454545454,2,9,38,17
37730246.0,66,198,3.0,1,6,66,0
37731283.0,13,31,2.3846153846153846,1,4,13,0
37734937.0,3,20,6.666666666666667,5,8,2,1
37746969.0,60,191,3.183333333333333,1,5,60,0
37750650.0,40,279,6.975,4,10,30,10
37754719.0,77,387,5.025974025974026,3,7,77,0
37766268.0,198,1723,8.702020202020202,2,11,29,169
37770313.0,6,41,6.833333333333333,6,8,5,1
37778464.0,8,52,6.5,4,8,6,2
37778812.0,7,38,5.428571428571429,4,7,7,0
37786272.0,12,29,2.4166666666666665,1,3,12,0
37789743.0,19,167,8.789473684210526,6,11,3,16
37790127.0,50,355,7.1,3,9,29,21
37795098.0,67,130,1.9402985074626866,1,4,67,0
37799117.0,183,913,4.9890710382513666,2,8,181,2
37817140.0,63,182,2.888888888888889,1,4,63,0
37818738.0,134,938,7.0,2,9,93,41
37820932.0,28,87,3.107142857142857,1,5,28,0
37842820.0,27,179,6.62962962962963,3,8,22,5
37845587.0,20,198,9.9,4,13,1,19
37848932.0,11,63,5.7272727272727275,4,7,11,0
37866441.0,244,1652,6.770491803278689,2,9,178,66
37866790.0,11,21,1.9090909090909092,1,3,11,0
37868738.0,61,237,3.8852459016393444,2,6,61,0
37879987.0,7,12,1.7142857142857142,1,3,7,0
37880253.0,26,272,10.461538461538462,9,13,0,26
37895501.0,1,3,3.0,3,3,1,0
37895696.0,5,11,2.2,1,3,5,0
37902553.0,4,12,3.0,1,5,4,0
37924520.0,18,88,4.888888888888889,3,7,18,0
37926435.0,17,113,6.647058823529412,4,9,13,4
37927074.0,13,25,1.9230769230769231,1,3,13,0
37929397.0,1,2,2.0,2,2,1,0
37931443.0,1,1,1.0,1,1,1,0
37932830.0,3,7,2.3333333333333335,1,3,3,0
37935489.0,44,174,3.9545454545454546,1,6,44,0
37935715.0,38,149,3.9210526315789473,2,6,38,0
37940179.0,126,601,4.76984126984127,2,7,126,0
37943029.0,15,150,10.0,6,13,1,14
37951684.0,19,56,2.9473684210526314,2,6,19,0
37954120.0,88,689,7.829545454545454,3,11,32,56
37954206.0,12,22,1.8333333333333333,1,3,12,0
37957019.0,10,24,2.4,1,3,10,0
37958335.0,181,1730,9.558011049723756,2,12,10,171
37964383.0,4,7,1.75,1,3,4,0
37967492.0,7,18,2.5714285714285716,2,3,7,0
37970163.0,130,881,6.776923076923077,3,9,99,31
37986581.0,148,449,3.0337837837837838,1,6,148,0
37986734.0,174,1204,6.919540229885057,2,9,119,55
38004339.0,129,891,6.906976744186046,2,9,90,39
38011908.0,122,465,3.8114754098360657,2,6,122,0
38013373.0,113,330,2.920353982300885,1,5,113,0
38021724.0,45,225,5.0,2,7,45,0
38024009.0,280,2460,8.785714285714286,2,12,27,253
38036504.0,726,2854,3.931129476584022,1,7,726,0
38041194.0,186,931,5.005376344086022,2,8,184,2
38058866.0,16,31,1.9375,1,3,16,0
38067041.0,54,416,7.703703703703703,2,10,19,35
38067400.0,21,153,7.285714285714286,2,10,10,11
38069918.0,19,40,2.1052631578947367,1,4,19,0
38071198.0,20,137,6.85,6,9,16,4
38075422.0,76,151,1.986842105263158,1,4,76,0
38076458.0,78,166,2.128205128205128,1,5,78,0
38077733.0,67,142,2.1194029850746268,1,5,67,0
38079991.0,116,270,2.3275862068965516,1,5,116,0
38080591.0,168,1138,6.773809523809524,2,10,120,48
38083951.0,12,24,2.0,1,3,12,0
38085728.0,7,47,6.714285714285714,5,8,6,1
38091112.0,102,414,4.0588235294117645,2,6,102,0
38095282.0,156,747,4.788461538461538,2,8,155,1
38110538.0,53,349,6.584905660377358,2,10,43,10
38111560.0,27,218,8.074074074074074,6,10,10,17
38117399.0,6,18,3.0,2,4,6,0
38120938.0,31,220,7.096774193548387,3,9,17,14
38122440.0,15,117,7.8,4,11,6,9
38124736.0,310,2107,6.796774193548387,2,10,229,81
38124990.0,3,6,2.0,1,3,3,0
38126440.0,105,1015,9.666666666666666,2,12,6,99
38131084.0,158,478,3.0253164556962027,1,6,158,0
38141513.0,3,25,8.333333333333334,7,10,1,2
38142935.0,17,120,7.0588235294117645,5,9,11,6
38143788.0,37,111,3.0,1,6,37,0
38148303.0,52,439,8.442307692307692,2,11,9,43
38159093.0,4,8,2.0,1,3,4,0
38169475.0,2,5,2.5,2,3,2,0
38169790.0,27,135,5.0,3,7,27,0
38174122.0,7,10,1.4285714285714286,1,2,7,0
38174172.0,4,6,1.5,1,2,4,0
38174219.0,8,9,1.125,1,2,8,0
38174347.0,1,2,2.0,2,2,1,0
38174394.0,16,16,1.0,1,1,16,0
38174437.0,10,10,1.0,1,1,10,0
38174547.0,12,13,1.0833333333333333,1,2,12,0
38174612.0,7,9,1.2857142857142858,1,2,7,0
38174783.0,4,4,1.0,1,1,4,0
38174825.0,5,6,1.2,1,2,5,0
38175047.0,1,2,2.0,2,2,1,0
38175360.0,10,16,1.6,1,3,10,0
38177511.0,19,108,5.684210526315789,3,7,19,0
38180979.0,17,29,1.7058823529411764,1,3,17,0
38197609.0,164,1570,9.573170731707316,2,12,8,156
38204068.0,71,684,9.633802816901408,2,12,4,67
38210602.0,25,123,4.92,3,7,25,0
38215823.0,134,268,2.0,1,4,134,0
38224574.0,1,2,2.0,2,2,1,0
38224976.0,218,2120,9.724770642201834,2,13,12,206
38230027.0,128,1212,9.46875,2,13,12,116
38236685.0,23,152,6.608695652173913,2,9,15,8
38248778.0,84,387,4.607142857142857,2,7,84,0
38251037.0,35,47,1.3428571428571427,1,4,35,0
38251207.0,212,1437,6.778301886792453,3,9,159,53
38252574.0,2,4,2.0,2,2,2,0
38253190.0,142,303,2.1338028169014085,1,4,142,0
38255585.0,68,647,9.514705882352942,2,12,4,64
38257664.0,15,18,1.2,1,3,15,0
38258733.0,100,214,2.14,1,4,100,0
38276452.0,62,139,2.2419354838709675,1,5,62,0
38278364.0,96,377,3.9270833333333335,1,6,96,0
38280338.0,172,870,5.058139534883721,3,8,171,1
38280879.0,172,846,4.9186046511627906,2,8,171,1
38289234.0,85,808,9.505882352941176,4,12,5,80
38289997.0,1,7,7.0,7,7,1,0
38290559.0,8,14,1.75,1,3,8,0
38290572.0,130,1281,9.853846153846154,2,12,3,127
38292651.0,20,44,2.2,1,4,20,0
38294263.0,176,864,4.909090909090909,2,7,176,0
38305932.0,50,160,3.2,1,6,50,0
38308170.0,101,500,4.9504950495049505,2,8,99,2
38308559.0,3,9,3.0,2,4,3,0
38309004.0,142,961,6.767605633802817,2,9,104,38
38309125.0,30,285,9.5,5,12,1,29
38311561.0,8,12,1.5,1,3,8,0
38322594.0,66,459,6.954545454545454,3,9,41,25
38326528.0,1,9,9.0,9,9,0,1
38327703.0,129,864,6.6976744186046515,2,10,98,31
38334324.0,131,899,6.862595419847328,3,11,96,35
38335045.0,99,289,2.919191919191919,1,5,99,0
38340152.0,3,3,1.0,1,1,3,0
38350961.0,76,727,9.56578947368421,3,12,6,70
38351758.0,97,941,9.70103092783505,3,12,5,92
38352950.0,115,1075,9.347826086956522,3,12,13,102
38355863.0,25,77,3.08,1,5,25,0
38358790.0,120,236,1.9666666666666666,1,4,120,0
38367574.0,27,157,5.814814814814815,4,8,25,2
38367708.0,72,102,1.4166666666666667,1,3,72,0
38368070.0,8,44,5.5,4,7,8,0
38368469.0,6,8,1.3333333333333333,1,2,6,0
38368611.0,2,7,3.5,3,4,2,0
38368743.0,6,9,1.5,1,3,6,0
38372034.0,170,520,3.0588235294117645,1,6,170,0
38377612.0,54,72,1.3333333333333333,1,3,54,0
38379381.0,1,6,6.0,6,6,1,0
38385602.0,9,13,1.4444444444444444,1,3,9,0
38393230.0,16,141,8.8125,7,11,1,15
38396053.0,17,115,6.764705882352941,5,9,12,5
38403388.0,143,290,2.027972027972028,1,4,143,0
38404587.0,48,144,3.0,1,5,48,0
38418030.0,12,26,2.1666666666666665,1,3,12,0
38419775.0,217,884,4.073732718894009,1,7,217,0
38445593.0,145,978,6.744827586206896,2,10,102,43
38449139.0,32,71,2.21875,1,4,32,0
38450877.0,35,233,6.6571428571428575,2,8,26,9
38454233.0,1,9,9.0,9,9,0,1
38456747.0,9,20,2.2222222222222223,1,4,9,0
38472428.0,142,1253,8.82394366197183,2,11,11,131
38476167.0,11,23,2.090909090909091,1,3,11,0
38477558.0,128,391,3.0546875,1,6,128,0
38478854.0,308,904,2.935064935064935,1,6,308,0
38480383.0,245,1218,4.9714285714285715,2,7,245,0
38486116.0,2,16,8.0,8,8,0,2
38500236.0,5,15,3.0,2,4,5,0
38504383.0,5,8,1.6,1,2,5,0
38505613.0,213,452,2.1220657276995305,1,5,213,0
38505801.0,8,12,1.5,1,3,8,0
38508150.0,48,309,6.4375,2,9,34,14
38514000.0,3,24,8.0,7,9,1,2
38518053.0,3,4,1.3333333333333333,1,2,3,0
38519936.0,123,1190,9.674796747967479,2,12,7,116
38539338.0,2,9,4.5,4,5,2,0
38542993.0,244,1203,4.930327868852459,1,8,241,3
38548793.0,8,17,2.125,1,4,8,0
38551429.0,135,660,4.888888888888889,2,8,133,2
38559055.0,276,579,2.097826086956522,1,5,276,0
38561368.0,3,15,5.0,5,5,3,0
38561585.0,1,2,2.0,2,2,1,0
38561598.0,7,52,7.428571428571429,6,9,4,3
38562327.0,23,54,2.347826086956522,1,5,23,0
38562350.0,13,37,2.8461538461538463,1,5,13,0
38563555.0,198,1905,9.621212121212121,2,12,11,187
38573071.0,58,119,2.0517241379310347,1,4,58,0
38575193.0,13,46,3.5384615384615383,1,5,13,0
38581379.0,2,5,2.5,2,3,2,0
38591821.0,105,217,2.066666666666667,1,5,105,0
38609990.0,5,9,1.8,1,3,5,0
38612397.0,35,350,10.0,7,12,1,34
38614708.0,44,444,10.090909090909092,5,12,1,43
38617422.0,219,2134,9.744292237442922,2,13,12,207
38620632.0,176,359,2.039772727272727,1,5,176,0
38623082.0,112,549,4.901785714285714,2,9,111,1
38630765.0,2,9,4.5,3,6,2,0
38636937.0,97,829,8.54639175257732,2,11,11,86
38641042.0,108,534,4.944444444444445,2,8,107,1
38644574.0,57,285,5.0,2,7,57,0
38646553.0,97,768,7.917525773195877,2,11,30,67
38650794.0,10,20,2.0,1,4,10,0
38654511.0,48,109,2.2708333333333335,1,5,48,0
38655721.0,4,29,7.25,6,8,2,2
38656826.0,4,9,2.25,2,3,4,0
38658441.0,7,18,2.5714285714285716,1,4,7,0
38659192.0,12,24,2.0,1,3,12,0
38662267.0,365,775,2.1232876712328768,1,6,365,0
38668281.0,22,83,3.772727272727273,1,6,22,0
38669739.0,1,4,4.0,4,4,1,0
38673752.0,87,191,2.1954022988505746,1,4,87,0
38680178.0,26,54,2.076923076923077,1,4,26,0
38684906.0,89,260,2.9213483146067416,1,5,89,0
38685708.0,167,322,1.9281437125748504,1,4,167,0
38695941.0,6,13,2.1666666666666665,1,4,6,0
38697773.0,44,234,5.318181818181818,3,7,44,0
38719248.0,19,106,5.578947368421052,4,8,16,3
38727654.0,350,3007,8.59142857142857,2,12,50,300
38730025.0,25,31,1.24,1,3,25,0
38734882.0,69,466,6.753623188405797,2,9,50,19
38736710.0,48,467,9.729166666666666,4,12,3,45
38740472.0,282,2677,9.49290780141844,2,13,24,258
38744362.0,78,537,6.884615384615385,3,10,52,26
38747735.0,133,370,2.781954887218045,1,5,133,0
38750247.0,216,2029,9.393518518518519,2,13,20,196
38750326.0,34,144,4.235294117647059,1,7,34,0
38764185.0,119,236,1.9831932773109244,1,5,119,0
38765599.0,41,116,2.8292682926829267,1,5,41,0
38766799.0,105,223,2.123809523809524,1,4,105,0
38766913.0,126,249,1.9761904761904763,1,5,126,0
38767417.0,40,309,7.725,4,10,18,22
38768486.0,12,22,1.8333333333333333,1,4,12,0
38775001.0,29,121,4.172413793103448,2,6,29,0
38779846.0,324,662,2.04320987654321,1,4,324,0
38786004.0,35,169,4.828571428571428,3,7,35,0
38786908.0,2,11,5.5,5,6,2,0
38791240.0,164,1601,9.762195121951219,2,12,5,159
38792504.0,43,172,4.0,1,7,43,0
38799907.0,49,277,5.653061224489796,2,8,47,2
38801219.0,124,177,1.4274193548387097,1,4,124,0
38804767.0,232,2184,9.413793103448276,2,13,22,210
38810043.0,23,174,7.565217391304348,3,10,10,13
38812514.0,90,895,9.944444444444445,2,12,3,87
38813113.0,3,9,3.0,3,3,3,0
38813940.0,52,104,2.0,1,4,52,0
38817373.0,341,2327,6.8240469208211145,2,10,243,98
38820946.0,3,5,1.6666666666666667,1,2,3,0
38822180.0,1,3,3.0,3,3,1,0
38822283.0,98,662,6.755102040816326,2,10,69,29
38822286.0,199,610,3.0653266331658293,1,6,199,0
38828895.0,2,15,7.5,6,9,1,1
38831564.0,15,39,2.6,1,4,15,0
38833942.0,39,84,2.1538461538461537,1,4,39,0
38836201.0,626,3073,4.9089456869009584,2,8,621,5
38837824.0,304,1510,4.967105263157895,2,8,301,3
38840531.0,23,52,2.260869565217391,1,4,23,0
38849159.0,2,5,2.5,2,3,2,0
38849265.0,13,97,7.461538461538462,6,9,7,6
38849956.0,215,2074,9.646511627906976,2,13,13,202
38864278.0,14,38,2.7142857142857144,1,4,14,0
38864420.0,7,18,2.5714285714285716,2,4,7,0
38877183.0,62,133,2.1451612903225805,1,5,62,0
38888093.0,298,628,2.1073825503355703,1,5,298,0
38888205.0,178,710,3.9887640449438204,1,7,178,0
38888940.0,264,1300,4.924242424242424,2,8,263,1
38891488.0,252,2413,9.575396825396826,2,12,18,234
38892835.0,104,312,3.0,1,5,104,0
38896960.0,1,1,1.0,1,1,1,0
38899927.0,18,134,7.444444444444445,4,9,7,11
38913384.0,65,318,4.892307692307693,3,8,64,1
38918031.0,94,705,7.5,2,10,38,56
38923979.0,58,292,5.0344827586206895,2,7,58,0
38927628.0,12,19,1.5833333333333333,1,4,12,0
38930283.0,9,16,1.7777777777777777,1,3,9,0
38940528.0,6,13,2.1666666666666665,1,4,6,0
38941454.0,208,619,2.9759615384615383,1,5,208,0
38944212.0,22,139,6.318181818181818,5,8,19,3
38944994.0,88,249,2.8295454545454546,1,5,88,0
38950126.0,4,6,1.5,1,2,4,0
38955551.0,177,863,4.875706214689266,2,8,176,1
38978476.0,283,2761,9.756183745583039,2,13,13,270
38989483.0,1,3,3.0,3,3,1,0
38990974.0,19,154,8.105263157894736,6,9,2,17
38992720.0,178,1566,8.797752808988765,2,12,18,160
38992791.0,9,64,7.111111111111111,6,8,5,4
38999941.0,4,5,1.25,1,2,4,0
39003945.0,71,349,4.915492957746479,2,8,70,1
39012437.0,11,52,4.7272727272727275,2,7,11,0
39013736.0,50,403,8.06,4,10,15,35
39016744.0,34,151,4.4411764705882355,1,7,34,0
39019749.0,124,359,2.8951612903225805,1,5,124,0
39020275.0,3,5,1.6666666666666667,1,2,3,0
39022350.0,188,1783,9.48404255319149,2,12,19,169
39026573.0,159,917,5.767295597484277,3,8,153,6
39027506.0,1,2,2.0,2,2,1,0
39027938.0,101,968,9.584158415841584,3,12,6,95
39040283.0,42,62,1.4761904761904763,1,4,42,0
39045649.0,20,78,3.9,2,6,20,0
39048265.0,2,3,1.5,1,2,2,0
39051336.0,17,46,2.7058823529411766,2,4,17,0
39052040.0,19,105,5.526315789473684,4,7,19,0
39059183.0,227,467,2.05726872246696,1,5,227,0
39064626.0,20,186,9.3,5,12,2,18
39068967.0,31,157,5.064516129032258,4,7,31,0
39069219.0,43,219,5.093023255813954,2,7,43,0
39069609.0,3,9,3.0,3,3,3,0
39070414.0,119,252,2.1176470588235294,1,5,119,0
39078851.0,6,13,2.1666666666666665,2,3,6,0
39099046.0,187,558,2.983957219251337,1,6,187,0
39100535.0,29,204,7.0344827586206895,5,9,20,9
39108689.0,1,4,4.0,4,4,1,0
39113906.0,30,61,2.033333333333333,1,5,30,0
39120872.0,49,478,9.755102040816327,4,12,3,46
39127372.0,273,580,2.1245421245421245,1,5,273,0
39128229.0,4,14,3.5,3,4,4,0
39128502.0,95,827,8.705263157894738,2,11,10,85
39129149.0,103,893,8.669902912621358,2,11,11,92
39131373.0,53,206,3.8867924528301887,2,6,53,0
39131376.0,131,501,3.8244274809160306,1,7,131,0
39131380.0,75,292,3.8933333333333335,1,6,75,0
39131383.0,59,232,3.9322033898305087,1,7,59,0
39131384.0,84,337,4.011904761904762,2,6,84,0
39131883.0,77,542,7.038961038961039,3,10,47,30
39135541.0,17,26,1.5294117647058822,1,4,17,0
39135751.0,6,7,1.1666666666666667,1,2,6,0
39142021.0,93,814,8.75268817204301,3,12,12,81
39146485.0,6,43,7.166666666666667,6,9,4,2
39160694.0,1,4,4.0,4,4,1,0
39171984.0,109,1065,9.770642201834862,4,13,6,103
39175317.0,10,51,5.1,3,7,10,0
39184786.0,142,1090,7.676056338028169,2,11,58,84
39187307.0,191,409,2.141361256544503,1,5,191,0
39198490.0,306,933,3.049019607843137,1,6,306,0
39210568.0,11,19,1.7272727272727273,1,3,11,0
39210798.0,121,594,4.909090909090909,2,8,119,2
39213662.0,77,302,3.9220779220779223,2,6,77,0
39215455.0,15,75,5.0,4,6,15,0
39219282.0,11,32,2.909090909090909,1,5,11,0
39222588.0,1,8,8.0,8,8,0,1
39226848.0,23,233,10.130434782608695,9,12,0,23
39236076.0,87,704,8.091954022988507,3,11,22,65
39236650.0,134,681,5.082089552238806,2,8,133,1
39243292.0,40,78,1.95,1,4,40,0
39244347.0,173,855,4.942196531791907,2,7,173,0
39244866.0,100,687,6.87,2,9,67,33
39245502.0,50,346,6.92,3,10,34,16
39248656.0,1,4,4.0,4,4,1,0
39249261.0,71,422,5.943661971830986,4,9,67,4
39262603.0,31,216,6.967741935483871,4,9,22,9
39263271.0,39,270,6.923076923076923,4,8,26,13
39266465.0,43,308,7.162790697674419,5,9,28,15
39272093.0,66,273,4.136363636363637,1,6,66,0
39274256.0,1,3,3.0,3,3,1,0
39288347.0,114,238,2.087719298245614,1,4,114,0
39298196.0,1,1,1.0,1,1,1,0
39314926.0,2,12,6.0,6,6,2,0
39316508.0,10,71,7.1,3,9,6,4
39318826.0,107,309,2.8878504672897196,1,5,107,0
39331586.0,6,13,2.1666666666666665,1,3,6,0
39334159.0,164,659,4.0182926829268295,1,7,164,0
39335277.0,16,21,1.3125,1,2,16,0
39349151.0,1,2,2.0,2,2,1,0
39353772.0,220,640,2.909090909090909,1,6,220,0
39355787.0,54,371,6.87037037037037,3,10,38,16
39357326.0,84,394,4.690476190476191,2,7,84,0
39358129.0,3,6,2.0,1,3,3,0
39360895.0,273,1898,6.9523809523809526,3,10,180,93
39361390.0,94,933,9.925531914893616,5,12,1,93
39361911.0,311,641,2.0610932475884245,1,5,311,0
39361915.0,216,436,2.0185185185185186,1,6,216,0
39364601.0,36,361,10.027777777777779,6,13,1,35
39365098.0,12,41,3.4166666666666665,2,5,12,0
39386698.0,28,59,2.107142857142857,1,4,28,0
39388777.0,67,577,8.611940298507463,4,11,8,59
39388959.0,49,347,7.081632653061225,2,10,32,17
39401130.0,261,1261,4.831417624521073,2,8,260,1
39403942.0,15,89,5.933333333333334,5,7,15,0
39407364.0,160,615,3.84375,2,7,160,0
39412574.0,48,102,2.125,1,5,48,0
39427036.0,9,43,4.777777777777778,4,6,9,0
39429230.0,153,751,4.908496732026144,2,7,153,0
39430632.0,10,81,8.1,7,9,3,7
39430643.0,209,438,2.0956937799043063,1,5,209,0
39433528.0,6,42,7.0,5,8,3,3
39438646.0,93,804,8.64516129032258,3,11,9,84
39441545.0,135,912,6.7555555555555555,2,10,105,30
39443120.0,137,292,2.1313868613138687,1,5,137,0
39449594.0,5,16,3.2,2,6,5,0
39452100.0,2,3,1.5,1,2,2,0
39459173.0,17,47,2.764705882352941,1,4,17,0
39462693.0,48,460,9.583333333333334,3,12,5,43
39466024.0,160,782,4.8875,2,7,160,0
39480856.0,51,101,1.9803921568627452,1,4,51,0
39482427.0,4,9,2.25,1,3,4,0
39482590.0,128,999,7.8046875,2,10,46,82
39497555.0,11,18,1.6363636363636365,1,3,11,0
39497594.0,29,233,8.03448275862069,5,10,9,20
39502539.0,91,726,7.978021978021978,2,10,27,64
39504398.0,20,158,7.9,6,9,7,13
39505863.0,14,20,1.4285714285714286,1,3,14,0
39513802.0,9,47,5.222222222222222,4,6,9,0
39514209.0,12,60,5.0,3,6,12,0
39517407.0,38,252,6.631578947368421,3,10,28,10
39519445.0,5,14,2.8,2,4,5,0
39521170.0,93,368,3.956989247311828,1,6,93,0
39524331.0,20,105,5.25,3,7,20,0
39541292.0,33,173,5.242424242424242,2,7,33,0
39542549.0,10,46,4.6,4,7,10,0
39543328.0,4,22,5.5,4,6,4,0
39544001.0,14,73,5.214285714285714,3,8,13,1
39544143.0,3,18,6.0,6,6,3,0
39546940.0,81,405,5.0,2,7,81,0
39547263.0,30,65,2.1666666666666665,1,5,30,0
39548240.0,7,33,4.714285714285714,3,7,7,0
39549989.0,51,66,1.2941176470588236,1,2,51,0
39550203.0,49,68,1.3877551020408163,1,3,49,0
39550273.0,197,267,1.3553299492385786,1,4,197,0
39550335.0,11,23,2.090909090909091,1,3,11,0
39550374.0,90,123,1.3666666666666667,1,3,90,0
39568259.0,39,94,2.41025641025641,1,5,39,0
39579267.0,203,1383,6.812807881773399,2,9,148,55
39584132.0,10,85,8.5,7,10,2,8
39584461.0,6,13,2.1666666666666665,1,4,6,0
39593446.0,1,8,8.0,8,8,0,1
39598264.0,90,795,8.833333333333334,3,11,10,80
39602814.0,1,1,1.0,1,1,1,0
39609742.0,1,1,1.0,1,1,1,0
39609855.0,21,127,6.0476190476190474,2,8,19,2
39610001.0,24,32,1.3333333333333333,1,3,24,0
39610067.0,18,38,2.111111111111111,1,4,18,0
39619462.0,76,96,1.263157894736842,1,3,76,0
39620139.0,47,62,1.3191489361702127,1,4,47,0
39620241.0,46,74,1.608695652173913,1,4,46,0
39620317.0,78,107,1.3717948717948718,1,3,78,0
39620377.0,62,87,1.403225806451613,1,3,62,0
39620901.0,292,1454,4.97945205479452,2,8,289,3
39622401.0,145,1393,9.606896551724137,2,13,8,137
39626544.0,219,467,2.132420091324201,1,5,219,0
39629741.0,195,1864,9.558974358974359,2,13,13,182
39629977.0,5,17,3.4,3,4,5,0
39631513.0,2,5,2.5,1,4,2,0
39638907.0,3,25,8.333333333333334,8,9,0,3
39640495.0,2,6,3.0,2,4,2,0
39641034.0,5,9,1.8,1,2,5,0
39643204.0,17,153,9.0,8,11,0,17
39657532.0,140,535,3.8214285714285716,1,7,140,0
39657825.0,26,193,7.423076923076923,2,10,12,14
39658775.0,35,269,7.685714285714286,2,10,13,22
39659258.0,26,201,7.730769230769231,2,10,9,17
39665688.0,40,195,4.875,3,8,39,1
39670157.0,6,20,3.3333333333333335,2,4,6,0
39670684.0,24,174,7.25,6,9,16,8
39671405.0,27,191,7.074074074074074,3,9,16,11
39672576.0,119,169,1.4201680672268908,1,3,119,0
39682849.0,25,50,2.0,1,4,25,0
39683625.0,195,764,3.917948717948718,1,6,195,0
39684538.0,217,871,4.013824884792626,1,7,217,0
39685131.0,70,277,3.9571428571428573,2,8,69,1
39687865.0,43,378,8.790697674418604,2,11,4,39
39691167.0,3,5,1.6666666666666667,1,3,3,0
39696249.0,5,15,3.0,2,5,5,0
39705647.0,126,629,4.992063492063492,2,8,124,2
39709705.0,6,56,9.333333333333334,8,10,0,6
39709711.0,50,254,5.08,3,7,50,0
39709712.0,64,327,5.109375,2,8,63,1
39709715.0,153,762,4.980392156862745,2,8,152,1
39710402.0,118,600,5.084745762711864,2,8,117,1
39710829.0,284,579,2.038732394366197,1,5,284,0
39717339.0,131,885,6.755725190839694,2,10,103,28
39717480.0,396,1997,5.042929292929293,2,8,393,3
39719010.0,1,1,1.0,1,1,1,0
39720515.0,181,747,4.12707182320442,2,7,181,0
39721540.0,14,18,1.2857142857142858,1,4,14,0
39722328.0,207,783,3.782608695652174,1,6,207,0
39725537.0,9,21,2.3333333333333335,1,4,9,0
39737581.0,11,36,3.272727272727273,1,5,11,0
39739019.0,178,348,1.9550561797752808,1,5,178,0
39739171.0,121,933,7.710743801652892,2,11,45,76
39740792.0,172,685,3.9825581395348837,1,7,172,0
39744574.0,38,151,3.973684210526316,3,6,38,0
39744597.0,54,213,3.9444444444444446,2,6,54,0
39744599.0,35,146,4.171428571428572,2,7,35,0
39745315.0,9,28,3.111111111111111,2,4,9,0
39746159.0,1,1,1.0,1,1,1,0
39747236.0,28,275,9.821428571428571,7,12,1,27
39748921.0,70,465,6.642857142857143,2,9,51,19
39748963.0,2,4,2.0,1,3,2,0
39749298.0,183,741,4.049180327868853,1,7,183,0
39749508.0,90,606,6.733333333333333,3,9,64,26
39749940.0,67,462,6.895522388059701,2,10,44,23
39750038.0,141,550,3.900709219858156,1,7,141,0
39751309.0,33,129,3.909090909090909,2,6,33,0
39751495.0,2,4,2.0,2,2,2,0
39754679.0,168,688,4.095238095238095,1,7,168,0
39756628.0,157,314,2.0,1,4,157,0
39762001.0,86,275,3.197674418604651,1,6,86,0
39765598.0,93,440,4.731182795698925,2,7,93,0
39769523.0,54,107,1.9814814814814814,1,4,54,0
39771508.0,11,32,2.909090909090909,1,4,11,0
39771607.0,8,43,5.375,3,6,8,0
39791980.0,3,25,8.333333333333334,8,9,0,3
39792606.0,114,559,4.9035087719298245,3,7,114,0
39793141.0,43,184,4.27906976744186,2,6,43,0
39793165.0,32,67,2.09375,1,4,32,0
39796446.0,213,1449,6.802816901408451,2,9,163,50
39800527.0,6,11,1.8333333333333333,1,3,6,0
39809087.0,6,16,2.6666666666666665,2,4,6,0
39815085.0,1,3,3.0,3,3,1,0
39815178.0,527,5062,9.605313092979127,2,14,25,502
39817032.0,40,401,10.025,3,12,1,39
39822459.0,6,18,3.0,1,4,6,0
39825822.0,33,45,1.3636363636363635,1,3,33,0
39826750.0,31,64,2.064516129032258,1,4,31,0
39831307.0,43,117,2.7209302325581395,1,6,43,0
39831678.0,44,57,1.2954545454545454,1,3,44,0
39835487.0,23,48,2.0869565217391304,1,3,23,0
39838022.0,118,480,4.067796610169491,2,6,118,0
39842252.0,54,207,3.8333333333333335,2,6,54,0
39849809.0,9,41,4.555555555555555,2,6,9,0
39863808.0,4,7,1.75,1,3,4,0
39879523.0,20,102,5.1,4,7,20,0
39881066.0,49,234,4.775510204081633,3,7,49,0
39882270.0,33,81,2.4545454545454546,1,5,33,0
39883319.0,185,394,2.1297297297297297,1,5,185,0
39884575.0,78,554,7.102564102564102,2,10,52,26
39885481.0,21,43,2.0476190476190474,1,4,21,0
39885528.0,17,37,2.176470588235294,1,3,17,0
39887396.0,180,389,2.161111111111111,1,5,180,0
39889343.0,29,119,4.103448275862069,2,6,29,0
39893761.0,6,15,2.5,2,3,6,0
39895614.0,1,2,2.0,2,2,1,0
39906964.0,2,2,1.0,1,1,2,0
39907707.0,10,25,2.5,1,4,10,0
39910771.0,12,119,9.916666666666666,5,12,1,11
39911271.0,1,2,2.0,2,2,1,0
39913478.0,196,368,1.8775510204081634,1,4,196,0
39913667.0,7,14,2.0,1,3,7,0
39917463.0,128,891,6.9609375,2,9,86,42
39921330.0,1,1,1.0,1,1,1,0
39921401.0,125,872,6.976,3,10,84,41
39930270.0,1,2,2.0,2,2,1,0
39930613.0,44,345,7.840909090909091,5,11,15,29
39931537.0,1,2,2.0,2,2,1,0
39931581.0,1,2,2.0,2,2,1,0
39931665.0,1,2,2.0,2,2,1,0
39933082.0,85,242,2.847058823529412,1,6,85,0
39937428.0,55,376,6.836363636363636,2,9,37,18
39938846.0,140,293,2.092857142857143,1,4,140,0
39939701.0,30,209,6.966666666666667,2,9,21,9
39939908.0,35,73,2.085714285714286,1,5,35,0
39947047.0,144,699,4.854166666666667,2,8,143,1
39947070.0,18,131,7.277777777777778,5,8,9,9
39948469.0,99,134,1.3535353535353536,1,4,99,0
39950170.0,90,863,9.588888888888889,2,12,7,83
39954156.0,208,432,2.076923076923077,1,5,208,0
39957473.0,53,250,4.716981132075472,2,7,53,0
39962039.0,36,146,4.055555555555555,2,7,36,0
39962394.0,28,102,3.642857142857143,1,6,28,0
39967851.0,193,390,2.0207253886010363,1,5,193,0
39970225.0,128,256,2.0,1,4,128,0
39980872.0,95,450,4.7368421052631575,2,7,95,0
39981319.0,128,1244,9.71875,2,12,7,121
39981812.0,3,8,2.6666666666666665,2,3,3,0
39982406.0,8,19,2.375,1,4,8,0
39984157.0,1,1,1.0,1,1,1,0
39986357.0,18,105,5.833333333333333,4,7,18,0
39987127.0,71,480,6.76056338028169,3,9,51,20
39995735.0,1,2,2.0,2,2,1,0
39999171.0,8,13,1.625,1,3,8,0
40003700.0,1,4,4.0,4,4,1,0
40006167.0,24,46,1.9166666666666667,1,3,24,0
40006673.0,17,131,7.705882352941177,6,10,10,7
40007208.0,205,616,3.004878048780488,1,5,205,0
40020359.0,198,967,4.883838383838384,2,8,197,1
40023621.0,9,17,1.8888888888888888,1,4,9,0
40023752.0,6,17,2.8333333333333335,2,4,6,0
40024546.0,247,517,2.0931174089068825,1,5,247,0
40025365.0,211,440,2.085308056872038,1,4,211,0
40028286.0,26,208,8.0,6,10,8,18
40029083.0,197,412,2.0913705583756346,1,4,197,0
40031317.0,139,1339,9.633093525179856,3,12,11,128
40041590.0,175,517,2.954285714285714,1,5,175,0
40049572.0,2,4,2.0,1,3,2,0
40050773.0,138,1192,8.63768115942029,2,12,17,121
40053953.0,131,271,2.068702290076336,1,4,131,0
40055399.0,50,480,9.6,6,13,3,47
40055460.0,19,31,1.631578947368421,1,4,19,0
40056444.0,120,237,1.975,1,4,120,0
40060521.0,20,91,4.55,3,7,20,0
40061239.0,7,16,2.2857142857142856,1,3,7,0
40066126.0,56,168,3.0,1,5,56,0
40074700.0,402,3522,8.761194029850746,2,12,41,361
40078144.0,128,662,5.171875,2,7,128,0
40079044.0,22,42,1.9090909090909092,1,4,22,0
40079088.0,131,1119,8.541984732824428,2,11,22,109
40084819.0,70,343,4.9,2,7,70,0
40089747.0,1,8,8.0,8,8,0,1
40092178.0,2,4,2.0,1,3,2,0
40098112.0,94,484,5.148936170212766,3,7,94,0
40099947.0,154,298,1.9350649350649352,1,5,154,0
40100287.0,3,3,1.0,1,1,3,0
40101463.0,135,281,2.0814814814814815,1,4,135,0
40101840.0,37,77,2.081081081081081,1,3,37,0
40105458.0,5,25,5.0,3,7,5,0
40107333.0,6,14,2.3333333333333335,1,3,6,0
40125288.0,6,9,1.5,1,2,6,0
40125531.0,108,213,1.9722222222222223,1,5,108,0
40126829.0,7,17,2.4285714285714284,1,4,7,0
40126979.0,12,28,2.3333333333333335,1,4,12,0
40127099.0,27,52,1.9259259259259258,1,4,27,0
40127270.0,12,32,2.6666666666666665,2,4,12,0
40127289.0,4,30,7.5,6,9,2,2
40127364.0,52,365,7.019230769230769,3,9,33,19
40127818.0,62,138,2.225806451612903,1,5,62,0
40148746.0,12,20,1.6666666666666667,1,3,12,0
40151053.0,178,1714,9.629213483146067,3,13,16,162
40165365.0,126,629,4.992063492063492,3,7,126,0
40167896.0,166,1618,9.74698795180723,2,13,6,160
40171520.0,1,2,2.0,2,2,1,0
40177073.0,51,96,1.8823529411764706,1,4,51,0
40177965.0,1,4,4.0,4,4,1,0
40179191.0,10,22,2.2,1,3,10,0
40181695.0,2,5,2.5,2,3,2,0
40184755.0,45,423,9.4,2,13,5,40
40185624.0,47,332,7.0638297872340425,2,9,26,21
40188912.0,109,544,4.990825688073395,2,7,109,0
40188940.0,227,468,2.0616740088105727,1,5,227,0
40189355.0,274,1629,5.945255474452555,2,9,257,17
40189764.0,1,2,2.0,2,2,1,0
40191565.0,17,39,2.2941176470588234,1,4,17,0
40192408.0,2,7,3.5,3,4,2,0
40193237.0,267,812,3.041198501872659,1,6,267,0
40198182.0,55,164,2.981818181818182,1,5,55,0
40200113.0,67,579,8.64179104477612,2,11,8,59
40204112.0,196,378,1.9285714285714286,1,5,196,0
40205929.0,12,69,5.75,4,8,11,1
40218442.0,108,541,5.0092592592592595,2,8,106,2
40225286.0,27,56,2.074074074074074,1,4,27,0
40225288.0,23,67,2.9130434782608696,2,6,23,0
40226384.0,54,251,4.648148148148148,2,7,54,0
40230023.0,59,517,8.76271186440678,2,12,4,55
40233384.0,127,498,3.921259842519685,1,7,127,0
40235124.0,14,24,1.7142857142857142,1,3,14,0
40244503.0,86,176,2.046511627906977,1,6,86,0
40249448.0,8,28,3.5,3,5,8,0
40254070.0,118,797,6.754237288135593,2,9,90,28
40264228.0,162,1258,7.765432098765432,2,11,63,99
40269611.0,1,3,3.0,3,3,1,0
40273910.0,14,89,6.357142857142857,5,8,13,1
40279591.0,48,70,1.4583333333333333,1,3,48,0
40279623.0,11,109,9.909090909090908,8,11,0,11
40279646.0,39,78,2.0,1,4,39,0
40282544.0,159,1544,9.71069182389937,3,13,6,153
40282916.0,52,361,6.9423076923076925,3,10,33,19
40286024.0,8,51,6.375,5,8,7,1
40288020.0,236,1617,6.851694915254237,2,10,173,63
40298355.0,3,24,8.0,7,9,1,2
40298673.0,349,2711,7.767908309455588,2,11,118,231
40300115.0,10,20,2.0,1,3,10,0
40300131.0,384,774,2.015625,1,5,384,0
40301126.0,7,20,2.857142857142857,1,4,7,0
40308903.0,17,67,3.9411764705882355,2,6,17,0
40309133.0,1,1,1.0,1,1,1,0
40320920.0,73,299,4.095890410958904,2,7,73,0
40321629.0,3,6,2.0,1,3,3,0
40323613.0,15,44,2.933333333333333,1,4,15,0
40327487.0,35,196,5.6,4,7,35,0
40333217.0,50,249,4.98,3,7,50,0
40343449.0,7,64,9.142857142857142,3,12,1,6
40345778.0,141,693,4.914893617021277,2,8,140,1
40346765.0,1,3,3.0,3,3,1,0
40348288.0,76,112,1.4736842105263157,1,3,76,0
40357568.0,148,730,4.9324324324324325,2,8,146,2
40359997.0,9,61,6.777777777777778,4,8,6,3
40363744.0,69,479,6.942028985507246,3,9,46,23
40366556.0,213,2068,9.708920187793428,2,13,13,200
40367678.0,32,43,1.34375,1,3,32,0
40367684.0,17,21,1.2352941176470589,1,3,17,0
40367689.0,22,47,2.1363636363636362,1,5,22,0
40369500.0,13,115,8.846153846153847,5,12,1,12
40383325.0,6,23,3.8333333333333335,3,4,6,0
40387691.0,68,608,8.941176470588236,4,13,9,59
40390872.0,61,134,2.19672131147541,1,5,61,0
40393619.0,65,629,9.676923076923076,2,13,6,59
40394513.0,1,1,1.0,1,1,1,0
40394570.0,161,792,4.919254658385094,2,8,160,1
40394918.0,1,3,3.0,3,3,1,0
40395481.0,36,79,2.1944444444444446,1,5,36,0
40395872.0,15,43,2.8666666666666667,2,4,15,0
40398170.0,94,202,2.148936170212766,1,4,94,0
40398478.0,3,7,2.3333333333333335,2,3,3,0
40410512.0,131,398,3.0381679389312977,1,6,131,0
40415865.0,280,1919,6.853571428571429,2,10,203,77
40418001.0,1,2,2.0,2,2,1,0
40422127.0,1,7,7.0,7,7,1,0
40423132.0,1,2,2.0,2,2,1,0
40423444.0,1,4,4.0,4,4,1,0
40425354.0,464,1859,4.006465517241379,1,7,464,0
40425978.0,1,1,1.0,1,1,1,0
40427294.0,2,4,2.0,2,2,2,0
40439322.0,139,273,1.9640287769784173,1,4,139,0
40441056.0,2,5,2.5,2,3,2,0
40449006.0,1,3,3.0,3,3,1,0
40459093.0,16,34,2.125,1,4,16,0
40462875.0,113,225,1.991150442477876,1,4,113,0
40469244.0,3,21,7.0,6,8,2,1
40470500.0,1,2,2.0,2,2,1,0
40479017.0,4,10,2.5,2,4,4,0
40479806.0,1,2,2.0,2,2,1,0
40481241.0,155,318,2.0516129032258066,1,5,155,0
40485707.0,24,230,9.583333333333334,7,12,1,23
40485709.0,11,105,9.545454545454545,6,11,1,10
40486230.0,1,4,4.0,4,4,1,0
40490125.0,21,65,3.0952380952380953,1,5,21,0
40503975.0,138,1335,9.673913043478262,2,12,9,129
40508866.0,5,9,1.8,1,4,5,0
40509148.0,24,115,4.791666666666667,2,7,24,0
40519874.0,94,658,7.0,3,10,67,27
40531779.0,6,13,2.1666666666666665,1,3,6,0
40533219.0,109,151,1.385321100917431,1,3,109,0
40536112.0,1,8,8.0,8,8,0,1
40536219.0,9,82,9.11111111111111,8,10,0,9
40536919.0,3,24,8.0,7,9,1,2
40538012.0,149,1306,8.765100671140939,3,12,15,134
40545570.0,25,154,6.16,5,8,22,3
40545735.0,2,3,1.5,1,2,2,0
40550550.0,3,5,1.6666666666666667,1,2,3,0
40551167.0,27,112,4.148148148148148,3,6,27,0
40551614.0,124,384,3.096774193548387,1,5,124,0
40553229.0,179,363,2.0279329608938546,1,4,179,0
40554186.0,125,258,2.064,1,4,125,0
40556903.0,137,931,6.795620437956204,4,9,104,33
40565109.0,3,8,2.6666666666666665,2,3,3,0
40571206.0,76,744,9.789473684210526,3,13,5,71
40571371.0,5,8,1.6,1,3,5,0
40572004.0,3,9,3.0,3,3,3,0
40577914.0,264,1813,6.867424242424242,2,9,181,83
40581778.0,3,17,5.666666666666667,2,8,2,1
40582987.0,267,1797,6.730337078651686,2,10,187,80
40585138.0,18,39,2.1666666666666665,1,4,18,0
40585946.0,68,99,1.4558823529411764,1,3,68,0
40591557.0,1,1,1.0,1,1,1,0
40592877.0,177,1208,6.824858757062147,3,10,120,57
40593464.0,1,10,10.0,10,10,0,1
40593588.0,3,29,9.666666666666666,9,10,0,3
40593913.0,20,178,8.9,7,10,2,18
40604365.0,17,105,6.176470588235294,2,9,15,2
40604846.0,180,359,1.9944444444444445,1,4,180,0
40609549.0,28,189,6.75,5,9,22,6
40612872.0,10,31,3.1,2,5,10,0
40613426.0,119,1156,9.714285714285714,4,12,6,113
40615277.0,167,342,2.0479041916167664,1,4,167,0
40616514.0,12,38,3.1666666666666665,1,5,12,0
40627042.0,18,65,3.611111111111111,2,6,18,0
40628331.0,25,188,7.52,2,10,9,16
40629483.0,16,158,9.875,7,12,1,15
40633185.0,3,15,5.0,4,6,3,0
40634524.0,189,941,4.978835978835979,2,8,188,1
40639421.0,32,64,2.0,1,4,32,0
40645288.0,1,8,8.0,8,8,0,1
40646532.0,29,281,9.689655172413794,7,11,2,27
40646568.0,59,388,6.576271186440678,2,8,49,10
40648374.0,31,234,7.548387096774194,4,9,13,18
40650882.0,35,139,3.9714285714285715,2,7,35,0
40664698.0,1,10,10.0,10,10,0,1
40664971.0,3,3,1.0,1,1,3,0
40667922.0,87,592,6.804597701149425,4,9,66,21
40673138.0,61,308,5.049180327868853,3,7,61,0
40677375.0,45,221,4.911111111111111,3,7,45,0
40689374.0,1,4,4.0,4,4,1,0
40691779.0,145,305,2.103448275862069,1,4,145,0
40692233.0,18,99,5.5,3,7,18,0
40694778.0,1,2,2.0,2,2,1,0
40696680.0,114,1098,9.631578947368421,3,13,8,106
40699163.0,1,1,1.0,1,1,1,0
40699519.0,12,82,6.833333333333333,5,8,8,4
40700981.0,4,4,1.0,1,1,4,0
40721558.0,105,825,7.857142857142857,4,10,32,73
40723595.0,6,51,8.5,7,9,1,5
40727803.0,1,9,9.0,9,9,0,1
40730317.0,99,678,6.848484848484849,2,9,70,29
40752289.0,1,7,7.0,7,7,1,0
40756424.0,21,105,5.0,3,7,21,0
40756750.0,22,121,5.5,4,7,22,0
40768015.0,48,325,6.770833333333333,4,9,35,13
40768196.0,28,58,2.0714285714285716,1,4,28,0
40771697.0,1,7,7.0,7,7,1,0
40795209.0,162,334,2.0617283950617282,1,5,162,0
40796776.0,130,268,2.0615384615384613,1,5,130,0
40799979.0,96,653,6.802083333333333,3,10,70,26
40801256.0,60,403,6.716666666666667,2,9,42,18
40811117.0,1,8,8.0,8,8,0,1
40811315.0,52,107,2.0576923076923075,1,5,52,0
40812649.0,88,783,8.897727272727273,4,12,6,82
40814641.0,2,5,2.5,2,3,2,0
40815322.0,33,249,7.545454545454546,2,10,16,17
40815855.0,19,28,1.4736842105263157,1,3,19,0
40817502.0,146,724,4.958904109589041,2,8,144,2
40830809.0,101,418,4.138613861386139,2,7,101,0
40836347.0,228,1564,6.859649122807017,2,9,163,65
40852292.0,99,198,2.0,1,4,99,0
40853536.0,70,330,4.714285714285714,3,7,70,0
40853670.0,106,317,2.990566037735849,1,5,106,0
40856598.0,249,1704,6.843373493975903,2,10,171,78
40857720.0,3,23,7.666666666666667,7,8,1,2
40857770.0,9,46,5.111111111111111,4,7,9,0
40862669.0,208,1406,6.759615384615385,2,9,148,60
40873225.0,5,31,6.2,5,7,5,0
40876680.0,18,23,1.2777777777777777,1,3,18,0
40877848.0,26,177,6.8076923076923075,5,10,20,6
40878853.0,6,13,2.1666666666666665,1,4,6,0
40882251.0,125,852,6.816,2,9,86,39
40883860.0,27,77,2.8518518518518516,1,5,27,0
40885200.0,19,103,5.421052631578948,2,7,19,0
40885620.0,14,95,6.785714285714286,3,9,10,4
40888494.0,2,18,9.0,8,10,0,2
40890131.0,20,134,6.7,3,9,15,5
40893916.0,402,3952,9.83084577114428,2,14,17,385
40905713.0,251,2436,9.705179282868526,2,13,15,236
40905731.0,17,87,5.117647058823529,2,9,16,1
40906114.0,367,3529,9.615803814713896,2,13,19,348
40906924.0,170,358,2.1058823529411765,1,5,170,0
40908123.0,22,62,2.8181818181818183,1,4,22,0
40909218.0,264,2546,9.643939393939394,2,13,19,245
40910744.0,1,3,3.0,3,3,1,0
40911914.0,133,1174,8.827067669172932,3,11,12,121
40914285.0,4,28,7.0,6,8,3,1
40914462.0,253,1278,5.051383399209486,2,8,252,1
40916655.0,62,299,4.82258064516129,2,7,62,0
40921457.0,34,139,4.088235294117647,2,6,34,0
40921774.0,4,8,2.0,1,3,4,0
40931471.0,79,540,6.8354430379746836,4,9,61,18
40931563.0,5,39,7.8,6,9,1,4
40932342.0,294,2002,6.809523809523809,2,11,220,74
40933383.0,170,1154,6.788235294117647,3,10,125,45
40935710.0,46,396,8.608695652173912,2,11,4,42
40952057.0,76,367,4.828947368421052,3,7,76,0
40954656.0,39,376,9.64102564102564,5,14,3,36
40958456.0,99,593,5.98989898989899,3,8,89,10
40960391.0,29,198,6.827586206896552,3,9,21,8
40969750.0,410,4001,9.758536585365853,2,14,18,392
40970140.0,310,1515,4.887096774193548,2,8,307,3
40984881.0,70,469,6.7,2,9,48,22
40984909.0,1,3,3.0,3,3,1,0
40985222.0,33,42,1.2727272727272727,1,3,33,0
40985716.0,28,47,1.6785714285714286,1,4,28,0
40987348.0,8,37,4.625,3,6,8,0
40994660.0,45,434,9.644444444444444,4,12,4,41
40994822.0,55,271,4.927272727272728,2,6,55,0
40995392.0,426,2109,4.950704225352113,2,8,425,1
40998149.0,114,457,4.008771929824562,2,7,114,0
41001056.0,62,243,3.9193548387096775,2,7,62,0
41001807.0,1,4,4.0,4,4,1,0
41006455.0,2,9,4.5,4,5,2,0
41007467.0,50,401,8.02,6,10,15,35
41017354.0,127,876,6.897637795275591,2,9,88,39
41017959.0,204,1396,6.8431372549019605,2,10,141,63
41018599.0,224,2124,9.482142857142858,2,12,15,209
41023108.0,115,675,5.869565217391305,2,9,110,5
41027221.0,41,313,7.634146341463414,2,10,17,24
41029871.0,119,368,3.092436974789916,1,5,119,0
41030561.0,168,341,2.0297619047619047,1,5,168,0
41038604.0,90,177,1.9666666666666666,1,5,90,0
41038753.0,96,544,5.666666666666667,2,8,92,4
41039218.0,178,245,1.3764044943820224,1,4,178,0
41039226.0,27,87,3.2222222222222223,1,5,27,0
41039744.0,25,183,7.32,6,9,13,12
41039933.0,44,262,5.954545454545454,4,9,39,5
41040170.0,69,95,1.3768115942028984,1,3,69,0
41053871.0,28,54,1.9285714285714286,1,4,28,0
41054995.0,54,207,3.8333333333333335,2,6,54,0
41057008.0,39,76,1.9487179487179487,1,4,39,0
41072425.0,232,2262,9.75,2,12,13,219
41072835.0,28,81,2.892857142857143,1,6,28,0
41076448.0,106,222,2.0943396226415096,1,4,106,0
41076977.0,88,526,5.9772727272727275,4,9,79,9
41077654.0,93,134,1.4408602150537635,1,5,93,0
41078042.0,79,450,5.69620253164557,2,8,77,2
41091641.0,215,1496,6.9581395348837205,2,10,155,60
41095105.0,3,7,2.3333333333333335,1,4,3,0
41101014.0,117,796,6.803418803418803,3,9,83,34
41103201.0,171,1498,8.760233918128655,2,13,15,156
41104931.0,101,135,1.3366336633663367,1,3,101,0
41106459.0,278,1362,4.899280575539568,2,7,278,0
41108580.0,88,520,5.909090909090909,3,8,83,5
41112600.0,1,1,1.0,1,1,1,0
41116351.0,87,116,1.3333333333333333,1,4,87,0
41118170.0,93,535,5.752688172043011,2,8,88,5
41118396.0,66,404,6.121212121212121,4,8,60,6
41118657.0,79,463,5.860759493670886,2,8,75,4
41124831.0,36,78,2.1666666666666665,1,4,36,0
41130523.0,2,6,3.0,2,4,2,0
41132726.0,2,7,3.5,3,4,2,0
41142546.0,23,93,4.043478260869565,2,6,23,0
41143773.0,1,1,1.0,1,1,1,0
41144741.0,70,281,4.014285714285714,2,7,70,0
41145850.0,32,305,9.53125,2,12,3,29
41151593.0,90,857,9.522222222222222,3,13,9,81
41162525.0,52,317,6.096153846153846,4,8,49,3
41167244.0,51,72,1.411764705882353,1,3,51,0
41169978.0,183,1752,9.573770491803279,2,13,15,168
41174327.0,230,1139,4.952173913043478,2,7,230,0
41174871.0,214,2062,9.63551401869159,2,12,15,199
41179592.0,7,26,3.7142857142857144,3,5,7,0
41187434.0,55,79,1.4363636363636363,1,4,55,0
41204801.0,12,17,1.4166666666666667,1,2,12,0
41206544.0,179,875,4.888268156424581,2,7,179,0
41207102.0,205,1023,4.990243902439024,2,7,205,0
41210392.0,174,1352,7.7701149425287355,2,11,65,109
41211338.0,5,11,2.2,1,3,5,0
41211629.0,175,1528,8.731428571428571,2,12,20,155
41220419.0,186,712,3.827956989247312,1,7,186,0
41224154.0,70,410,5.857142857142857,2,8,68,2
41226343.0,20,95,4.75,3,7,20,0
41233959.0,30,89,2.966666666666667,1,5,30,0
41235338.0,247,2364,9.570850202429149,2,13,19,228
41249810.0,86,426,4.953488372093023,2,8,85,1
41251104.0,68,332,4.882352941176471,2,7,68,0
41252089.0,4,14,3.5,3,4,4,0
41286760.0,54,159,2.9444444444444446,1,5,54,0
41290104.0,1,3,3.0,3,3,1,0
41292094.0,10,18,1.8,1,3,10,0
41293357.0,41,91,2.2195121951219514,1,5,41,0
41318593.0,5,22,4.4,2,6,5,0
41318868.0,137,553,4.036496350364963,1,7,137,0
41321089.0,1,8,8.0,8,8,0,1
41321642.0,121,619,5.115702479338843,2,8,120,1
41339435.0,39,261,6.6923076923076925,2,9,27,12
41343941.0,1,2,2.0,2,2,1,0
41345375.0,147,1417,9.639455782312925,3,13,10,137
41358032.0,2,24,12.0,11,13,0,2
41359820.0,121,234,1.9338842975206612,1,5,121,0
41360821.0,1,4,4.0,4,4,1,0
41363725.0,27,188,6.962962962962963,4,10,15,12
41371887.0,102,784,7.686274509803922,3,11,45,57
41375947.0,45,386,8.577777777777778,3,11,8,37
41377546.0,112,252,2.25,1,4,112,0
41388644.0,245,1433,5.848979591836735,2,9,224,21
41388760.0,214,285,1.3317757009345794,1,3,214,0
41388792.0,7,10,1.4285714285714286,1,3,7,0
41388849.0,243,322,1.3251028806584362,1,4,243,0
41388931.0,226,314,1.3893805309734513,1,4,226,0
41389046.0,446,601,1.3475336322869955,1,4,446,0
41391219.0,163,350,2.147239263803681,1,5,163,0
41392995.0,17,163,9.588235294117647,5,12,1,16
41394245.0,73,585,8.013698630136986,6,10,21,52
41400731.0,97,300,3.0927835051546393,1,5,97,0
41404828.0,125,646,5.168,2,7,125,0
41416041.0,1,3,3.0,3,3,1,0
41416459.0,14,56,4.0,3,5,14,0
41417813.0,53,518,9.773584905660377,5,12,3,50
41419269.0,4,7,1.75,1,2,4,0
41420190.0,79,162,2.050632911392405,1,4,79,0
41431595.0,1,1,1.0,1,1,1,0
41441252.0,4,8,2.0,1,3,4,0
41441776.0,52,258,4.961538461538462,2,8,51,1
41443738.0,54,526,9.74074074074074,6,12,3,51
41445042.0,22,108,4.909090909090909,3,7,22,0
41466631.0,6,18,3.0,2,5,6,0
41468719.0,144,586,4.069444444444445,2,7,144,0
41469675.0,120,595,4.958333333333333,2,7,120,0
41476326.0,1,3,3.0,3,3,1,0
41479174.0,113,572,5.061946902654867,2,7,113,0
41483260.0,72,497,6.902777777777778,2,10,52,20
41496211.0,49,427,8.714285714285714,2,12,5,44
41498312.0,47,146,3.106382978723404,1,5,47,0
41499305.0,2,19,9.5,9,10,0,2
41504894.0,23,52,2.260869565217391,1,4,23,0
41514823.0,29,138,4.758620689655173,3,7,29,0
41515048.0,42,210,5.0,3,8,40,2
41516072.0,14,69,4.928571428571429,3,7,14,0
41516784.0,42,203,4.833333333333333,3,7,42,0
41517274.0,178,867,4.870786516853933,2,8,177,1
41527263.0,213,2107,9.892018779342724,2,13,8,205
41527686.0,1,2,2.0,2,2,1,0
41528595.0,30,60,2.0,1,4,30,0
41532802.0,28,248,8.857142857142858,4,12,2,26
41543808.0,127,1001,7.881889763779528,2,10,44,83
41545805.0,2,5,2.5,2,3,2,0
41550981.0,256,535,2.08984375,1,5,256,0
41556060.0,7,31,4.428571428571429,2,6,7,0
41561260.0,2,11,5.5,2,9,1,1
41566407.0,102,297,2.911764705882353,1,5,102,0
41573257.0,130,642,4.938461538461539,1,7,130,0
41574829.0,5,10,2.0,1,3,5,0
41577586.0,67,458,6.835820895522388,2,9,45,22
41580586.0,30,73,2.433333333333333,1,5,30,0
41583398.0,299,590,1.9732441471571907,1,4,299,0
41583947.0,46,95,2.0652173913043477,1,4,46,0
41591321.0,291,2840,9.759450171821307,2,13,13,278
41602616.0,56,536,9.571428571428571,4,13,3,53
41602831.0,179,881,4.921787709497207,2,7,179,0
41602864.0,155,614,3.9612903225806453,2,6,155,0
41602869.0,208,648,3.1153846153846154,1,6,208,0
41608922.0,18,34,1.8888888888888888,1,3,18,0
41612026.0,50,202,4.04,1,6,50,0
41628801.0,5,33,6.6,2,9,3,2
41632405.0,121,246,2.0330578512396693,1,4,121,0
41638543.0,81,566,6.987654320987654,3,10,56,25
41653995.0,30,96,3.2,1,6,30,0
41659026.0,99,475,4.797979797979798,2,7,99,0
41664446.0,30,92,3.066666666666667,1,5,30,0
41675830.0,51,120,2.3529411764705883,1,4,51,0
41680220.0,328,2883,8.789634146341463,2,12,40,288
41682850.0,12,105,8.75,7,10,1,11
41685622.0,2,2,1.0,1,1,2,0
41688004.0,54,407,7.537037037037037,2,10,23,31
41688885.0,153,473,3.0915032679738563,1,5,153,0
41703291.0,7,13,1.8571428571428572,1,3,7,0
41706041.0,193,393,2.0362694300518136,1,4,193,0
41712518.0,63,619,9.825396825396826,3,12,4,59
41725652.0,2,7,3.5,3,4,2,0
41725783.0,89,364,4.089887640449438,1,6,89,0
41726943.0,77,312,4.0519480519480515,2,6,77,0
41728107.0,32,157,4.90625,3,8,31,1
41732204.0,1,3,3.0,3,3,1,0
41735779.0,128,1218,9.515625,2,13,15,113
41736693.0,39,78,2.0,1,4,39,0
41738896.0,52,264,5.076923076923077,3,7,52,0
41739620.0,9,89,9.88888888888889,9,11,0,9
41754438.0,100,396,3.96,1,7,100,0
41754573.0,18,120,6.666666666666667,3,9,13,5
41754690.0,101,505,5.0,3,8,100,1
41754920.0,133,1259,9.466165413533835,2,13,11,122
41757134.0,153,330,2.156862745098039,1,4,153,0
41759539.0,21,140,6.666666666666667,4,8,16,5
41764069.0,278,2152,7.741007194244604,2,11,98,180
41768459.0,64,387,6.046875,2,8,56,8
41769772.0,9,22,2.4444444444444446,1,4,9,0
41770951.0,81,700,8.641975308641975,3,11,15,66
41771796.0,90,446,4.955555555555556,2,7,90,0
41772131.0,106,526,4.962264150943396,2,7,106,0
41773095.0,190,747,3.931578947368421,1,6,190,0
41780058.0,138,1329,9.630434782608695,2,12,5,133
41783268.0,48,107,2.2291666666666665,1,4,48,0
41785150.0,116,1142,9.844827586206897,6,13,4,112
41789226.0,18,131,7.277777777777778,6,9,11,7
41790051.0,5,9,1.8,1,3,5,0
41807193.0,1,3,3.0,3,3,1,0
41807482.0,153,207,1.3529411764705883,1,4,153,0
41808878.0,67,190,2.8358208955223883,1,5,67,0
41809410.0,136,802,5.897058823529412,2,9,126,10
41817637.0,4,26,6.5,5,8,3,1
41828437.0,26,221,8.5,3,12,7,19
41834616.0,23,110,4.782608695652174,3,7,23,0
41847219.0,13,88,6.769230769230769,6,9,12,1
41856146.0,21,200,9.523809523809524,4,12,2,19
41861812.0,205,1795,8.75609756097561,2,12,24,181
41865514.0,340,2366,6.958823529411765,2,10,238,102
41866878.0,28,62,2.2142857142857144,1,5,28,0
41869265.0,2,3,1.5,1,2,2,0
41870131.0,1,3,3.0,3,3,1,0
41871003.0,22,151,6.863636363636363,4,9,12,10
41880231.0,183,543,2.9672131147540983,1,5,183,0
41881975.0,74,148,2.0,1,4,74,0
41882936.0,93,913,9.817204301075268,3,13,5,88
41887147.0,1,1,1.0,1,1,1,0
41895353.0,49,375,7.653061224489796,3,9,20,29
41895829.0,190,935,4.921052631578948,2,8,189,1
41898460.0,103,506,4.912621359223301,2,7,103,0
41899273.0,126,610,4.841269841269841,1,8,125,1
41900789.0,229,1145,5.0,2,8,227,2
41902349.0,270,1333,4.937037037037037,2,9,268,2
41902552.0,1,4,4.0,4,4,1,0
41902771.0,151,728,4.821192052980132,3,7,151,0
41907376.0,15,32,2.1333333333333333,1,4,15,0
41910852.0,89,423,4.752808988764045,2,8,88,1
41919163.0,55,528,9.6,4,12,7,48
41922702.0,169,368,2.1775147928994083,1,5,169,0
41927206.0,57,125,2.192982456140351,1,4,57,0
41932037.0,11,13,1.1818181818181819,1,2,11,0
41943773.0,72,296,4.111111111111111,2,7,72,0
41948174.0,102,691,6.7745098039215685,3,10,81,21
41948480.0,18,142,7.888888888888889,4,10,5,13
41963317.0,148,727,4.912162162162162,3,8,146,2
41968284.0,1,8,8.0,8,8,0,1
41969920.0,72,104,1.4444444444444444,1,3,72,0
41970464.0,79,165,2.088607594936709,1,5,79,0
41970583.0,196,267,1.3622448979591837,1,3,196,0
41972422.0,38,66,1.736842105263158,1,3,38,0
41972430.0,58,396,6.827586206896552,3,9,40,18
41977392.0,94,197,2.095744680851064,1,5,94,0
41990701.0,23,45,1.9565217391304348,1,4,23,0
41993641.0,33,224,6.787878787878788,5,9,26,7
41997651.0,171,1151,6.730994152046784,2,10,124,47
42008210.0,29,196,6.758620689655173,3,8,20,9
42009097.0,1,4,4.0,4,4,1,0
42014469.0,115,1093,9.504347826086956,2,12,8,107
42016647.0,65,615,9.461538461538462,2,12,4,61
42017287.0,11,101,9.181818181818182,2,13,2,9
42018169.0,60,592,9.866666666666667,4,12,2,58
42019462.0,381,3632,9.53280839895013,2,13,31,350
42019760.0,226,1112,4.920353982300885,2,8,224,2
42020292.0,154,331,2.1493506493506493,1,4,154,0
42035685.0,87,597,6.862068965517241,2,10,61,26
42039769.0,18,167,9.277777777777779,5,11,2,16
42044009.0,60,569,9.483333333333333,2,12,5,55
42046394.0,126,253,2.007936507936508,1,4,126,0
42052419.0,116,795,6.853448275862069,3,10,83,33
42055487.0,40,233,5.825,3,8,38,2
42057955.0,99,208,2.101010101010101,1,5,99,0
42057962.0,111,237,2.135135135135135,1,4,111,0
42057969.0,131,263,2.0076335877862594,1,4,131,0
42058899.0,111,775,6.981981981981982,2,10,75,36
42060479.0,109,543,4.981651376146789,2,8,108,1
42061030.0,30,67,2.2333333333333334,1,5,30,0
42064182.0,19,51,2.6842105263157894,1,5,19,0
42064736.0,20,41,2.05,1,4,20,0
42072222.0,120,824,6.866666666666666,2,9,87,33
42086337.0,153,1039,6.790849673202614,2,10,112,41
42088914.0,18,86,4.777777777777778,3,7,18,0
42093867.0,72,549,7.625,2,10,26,46
42106593.0,43,214,4.976744186046512,2,6,43,0
42107002.0,42,395,9.404761904761905,4,12,4,38
42107249.0,40,157,3.925,1,6,40,0
42110474.0,92,626,6.804347826086956,4,10,67,25
42112270.0,13,31,2.3846153846153846,1,4,13,0
42128094.0,245,1183,4.828571428571428,2,8,242,3
42129045.0,110,560,5.090909090909091,2,8,109,1
42130045.0,9,61,6.777777777777778,5,8,8,1
42131209.0,374,1109,2.96524064171123,1,7,374,0
42151819.0,2,6,3.0,2,4,2,0
42152633.0,3,19,6.333333333333333,5,7,3,0
42154329.0,141,1360,9.645390070921986,4,12,8,133
42155085.0,190,1844,9.705263157894738,2,13,7,183
42163475.0,41,85,2.073170731707317,1,5,41,0
42164408.0,21,48,2.2857142857142856,1,5,21,0
42170020.0,3,8,2.6666666666666665,2,3,3,0
42170411.0,143,1243,8.692307692307692,3,12,21,122
42173176.0,1,2,2.0,2,2,1,0
42179198.0,40,124,3.1,1,5,40,0
42188056.0,61,308,5.049180327868853,3,8,60,1
42188902.0,13,22,1.6923076923076923,1,4,13,0
42189383.0,10,26,2.6,1,4,10,0
42189785.0,42,85,2.0238095238095237,1,5,42,0
42189909.0,102,406,3.980392156862745,1,6,102,0
42192073.0,101,1008,9.98019801980198,5,12,4,97
42199877.0,144,440,3.0555555555555554,1,6,144,0
42202315.0,17,75,4.411764705882353,2,6,17,0
42211651.0,1,8,8.0,8,8,0,1
42212724.0,35,70,2.0,1,4,35,0
42219364.0,17,136,8.0,6,10,6,11
42220007.0,195,405,2.076923076923077,1,4,195,0
42224131.0,220,877,3.9863636363636363,1,7,220,0
42228384.0,30,70,2.3333333333333335,1,4,30,0
42240455.0,95,378,3.9789473684210526,2,6,95,0
42243426.0,25,72,2.88,1,5,25,0
42245229.0,24,232,9.666666666666666,3,12,1,23
42251305.0,2,18,9.0,9,9,0,2
42252633.0,27,180,6.666666666666667,2,9,19,8
42260632.0,184,1743,9.472826086956522,2,12,13,171
42261732.0,106,810,7.6415094339622645,2,11,44,62
42263649.0,15,18,1.2,1,2,15,0
42267894.0,2,2,1.0,1,1,2,0
42270173.0,4,27,6.75,6,7,4,0
42270907.0,2,14,7.0,6,8,1,1
42283314.0,124,616,4.967741935483871,2,8,123,1
42290551.0,14,29,2.0714285714285716,1,3,14,0
42295526.0,23,45,1.9565217391304348,1,3,23,0
42302290.0,20,83,4.15,2,6,20,0
42305593.0,25,254,10.16,7,12,1,24
42314853.0,5,16,3.2,2,5,5,0
42330088.0,2,3,1.5,1,2,2,0
42330635.0,4,7,1.75,1,3,4,0
42351605.0,62,119,1.9193548387096775,1,4,62,0
42356313.0,98,590,6.020408163265306,2,8,92,6
42356676.0,3,8,2.6666666666666665,2,3,3,0
42358061.0,146,852,5.835616438356165,2,8,142,4
42358957.0,151,339,2.2450331125827816,1,5,151,0
42359478.0,106,639,6.028301886792453,2,9,100,6
42366550.0,77,397,5.1558441558441555,2,8,76,1
42366719.0,165,1602,9.709090909090909,2,13,8,157
42370481.0,39,73,1.8717948717948718,1,4,39,0
42371427.0,64,135,2.109375,1,4,64,0
42372504.0,55,156,2.8363636363636364,1,5,55,0
42376206.0,25,166,6.64,6,8,23,2
42377092.0,78,298,3.8205128205128207,1,6,78,0
42380033.0,117,1091,9.324786324786325,2,12,11,106
42385371.0,65,149,2.292307692307692,1,4,65,0
42395700.0,11,23,2.090909090909091,1,3,11,0
42396013.0,22,50,2.272727272727273,1,4,22,0
42401760.0,8,18,2.25,1,4,8,0
42402219.0,128,947,7.3984375,2,11,66,62
42402377.0,1,1,1.0,1,1,1,0
42409194.0,13,103,7.923076923076923,6,9,4,9
42419641.0,168,1451,8.636904761904763,2,12,23,145
42426494.0,141,293,2.078014184397163,1,5,141,0
42431040.0,155,638,4.116129032258065,2,6,155,0
42433465.0,1,2,2.0,2,2,1,0
42440149.0,16,53,3.3125,2,5,16,0
42440320.0,6,44,7.333333333333333,3,10,3,3
42442339.0,43,79,1.8372093023255813,1,3,43,0
42442544.0,38,325,8.552631578947368,3,10,6,32
42446303.0,17,36,2.1176470588235294,1,4,17,0
42448016.0,155,621,4.006451612903226,1,7,155,0
42448198.0,1,3,3.0,3,3,1,0
42449153.0,61,309,5.065573770491803,2,8,60,1
42450079.0,59,460,7.796610169491525,5,10,22,37
42452146.0,13,105,8.076923076923077,6,10,4,9
42454637.0,226,1554,6.876106194690266,2,10,156,70
42457540.0,57,113,1.9824561403508771,1,4,57,0
42458343.0,10,36,3.6,2,5,10,0
42462596.0,19,136,7.157894736842105,5,9,11,8
42462636.0,18,158,8.777777777777779,5,11,4,14
42464899.0,19,114,6.0,3,8,16,3
42473616.0,68,204,3.0,1,5,68,0
42481747.0,245,1245,5.081632653061225,2,7,245,0
42482054.0,43,300,6.976744186046512,5,11,30,13
42484819.0,24,33,1.375,1,3,24,0
42500709.0,5,9,1.8,1,3,5,0
42511337.0,71,150,2.112676056338028,1,5,71,0
42512472.0,93,650,6.989247311827957,2,9,60,33
42513514.0,1,2,2.0,2,2,1,0
42513864.0,50,382,7.64,2,10,19,31
42526093.0,201,973,4.840796019900497,2,8,199,2
42528622.0,154,1348,8.753246753246753,3,12,19,135
42528808.0,267,2597,9.726591760299625,2,13,17,250
42533276.0,62,542,8.741935483870968,6,11,8,54
42533282.0,220,2129,9.677272727272728,2,12,15,205
42573306.0,7,12,1.7142857142857142,1,3,7,0
42573336.0,11,35,3.1818181818181817,1,5,11,0
42573371.0,10,68,6.8,5,8,8,2
42573453.0,9,18,2.0,1,4,9,0
42574662.0,22,210,9.545454545454545,5,12,1,21
42576987.0,2,8,4.0,4,4,2,0
42579160.0,209,1007,4.818181818181818,2,8,208,1
42580261.0,88,178,2.022727272727273,1,4,88,0
42581130.0,86,601,6.988372093023256,2,10,58,28
42594196.0,1,1,1.0,1,1,1,0
42595353.0,90,360,4.0,2,6,90,0
42597057.0,142,430,3.028169014084507,1,5,142,0
42601851.0,11,84,7.636363636363637,6,9,4,7
42602764.0,1,2,2.0,2,2,1,0
42602831.0,41,83,2.024390243902439,1,4,41,0
42602835.0,64,128,2.0,1,4,64,0
42602838.0,33,69,2.090909090909091,1,4,33,0
42602840.0,77,157,2.038961038961039,1,4,77,0
42603873.0,94,464,4.9361702127659575,2,8,93,1
42604578.0,168,1160,6.904761904761905,3,10,120,48
42609325.0,39,77,1.9743589743589745,1,4,39,0
42615199.0,110,956,8.690909090909091,2,11,11,99
42617375.0,180,357,1.9833333333333334,1,5,180,0
42622746.0,44,167,3.7954545454545454,2,6,44,0
42623983.0,105,1022,9.733333333333333,7,13,2,103
42624508.0,102,960,9.411764705882353,2,13,13,89
42625460.0,11,77,7.0,5,8,6,5
42633859.0,1,3,3.0,3,3,1,0
42639054.0,1,2,2.0,2,2,1,0
42639470.0,174,1545,8.879310344827585,2,12,18,156
42640442.0,449,3097,6.897550111358575,2,11,314,135
42640850.0,60,479,7.983333333333333,5,11,19,41
42644273.0,5,40,8.0,7,9,2,3
42650422.0,1,1,1.0,1,1,1,0
42654235.0,28,51,1.8214285714285714,1,3,28,0
42654721.0,22,47,2.1363636363636362,1,3,22,0
42655019.0,27,56,2.074074074074074,1,4,27,0
42655181.0,10,17,1.7,1,3,10,0
42655304.0,1,4,4.0,4,4,1,0
42665775.0,102,212,2.0784313725490198,1,5,102,0
42675334.0,86,435,5.058139534883721,3,8,85,1
42676354.0,96,955,9.947916666666666,3,13,3,93
42687866.0,12,14,1.1666666666666667,1,2,12,0
42698776.0,132,282,2.1363636363636362,1,5,132,0
42699163.0,2,6,3.0,2,4,2,0
42700030.0,6,15,2.5,1,3,6,0
42701237.0,8,38,4.75,3,7,8,0
42704219.0,1,3,3.0,3,3,1,0
42704893.0,148,439,2.9662162162162162,1,5,148,0
42715491.0,2,6,3.0,3,3,2,0
42724332.0,70,705,10.071428571428571,4,13,2,68
42732957.0,41,410,10.0,4,12,2,39
42735826.0,76,151,1.986842105263158,1,4,76,0
42739597.0,2,10,5.0,5,5,2,0
42746904.0,91,629,6.912087912087912,2,9,54,37
42747883.0,72,732,10.166666666666666,4,12,2,70
42752490.0,253,517,2.0434782608695654,1,5,253,0
42752626.0,332,1626,4.897590361445783,2,8,331,1
42752921.0,148,575,3.885135135135135,1,6,148,0
42757968.0,106,230,2.169811320754717,1,5,106,0
42760906.0,43,218,5.069767441860465,3,7,43,0
42761588.0,35,68,1.9428571428571428,1,4,35,0
42761670.0,2,5,2.5,2,3,2,0
42772346.0,1,1,1.0,1,1,1,0
42773870.0,26,81,3.1153846153846154,2,5,26,0
42780945.0,31,317,10.225806451612904,9,12,0,31
42781722.0,4,11,2.75,2,3,4,0
42783111.0,212,1432,6.754716981132075,2,10,155,57
42785641.0,1,4,4.0,4,4,1,0
42788974.0,2,20,10.0,10,10,0,2
42792227.0,43,288,6.6976744186046515,2,10,32,11
42801260.0,78,241,3.08974358974359,1,5,78,0
42801831.0,83,470,5.662650602409639,2,8,79,4
42802245.0,103,209,2.029126213592233,1,4,103,0
42804585.0,117,457,3.905982905982906,2,7,117,0
42810018.0,58,400,6.896551724137931,4,10,40,18
42814473.0,43,300,6.976744186046512,5,9,28,15
42822405.0,133,289,2.172932330827068,1,4,133,0
42823530.0,143,303,2.1188811188811187,1,4,143,0
42831968.0,34,62,1.8235294117647058,1,4,34,0
42851132.0,149,1286,8.630872483221477,2,13,21,128
42852978.0,5,53,10.6,10,11,0,5
42855358.0,195,284,1.4564102564102563,1,4,195,0
42855880.0,294,414,1.4081632653061225,1,4,294,0
42856189.0,4,13,3.25,2,5,4,0
42859919.0,14,143,10.214285714285714,8,13,0,14
42878421.0,60,526,8.766666666666667,2,11,4,56
42886599.0,168,1500,8.928571428571429,6,12,14,154
42887852.0,11,18,1.6363636363636365,1,2,11,0
42900136.0,7,57,8.142857142857142,7,9,2,5
42909917.0,35,73,2.085714285714286,1,4,35,0
42923423.0,26,60,2.3076923076923075,1,4,26,0
42924208.0,12,26,2.1666666666666665,1,3,12,0
42925094.0,17,35,2.0588235294117645,1,4,17,0
42925678.0,13,34,2.6153846153846154,1,5,13,0
42925977.0,6,13,2.1666666666666665,1,3,6,0
42926219.0,3,7,2.3333333333333335,1,3,3,0
42933216.0,1,1,1.0,1,1,1,0
42947028.0,164,318,1.9390243902439024,1,4,164,0
42970648.0,109,448,4.110091743119266,1,7,109,0
42986180.0,194,394,2.0309278350515463,1,5,194,0
43017946.0,2,8,4.0,4,4,2,0
43028809.0,5,14,2.8,2,4,5,0
43033448.0,6,17,2.8333333333333335,1,4,6,0
43041002.0,184,718,3.902173913043478,1,7,184,0
43048076.0,34,132,3.8823529411764706,2,6,34,0
43049062.0,15,21,1.4,1,3,15,0
43057115.0,45,359,7.977777777777778,5,10,15,30
43063427.0,5,52,10.4,10,11,0,5
43069621.0,107,228,2.130841121495327,1,5,107,0
43073627.0,48,226,4.708333333333333,2,8,47,1
43076012.0,50,387,7.74,2,10,19,31
43076404.0,16,149,9.3125,4,11,1,15
43084263.0,3,26,8.666666666666666,8,9,0,3
43084765.0,84,409,4.869047619047619,2,7,84,0
43095308.0,24,68,2.8333333333333335,1,5,24,0
43167619.0,69,344,4.9855072463768115,2,7,69,0
43168008.0,3,5,1.6666666666666667,1,2,3,0
43168036.0,19,38,2.0,1,3,19,0
43168041.0,1,2,2.0,2,2,1,0
43168045.0,10,15,1.5,1,3,10,0
43169268.0,28,189,6.75,2,9,19,9
43174270.0,16,121,7.5625,4,9,6,10
43176252.0,3,23,7.666666666666667,7,8,1,2
43183004.0,64,376,5.875,4,8,60,4
43183038.0,90,187,2.077777777777778,1,5,90,0
43191659.0,39,78,2.0,1,4,39,0
43201596.0,85,354,4.1647058823529415,2,7,85,0
43202218.0,172,1657,9.633720930232558,2,13,10,162
43202959.0,173,722,4.173410404624278,1,7,173,0
43220689.0,189,931,4.925925925925926,2,7,189,0
43234442.0,32,55,1.71875,1,3,32,0
43236713.0,4,15,3.75,2,5,4,0
43237035.0,2,9,4.5,4,5,2,0
43252805.0,2,11,5.5,2,9,1,1
43253561.0,132,400,3.0303030303030303,1,6,132,0
43253959.0,66,195,2.9545454545454546,1,5,66,0
43254146.0,46,324,7.043478260869565,5,10,34,12
43277808.0,250,522,2.088,1,5,250,0
43284827.0,35,346,9.885714285714286,3,12,2,33
43291949.0,159,1537,9.666666666666666,2,12,7,152
43306036.0,80,160,2.0,1,5,80,0
43306127.0,1,2,2.0,2,2,1,0
43313202.0,5,15,3.0,2,4,5,0
43314435.0,2,5,2.5,2,3,2,0
43314567.0,3,11,3.6666666666666665,3,4,3,0
43324930.0,4,10,2.5,2,4,4,0
43331911.0,4,8,2.0,1,3,4,0
43338607.0,111,242,2.18018018018018,1,4,111,0
43338683.0,94,275,2.925531914893617,1,5,94,0
43338815.0,16,150,9.375,4,11,1,15
43338866.0,150,328,2.1866666666666665,1,5,150,0
43338907.0,6,36,6.0,4,7,6,0
43338954.0,92,197,2.141304347826087,1,5,92,0
43339009.0,125,249,1.992,1,6,125,0
43339079.0,172,343,1.994186046511628,1,5,172,0
43342452.0,9,45,5.0,4,6,9,0
43345668.0,251,2403,9.573705179282868,2,12,15,236
43372405.0,4,27,6.75,6,8,3,1
43386960.0,41,195,4.7560975609756095,3,6,41,0
43387429.0,15,57,3.8,2,6,15,0
43387872.0,20,72,3.6,1,6,20,0
43388604.0,6,36,6.0,3,8,5,1
43388615.0,1,1,1.0,1,1,1,0
43413046.0,56,370,6.607142857142857,2,10,44,12
43414522.0,61,300,4.918032786885246,2,7,61,0
43428373.0,83,234,2.819277108433735,1,6,83,0
43428557.0,8,22,2.75,1,4,8,0
43428587.0,24,73,3.0416666666666665,2,5,24,0
43429870.0,205,1435,7.0,3,10,139,66
43431846.0,191,569,2.979057591623037,1,5,191,0
43447120.0,1,1,1.0,1,1,1,0
43464273.0,179,553,3.089385474860335,1,6,179,0
43465481.0,18,35,1.9444444444444444,1,5,18,0
43466194.0,16,128,8.0,6,10,6,10
43475431.0,107,528,4.934579439252336,2,7,107,0
43484889.0,1,3,3.0,3,3,1,0
43491242.0,63,134,2.126984126984127,1,5,63,0
43493055.0,1,3,3.0,3,3,1,0
43494802.0,166,335,2.0180722891566263,1,4,166,0
43501418.0,3,3,1.0,1,1,3,0
43501599.0,5,15,3.0,3,3,5,0
43501677.0,6,10,1.6666666666666667,1,3,6,0
43502239.0,1,6,6.0,6,6,1,0
43522521.0,9,41,4.555555555555555,3,6,9,0
43524526.0,24,168,7.0,2,10,15,9
43532535.0,11,23,2.090909090909091,1,3,11,0
43540547.0,173,361,2.086705202312139,1,4,173,0
43541114.0,66,138,2.090909090909091,1,5,66,0
43541115.0,123,266,2.16260162601626,1,6,123,0
43541116.0,57,121,2.1228070175438596,1,4,57,0
43541246.0,25,244,9.76,4,12,1,24
43541823.0,39,75,1.9230769230769231,1,4,39,0
43541824.0,143,294,2.055944055944056,1,4,143,0
43542320.0,34,173,5.088235294117647,3,6,34,0
43543918.0,22,64,2.909090909090909,1,4,22,0
43545906.0,39,113,2.8974358974358974,1,6,39,0
43545912.0,97,392,4.041237113402062,2,6,97,0
43545918.0,55,163,2.963636363636364,1,5,55,0
43549004.0,12,25,2.0833333333333335,1,3,12,0
43550029.0,55,370,6.7272727272727275,4,10,43,12
43553382.0,58,392,6.758620689655173,2,9,41,17
43553582.0,13,32,2.4615384615384617,1,4,13,0
43557996.0,159,1513,9.515723270440251,2,12,16,143
43564123.0,166,1149,6.921686746987952,2,10,118,48
43565478.0,21,95,4.523809523809524,3,7,21,0
43574660.0,1,1,1.0,1,1,1,0
43574852.0,330,2281,6.912121212121212,2,10,229,101
43575242.0,49,106,2.163265306122449,1,5,49,0
43577048.0,46,97,2.108695652173913,1,4,46,0
43578502.0,39,271,6.948717948717949,3,9,26,13
43580283.0,4,13,3.25,2,4,4,0
43580631.0,8,13,1.625,1,3,8,0
43580773.0,16,36,2.25,1,6,16,0
43580816.0,11,14,1.2727272727272727,1,2,11,0
43584582.0,28,83,2.9642857142857144,1,4,28,0
43590057.0,10,72,7.2,6,9,6,4
43593997.0,15,139,9.266666666666667,4,11,2,13
43594141.0,5,11,2.2,1,3,5,0
43603041.0,58,484,8.344827586206897,2,11,9,49
43603168.0,106,507,4.783018867924528,3,7,106,0
43607230.0,25,103,4.12,2,6,25,0
43607265.0,19,165,8.68421052631579,4,12,4,15
43608276.0,1,2,2.0,2,2,1,0
43610887.0,115,989,8.6,2,11,14,101
43611543.0,165,842,5.1030303030303035,2,8,164,1
43612868.0,3,9,3.0,2,4,3,0
43617424.0,19,90,4.7368421052631575,2,6,19,0
43619140.0,84,585,6.964285714285714,5,9,61,23
43619579.0,285,1397,4.901754385964912,1,8,284,1
43619584.0,128,869,6.7890625,2,9,95,33
43622298.0,3,5,1.6666666666666667,1,2,3,0
43624579.0,108,768,7.111111111111111,3,10,73,35
43629871.0,2,3,1.5,1,2,2,0
43630782.0,88,181,2.0568181818181817,1,4,88,0
43633065.0,2,6,3.0,2,4,2,0
43633177.0,2,5,2.5,2,3,2,0
43633259.0,7,13,1.8571428571428572,1,3,7,0
43633273.0,121,1166,9.636363636363637,2,12,7,114
43633650.0,73,717,9.821917808219178,5,12,1,72
43633900.0,55,268,4.872727272727273,3,7,55,0
43634300.0,1,2,2.0,2,2,1,0
43635760.0,2,8,4.0,4,4,2,0
43637295.0,2,3,1.5,1,2,2,0
43637403.0,147,313,2.129251700680272,1,5,147,0
43639572.0,8,24,3.0,1,4,8,0
43639836.0,134,403,3.0074626865671643,1,6,134,0
43639953.0,20,130,6.5,5,8,16,4
43645807.0,152,1014,6.671052631578948,2,10,117,35
43651496.0,25,241,9.64,4,13,1,24
43652191.0,25,234,9.36,3,13,4,21
43652384.0,24,102,4.25,1,6,24,0
43652686.0,42,418,9.952380952380953,7,13,1,41
43652786.0,29,53,1.8275862068965518,1,4,29,0
43664119.0,333,1635,4.90990990990991,2,7,333,0
43674352.0,228,1132,4.964912280701754,2,8,226,2
43678944.0,134,393,2.9328358208955225,1,5,134,0
43680272.0,1,4,4.0,4,4,1,0
43685407.0,4,32,8.0,7,9,2,2
43689144.0,4,14,3.5,2,5,4,0
43689145.0,8,81,10.125,8,12,0,8
43689407.0,5,15,3.0,2,4,5,0
43695049.0,52,367,7.0576923076923075,5,9,34,18
43698616.0,3,14,4.666666666666667,2,7,3,0
43699138.0,4,20,5.0,4,6,4,0
43699292.0,8,34,4.25,2,6,8,0
43700153.0,3,12,4.0,4,4,3,0
43700263.0,5,20,4.0,3,5,5,0
43705889.0,47,181,3.851063829787234,2,6,47,0
43706951.0,35,70,2.0,1,4,35,0
43709684.0,4,6,1.5,1,2,4,0
43710293.0,41,267,6.512195121951219,3,9,33,8
43710814.0,6,25,4.166666666666667,3,5,6,0
43713115.0,81,397,4.901234567901234,2,7,81,0
43721113.0,52,111,2.1346153846153846,1,4,52,0
43723540.0,1,2,2.0,2,2,1,0
43724862.0,16,88,5.5,4,7,16,0
43724917.0,5,39,7.8,6,9,2,3
43727912.0,25,147,5.88,3,8,23,2
43728214.0,65,570,8.76923076923077,6,11,8,57
43728288.0,91,188,2.065934065934066,1,5,91,0
43732918.0,2,4,2.0,1,3,2,0
43733996.0,3,17,5.666666666666667,5,6,3,0
43734137.0,2,10,5.0,4,6,2,0
43734192.0,18,42,2.3333333333333335,1,4,18,0
43734277.0,1,7,7.0,7,7,1,0
43735045.0,1,4,4.0,4,4,1,0
43735709.0,65,617,9.492307692307692,2,12,6,59
43736333.0,144,700,4.861111111111111,2,8,143,1
43746452.0,194,1856,9.56701030927835,2,13,21,173
43746585.0,177,1221,6.898305084745763,2,11,124,53
43748055.0,12,114,9.5,5,11,1,11
43748180.0,13,37,2.8461538461538463,1,5,13,0
43750128.0,6,14,2.3333333333333335,1,3,6,0
43751236.0,177,713,4.028248587570621,2,7,177,0
43753009.0,222,1949,8.77927927927928,2,12,24,198
43762273.0,233,1156,4.96137339055794,2,9,230,3
43762537.0,2,11,5.5,5,6,2,0
43764739.0,4,10,2.5,2,3,4,0
43765148.0,143,692,4.839160839160839,2,8,141,2
43765661.0,1,2,2.0,2,2,1,0
43766309.0,1,3,3.0,3,3,1,0
43766711.0,92,891,9.684782608695652,2,13,3,89
43767396.0,47,103,2.1914893617021276,1,4,47,0
43772163.0,260,551,2.1192307692307693,1,5,260,0
43778929.0,303,2894,9.551155115511552,2,14,20,283
43781973.0,57,282,4.947368421052632,2,8,56,1
43784188.0,3,8,2.6666666666666665,1,4,3,0
43791163.0,37,77,2.081081081081081,1,4,37,0
43795474.0,187,923,4.935828877005347,2,8,186,1
43796793.0,225,693,3.08,1,7,225,0
43798389.0,114,1110,9.736842105263158,2,12,8,106
43800072.0,48,311,6.479166666666667,2,9,37,11
43801874.0,2,3,1.5,1,2,2,0
43807634.0,16,116,7.25,6,8,10,6
43807719.0,52,118,2.269230769230769,1,4,52,0
43807803.0,58,405,6.982758620689655,5,10,37,21
43810511.0,66,509,7.712121212121212,6,10,28,38
43814644.0,72,344,4.777777777777778,2,7,72,0
43815855.0,225,1124,4.995555555555556,2,8,223,2
43816038.0,1,6,6.0,6,6,1,0
43823393.0,226,1108,4.902654867256637,2,7,226,0
43824542.0,224,1092,4.875,2,7,224,0
43826140.0,55,279,5.072727272727272,3,7,55,0
43827685.0,2,8,4.0,4,4,2,0
43828461.0,1,4,4.0,4,4,1,0
43829201.0,3,7,2.3333333333333335,2,3,3,0
43829358.0,27,138,5.111111111111111,4,7,27,0
43830106.0,4,9,2.25,1,3,4,0
43831280.0,2,6,3.0,3,3,2,0
43831473.0,2,2,1.0,1,1,2,0
43831551.0,7,13,1.8571428571428572,1,3,7,0
43831675.0,2,6,3.0,3,3,2,0
43833496.0,70,131,1.8714285714285714,1,5,70,0
43834227.0,190,1830,9.631578947368421,2,14,11,179
43838535.0,6,10,1.6666666666666667,1,3,6,0
43838585.0,94,201,2.1382978723404253,1,4,94,0
43840207.0,268,1070,3.9925373134328357,1,7,268,0
43840546.0,60,128,2.1333333333333333,1,5,60,0
43842546.0,7,14,2.0,1,3,7,0
43843440.0,5,11,2.2,1,3,5,0
43843473.0,107,540,5.046728971962617,2,8,106,1
43843608.0,4,6,1.5,1,2,4,0
43843683.0,1,4,4.0,4,4,1,0
43845374.0,185,734,3.9675675675675675,1,7,185,0
43845483.0,218,875,4.013761467889908,1,7,218,0
43863574.0,6,42,7.0,4,9,3,3
43869970.0,23,152,6.608695652173913,2,9,15,8
43873379.0,38,73,1.9210526315789473,1,4,38,0
43879292.0,1,6,6.0,6,6,1,0
43880064.0,112,218,1.9464285714285714,1,4,112,0
43881373.0,3,8,2.6666666666666665,2,4,3,0
43882311.0,12,39,3.25,1,5,12,0
43886401.0,3,5,1.6666666666666667,1,3,3,0
43887654.0,215,2092,9.730232558139535,2,13,12,203
43887746.0,1,3,3.0,3,3,1,0
43918451.0,40,293,7.325,2,10,17,23
43922966.0,258,1260,4.883720930232558,2,7,258,0
43924596.0,11,38,3.4545454545454546,2,4,11,0
43935155.0,78,242,3.1025641025641026,1,6,78,0
43935497.0,54,259,4.796296296296297,3,7,54,0
43937644.0,306,2148,7.019607843137255,4,10,207,99
43937945.0,194,1357,6.994845360824742,2,10,132,62
43942173.0,9,29,3.2222222222222223,2,4,9,0
43953071.0,22,155,7.045454545454546,4,10,16,6
43966113.0,64,137,2.140625,1,4,64,0
43967466.0,19,77,4.052631578947368,2,6,19,0
43975416.0,38,108,2.8421052631578947,1,5,38,0
43976297.0,32,249,7.78125,6,10,14,18
43978289.0,52,98,1.8846153846153846,1,4,52,0
43980955.0,27,205,7.592592592592593,4,10,12,15
43991360.0,95,846,8.905263157894737,6,11,8,87
43992679.0,89,789,8.865168539325843,4,11,8,81
43998777.0,188,542,2.882978723404255,1,6,188,0
44001707.0,30,109,3.6333333333333333,2,5,30,0
44002050.0,24,174,7.25,3,9,11,13
44007685.0,186,393,2.1129032258064515,1,5,186,0
44009874.0,25,234,9.36,2,13,3,22
44012773.0,2,5,2.5,2,3,2,0
44019195.0,12,44,3.6666666666666665,2,6,12,0
44026238.0,21,166,7.904761904761905,6,11,10,11
44035369.0,10,47,4.7,3,6,10,0
44040840.0,172,367,2.133720930232558,1,5,172,0
44041154.0,23,231,10.043478260869565,3,12,1,22
44043024.0,134,678,5.059701492537314,3,8,132,2
44046043.0,2,3,1.5,1,2,2,0
44046661.0,143,286,2.0,1,5,143,0
44047282.0,148,296,2.0,1,4,148,0
44048481.0,2,4,2.0,1,3,2,0
44054491.0,258,525,2.0348837209302326,1,4,258,0
44055568.0,10,48,4.8,4,6,10,0
44068155.0,43,429,9.976744186046512,6,13,1,42
44069581.0,101,305,3.01980198019802,1,6,101,0
44072521.0,25,192,7.68,3,9,10,15
44075028.0,20,198,9.9,3,12,1,19
44075827.0,21,203,9.666666666666666,7,12,1,20
44082262.0,32,254,7.9375,7,10,11,21
44082750.0,1,4,4.0,4,4,1,0
44087035.0,8,76,9.5,5,11,1,7
44091617.0,44,131,2.977272727272727,1,5,44,0
44094371.0,24,56,2.3333333333333335,1,4,24,0
44094579.0,5,42,8.4,7,9,1,4
44094783.0,16,119,7.4375,3,9,6,10
44095149.0,40,119,2.975,1,5,40,0
44097083.0,121,249,2.0578512396694215,1,4,121,0
44109900.0,164,485,2.957317073170732,1,5,164,0
44111008.0,78,169,2.1666666666666665,1,6,78,0
44115993.0,28,269,9.607142857142858,5,11,2,26
44117122.0,22,72,3.272727272727273,1,6,22,0
44117126.0,54,376,6.962962962962963,3,9,37,17
44120519.0,89,176,1.9775280898876404,1,4,89,0
44126119.0,35,179,5.114285714285714,3,7,35,0
44127614.0,18,35,1.9444444444444444,1,3,18,0
44134668.0,31,73,2.3548387096774195,1,5,31,0
44136190.0,5,12,2.4,1,4,5,0
44140621.0,28,260,9.285714285714286,3,11,2,26
44141120.0,225,1110,4.933333333333334,1,8,223,2
44141953.0,63,313,4.968253968253968,2,7,63,0
44142242.0,225,1112,4.942222222222222,2,8,224,1
44144075.0,79,158,2.0,1,4,79,0
44145027.0,27,54,2.0,1,4,27,0
44145319.0,176,363,2.0625,1,5,176,0
44145596.0,38,296,7.7894736842105265,2,10,13,25
44148009.0,37,69,1.864864864864865,1,4,37,0
44148282.0,2,8,4.0,4,4,2,0
44148611.0,85,262,3.0823529411764707,2,5,85,0
44149028.0,187,1281,6.850267379679145,2,10,130,57
44150316.0,3,18,6.0,5,7,3,0
44152462.0,92,198,2.152173913043478,1,4,92,0
44158148.0,2,3,1.5,1,2,2,0
44158728.0,171,1675,9.7953216374269,4,12,9,162
44159862.0,15,30,2.0,1,3,15,0
44160477.0,234,478,2.0427350427350426,1,5,234,0
44162855.0,15,31,2.066666666666667,1,4,15,0
44174305.0,2,4,2.0,1,3,2,0
44180950.0,6,42,7.0,6,8,5,1
44192553.0,31,284,9.161290322580646,5,11,2,29
44202236.0,11,39,3.5454545454545454,2,6,11,0
44223049.0,93,285,3.064516129032258,1,5,93,0
44230229.0,328,1942,5.920731707317073,2,9,301,27
44231717.0,246,2421,9.841463414634147,3,13,12,234
44238211.0,4,19,4.75,4,5,4,0
44239357.0,35,240,6.857142857142857,5,9,27,8
44239853.0,14,65,4.642857142857143,2,7,14,0
44240881.0,102,977,9.57843137254902,2,12,6,96
44257148.0,235,480,2.0425531914893615,1,5,235,0
44257150.0,210,1433,6.8238095238095235,2,10,148,62
44264032.0,199,422,2.120603015075377,1,5,199,0
44265422.0,6,13,2.1666666666666665,1,3,6,0
44266069.0,150,450,3.0,1,5,150,0
44271725.0,80,473,5.9125,3,8,74,6
44272409.0,39,233,5.9743589743589745,4,9,35,4
44272734.0,44,260,5.909090909090909,2,8,41,3
44285143.0,93,469,5.043010752688172,2,7,93,0
44291179.0,30,203,6.766666666666667,3,9,21,9
44296044.0,7,9,1.2857142857142858,1,2,7,0
44296525.0,16,27,1.6875,1,3,16,0
44300691.0,254,1732,6.818897637795276,2,10,180,74
44300994.0,2,3,1.5,1,2,2,0
44310533.0,1,2,2.0,2,2,1,0
44324833.0,236,492,2.0847457627118646,1,5,236,0
44328380.0,285,1384,4.856140350877193,2,8,283,2
44329307.0,8,23,2.875,2,4,8,0
44331101.0,18,35,1.9444444444444444,1,5,18,0
44333593.0,2,6,3.0,3,3,2,0
44334909.0,125,853,6.824,2,9,89,36
44346885.0,27,237,8.777777777777779,6,11,5,22
44349389.0,341,1718,5.038123167155425,2,8,338,3
44367154.0,210,1018,4.847619047619047,1,8,209,1
44367589.0,88,419,4.761363636363637,2,7,88,0
44371780.0,37,180,4.864864864864865,3,6,37,0
44372857.0,2,3,1.5,1,2,2,0
44375072.0,5,5,1.0,1,1,5,0
44377648.0,5,19,3.8,2,6,5,0
44379099.0,13,28,2.1538461538461537,1,4,13,0
44385231.0,36,74,2.0555555555555554,1,4,36,0
44390412.0,35,106,3.0285714285714285,1,5,35,0
44394920.0,66,335,5.075757575757576,3,8,65,1
44403858.0,568,2802,4.933098591549296,2,8,566,2
44404326.0,3,18,6.0,5,7,3,0
44404636.0,1,4,4.0,4,4,1,0
44418001.0,8,13,1.625,1,4,8,0
44421818.0,7,22,3.142857142857143,2,4,7,0
44424282.0,224,2172,9.696428571428571,2,13,11,213
44424636.0,2,6,3.0,2,4,2,0
44424903.0,169,664,3.9289940828402368,1,7,169,0
44427811.0,15,94,6.266666666666667,4,8,14,1
44437175.0,179,880,4.916201117318436,2,7,179,0
44437654.0,213,1088,5.107981220657277,2,8,211,2
44444501.0,224,1954,8.723214285714286,2,12,24,200
44444979.0,265,1317,4.969811320754717,2,9,261,4
44447012.0,33,104,3.1515151515151514,1,5,33,0
44449129.0,362,2461,6.798342541436464,2,10,264,98
44452286.0,253,1241,4.905138339920948,2,7,253,0
44454150.0,148,574,3.8783783783783785,1,6,148,0
44454579.0,77,728,9.454545454545455,3,12,4,73
44456794.0,77,376,4.883116883116883,2,7,77,0
44460328.0,104,212,2.0384615384615383,1,4,104,0
44460602.0,125,242,1.936,1,5,125,0
44463987.0,22,87,3.9545454545454546,2,6,22,0
44470066.0,53,520,9.81132075471698,2,12,2,51
44470172.0,218,462,2.1192660550458715,1,4,218,0
44472511.0,306,1486,4.856209150326797,2,8,305,1
44472602.0,175,1197,6.84,2,9,127,48
44482497.0,1,3,3.0,3,3,1,0
44483171.0,105,718,6.838095238095238,4,9,79,26
44489465.0,90,190,2.111111111111111,1,4,90,0
44499937.0,57,565,9.912280701754385,6,12,1,56
44504334.0,2,8,4.0,2,6,2,0
44512402.0,4,6,1.5,1,3,4,0
44515755.0,5,14,2.8,1,4,5,0
44519046.0,274,2640,9.635036496350365,2,13,15,259
44521864.0,28,59,2.107142857142857,1,4,28,0
44524818.0,281,2674,9.516014234875446,2,13,18,263
44532389.0,30,232,7.733333333333333,3,11,14,16
44535695.0,303,2936,9.689768976897689,2,13,21,282
44543671.0,70,91,1.3,1,3,70,0
44544624.0,17,23,1.3529411764705883,1,2,17,0
44547695.0,81,570,7.037037037037037,3,10,53,28
44551437.0,62,245,3.9516129032258065,1,6,62,0
44565820.0,20,40,2.0,1,3,20,0
44572340.0,34,241,7.088235294117647,5,10,22,12
44575033.0,57,453,7.947368421052632,4,11,18,39
44584136.0,67,149,2.2238805970149254,1,4,67,0
44587841.0,31,307,9.903225806451612,7,12,1,30
44589839.0,289,1408,4.8719723183391,2,9,286,3
44590444.0,73,704,9.643835616438356,2,12,6,67
44591954.0,226,1086,4.8053097345132745,2,8,225,1
44592663.0,203,1035,5.098522167487685,2,7,203,0
44594034.0,23,50,2.1739130434782608,1,4,23,0
44597944.0,96,635,6.614583333333333,2,10,73,23
44601745.0,195,1878,9.63076923076923,2,13,14,181
44605806.0,2,5,2.5,2,3,2,0
44612031.0,49,300,6.122448979591836,3,9,43,6
44618884.0,3,5,1.6666666666666667,1,3,3,0
44623236.0,10,70,7.0,5,9,7,3
44623462.0,16,111,6.9375,5,8,9,7
44628557.0,27,248,9.185185185185185,7,12,1,26
44636881.0,359,494,1.3760445682451254,1,4,359,0
44637066.0,361,504,1.3961218836565097,1,4,361,0
44637099.0,354,496,1.4011299435028248,1,4,354,0
44637131.0,330,470,1.4242424242424243,1,4,330,0
44638066.0,39,148,3.7948717948717947,1,6,39,0
44639907.0,24,230,9.583333333333334,8,12,0,24
44645998.0,10,78,7.8,3,10,2,8
44654265.0,63,314,4.984126984126984,2,7,63,0
44671913.0,59,118,2.0,1,4,59,0
44671915.0,30,59,1.9666666666666666,1,4,30,0
44676457.0,31,306,9.870967741935484,6,12,1,30
44681470.0,57,124,2.175438596491228,1,4,57,0
44693781.0,37,66,1.7837837837837838,1,3,37,0
44697269.0,654,5726,8.755351681957187,2,12,79,575
44698337.0,1,8,8.0,8,8,0,1
44701940.0,84,180,2.142857142857143,1,4,84,0
44704372.0,211,1427,6.76303317535545,2,10,155,56
44737375.0,289,610,2.110726643598616,1,6,289,0
44738822.0,209,471,2.2535885167464116,1,4,209,0
44739815.0,249,516,2.072289156626506,1,6,249,0
44741204.0,68,661,9.720588235294118,2,13,5,63
44744975.0,199,1889,9.492462311557789,2,13,17,182
44754549.0,86,668,7.767441860465116,3,10,27,59
44772201.0,101,427,4.227722772277228,2,7,101,0
44775466.0,196,386,1.969387755102041,1,5,196,0
44777278.0,51,456,8.941176470588236,3,12,4,47
44778173.0,24,97,4.041666666666667,2,6,24,0
44783114.0,244,493,2.0204918032786887,1,4,244,0
44788166.0,3,9,3.0,2,4,3,0
44800203.0,29,112,3.8620689655172415,2,6,29,0
44800374.0,24,227,9.458333333333334,3,12,2,22
44803617.0,20,206,10.3,8,12,0,20
44836683.0,184,911,4.951086956521739,2,8,182,2
44841990.0,69,594,8.608695652173912,2,11,12,57
44847305.0,214,439,2.0514018691588785,1,5,214,0
44928238.0,296,2851,9.631756756756756,2,13,24,272
44929697.0,6,13,2.1666666666666665,1,3,6,0
44994584.0,4,26,6.5,6,8,3,1
44999657.0,73,150,2.0547945205479454,1,4,73,0
45000750.0,99,204,2.0606060606060606,1,4,99,0
45004985.0,47,98,2.0851063829787235,1,5,47,0
45007204.0,37,266,7.1891891891891895,5,10,22,15
45007457.0,24,53,2.2083333333333335,1,4,24,0
45016912.0,132,643,4.871212121212121,2,7,132,0
45048865.0,102,1017,9.970588235294118,3,13,4,98
45053842.0,24,111,4.625,3,7,24,0
45070591.0,159,1560,9.81132075471698,4,13,8,151
45076388.0,26,51,1.9615384615384615,1,4,26,0
45076395.0,8,18,2.25,1,3,8,0
45076397.0,50,106,2.12,1,4,50,0
45076400.0,5,17,3.4,2,5,5,0
45077266.0,17,151,8.882352941176471,4,11,3,14
45083536.0,1,1,1.0,1,1,1,0
45083640.0,59,592,10.033898305084746,3,13,1,58
45086357.0,4,11,2.75,2,4,4,0
45086755.0,167,840,5.029940119760479,2,8,165,2
45094814.0,13,136,10.461538461538462,9,13,0,13
45095851.0,97,561,5.783505154639175,3,8,91,6
45098208.0,41,176,4.2926829268292686,2,7,41,0
45114987.0,240,1645,6.854166666666667,2,9,166,74
45130034.0,281,2706,9.629893238434164,2,13,20,261
45130701.0,1,1,1.0,1,1,1,0
45130706.0,25,44,1.76,1,4,25,0
45132677.0,16,102,6.375,3,8,13,3
45142590.0,156,1036,6.641025641025641,2,10,117,39
45148893.0,51,247,4.8431372549019605,2,7,51,0
45149502.0,31,68,2.193548387096774,1,4,31,0
45149752.0,30,61,2.033333333333333,1,4,30,0
45149887.0,3,7,2.3333333333333335,1,4,3,0
45151825.0,3,7,2.3333333333333335,2,3,3,0
45178219.0,36,275,7.638888888888889,2,11,16,20
45182478.0,20,97,4.85,3,6,20,0
45183730.0,5,7,1.4,1,2,5,0
45184601.0,79,763,9.658227848101266,4,12,5,74
45184972.0,17,34,2.0,1,4,17,0
45185055.0,7,15,2.142857142857143,1,3,7,0
45185922.0,3,7,2.3333333333333335,1,4,3,0
45186871.0,194,406,2.0927835051546393,1,6,194,0
45195511.0,29,57,1.9655172413793103,1,5,29,0
45197793.0,8,25,3.125,2,5,8,0
45203225.0,238,513,2.1554621848739495,1,5,238,0
45234416.0,66,134,2.0303030303030303,1,4,66,0
45238401.0,20,61,3.05,2,5,20,0
45238819.0,2,5,2.5,2,3,2,0
45239011.0,10,31,3.1,1,5,10,0
45241696.0,41,86,2.097560975609756,1,5,41,0
45254260.0,276,2402,8.702898550724637,3,12,34,242
45255616.0,10,73,7.3,5,9,5,5
45261839.0,3,8,2.6666666666666665,2,4,3,0
45263442.0,66,458,6.9393939393939394,2,9,39,27
45265338.0,59,232,3.9322033898305087,2,6,59,0
45267884.0,37,76,2.054054054054054,1,4,37,0
45271286.0,70,670,9.571428571428571,2,12,6,64
45279512.0,17,83,4.882352941176471,2,8,16,1
45279821.0,36,141,3.9166666666666665,2,6,36,0
45283717.0,31,265,8.548387096774194,3,12,4,27
45294165.0,292,1502,5.1438356164383565,2,8,288,4
45294780.0,119,1134,9.529411764705882,2,12,11,108
45297765.0,1,4,4.0,4,4,1,0
45312688.0,1,1,1.0,1,1,1,0
45329104.0,204,1937,9.495098039215685,2,13,18,186
45336924.0,148,595,4.02027027027027,2,7,148,0
45340919.0,21,107,5.095238095238095,3,8,19,2
45342011.0,422,2097,4.969194312796208,2,8,417,5
45343567.0,6,10,1.6666666666666667,1,3,6,0
45348230.0,180,1422,7.9,4,10,56,124
45357026.0,6,59,9.833333333333334,8,11,0,6
45361714.0,1,3,3.0,3,3,1,0
45374505.0,50,249,4.98,2,8,49,1
45376183.0,18,92,5.111111111111111,4,8,17,1
45378440.0,6,31,5.166666666666667,4,6,6,0
45412099.0,254,346,1.3622047244094488,1,4,254,0
45414492.0,3,15,5.0,5,5,3,0
45415174.0,63,305,4.841269841269841,2,7,63,0
45416891.0,29,291,10.03448275862069,8,13,0,29
45422181.0,4,12,3.0,2,4,4,0
45427349.0,12,25,2.0833333333333335,1,3,12,0
45428382.0,56,116,2.0714285714285716,1,4,56,0
45429735.0,30,147,4.9,3,7,30,0
45429840.0,28,133,4.75,2,7,28,0
45430011.0,8,44,5.5,4,7,8,0
45430129.0,1,3,3.0,3,3,1,0
45430266.0,9,47,5.222222222222222,4,7,9,0
45430301.0,1,4,4.0,4,4,1,0
45430367.0,3,16,5.333333333333333,5,6,3,0
45437588.0,152,594,3.9078947368421053,2,6,152,0
45437699.0,8,10,1.25,1,2,8,0
45437989.0,6,41,6.833333333333333,5,9,4,2
45438903.0,58,231,3.9827586206896552,1,6,58,0
45445654.0,105,807,7.685714285714286,2,10,38,67
45446226.0,1,1,1.0,1,1,1,0
45449997.0,2,3,1.5,1,2,2,0
45458791.0,136,1201,8.830882352941176,2,11,16,120
45460985.0,100,493,4.93,2,7,100,0
45461710.0,152,1319,8.677631578947368,2,11,20,132
45462688.0,1,8,8.0,8,8,0,1
45462796.0,113,555,4.911504424778761,3,7,113,0
45467414.0,1,4,4.0,4,4,1,0
45475039.0,32,64,2.0,1,4,32,0
45476656.0,62,123,1.9838709677419355,1,4,62,0
45478089.0,17,119,7.0,5,9,12,5
45486869.0,12,52,4.333333333333333,2,6,12,0
45489052.0,53,107,2.018867924528302,1,4,53,0
45490082.0,11,35,3.1818181818181817,2,4,11,0
45491308.0,208,1043,5.014423076923077,2,8,204,4
45494152.0,204,1023,5.014705882352941,2,8,202,2
45494282.0,236,1163,4.927966101694915,2,8,235,1
45501095.0,64,298,4.65625,2,6,64,0
45503675.0,517,2552,4.9361702127659575,2,8,515,2
45503838.0,461,2249,4.8785249457700655,2,9,455,6
45503913.0,436,2151,4.93348623853211,2,7,436,0
45504264.0,2,7,3.5,3,4,2,0
45510466.0,283,2746,9.703180212014134,2,13,16,267
45511907.0,45,318,7.066666666666666,3,10,28,17
45511915.0,159,462,2.9056603773584904,1,6,159,0
45512915.0,46,323,7.021739130434782,5,9,33,13
45513053.0,64,121,1.890625,1,4,64,0
45513138.0,18,125,6.944444444444445,5,9,12,6
45513949.0,23,52,2.260869565217391,1,4,23,0
45514012.0,33,230,6.96969696969697,5,10,25,8
45514093.0,11,72,6.545454545454546,2,8,7,4
45514199.0,16,112,7.0,4,9,12,4
45514251.0,27,178,6.592592592592593,2,9,21,6
45515897.0,27,69,2.5555555555555554,1,5,27,0
45521365.0,4,30,7.5,7,8,2,2
45523405.0,9,64,7.111111111111111,6,9,7,2
45525736.0,25,152,6.08,2,9,19,6
45526338.0,38,304,8.0,6,10,11,27
45528363.0,16,117,7.3125,5,9,9,7
45528915.0,105,1016,9.676190476190476,2,12,5,100
45531416.0,8,12,1.5,1,3,8,0
45531428.0,235,490,2.0851063829787235,1,4,235,0
45535735.0,147,208,1.4149659863945578,1,4,147,0
45555597.0,51,108,2.1176470588235294,1,4,51,0
45561011.0,84,720,8.571428571428571,2,12,13,71
45563560.0,206,1018,4.941747572815534,2,8,204,2
45568795.0,3,22,7.333333333333333,5,9,1,2
45580208.0,25,57,2.28,1,4,25,0
45588039.0,94,193,2.0531914893617023,1,4,94,0
45588549.0,102,499,4.892156862745098,2,8,101,1
45589741.0,90,452,5.022222222222222,3,8,88,2
45593177.0,213,1651,7.751173708920188,2,11,72,141
45601459.0,283,1382,4.88339222614841,2,8,282,1
45605248.0,85,179,2.1058823529411765,1,5,85,0
45612845.0,73,92,1.2602739726027397,1,4,73,0
45612901.0,41,61,1.4878048780487805,1,3,41,0
45613004.0,36,54,1.5,1,4,36,0
45613059.0,122,728,5.967213114754099,2,9,112,10
45618827.0,136,390,2.8676470588235294,1,7,136,0
45622121.0,282,1377,4.882978723404255,2,8,281,1
45627566.0,16,87,5.4375,4,7,16,0
45628045.0,3,13,4.333333333333333,2,6,3,0
45628500.0,32,131,4.09375,3,6,32,0
45629591.0,21,105,5.0,3,7,21,0
45629909.0,41,195,4.7560975609756095,2,8,40,1
45644836.0,13,42,3.230769230769231,1,5,13,0
45646549.0,4,14,3.5,3,4,4,0
45647213.0,202,1975,9.777227722772277,3,12,8,194
45651792.0,248,1235,4.979838709677419,2,7,248,0
45668882.0,11,24,2.1818181818181817,1,4,11,0
45672231.0,554,2729,4.925992779783393,2,8,553,1
45673709.0,48,248,5.166666666666667,3,7,48,0
45674320.0,11,15,1.3636363636363635,1,3,11,0
45674396.0,19,121,6.368421052631579,2,8,15,4
45679610.0,1,4,4.0,4,4,1,0
45681647.0,6,12,2.0,1,3,6,0
45685762.0,3,9,3.0,3,3,3,0
45685766.0,7,27,3.857142857142857,2,5,7,0
45692982.0,113,224,1.9823008849557522,1,4,113,0
45694875.0,469,2334,4.976545842217484,2,8,464,5
45695299.0,13,17,1.3076923076923077,1,2,13,0
45698740.0,284,1399,4.926056338028169,2,8,283,1
45698879.0,71,346,4.873239436619718,2,7,71,0
45701033.0,75,509,6.786666666666667,3,10,56,19
45701437.0,154,319,2.0714285714285716,1,4,154,0
45708473.0,82,709,8.646341463414634,2,12,13,69
45711026.0,299,600,2.0066889632107023,1,5,299,0
45712379.0,110,446,4.054545454545455,2,6,110,0
45728519.0,70,351,5.014285714285714,2,8,69,1
45729281.0,115,549,4.773913043478261,2,8,114,1
45744371.0,69,346,5.0144927536231885,2,7,69,0
45744665.0,8,21,2.625,2,3,8,0
45744932.0,91,865,9.505494505494505,3,12,7,84
45747929.0,5,36,7.2,6,8,3,2
45752967.0,10,80,8.0,7,9,2,8
45761659.0,2,3,1.5,1,2,2,0
45762315.0,15,29,1.9333333333333333,1,4,15,0
45772183.0,102,887,8.696078431372548,3,11,11,91
45783078.0,65,568,8.738461538461538,2,11,5,60
45784296.0,113,548,4.849557522123894,2,7,113,0
45784524.0,6,12,2.0,1,3,6,0
45786028.0,35,320,9.142857142857142,3,12,5,30
45792001.0,13,27,2.076923076923077,1,3,13,0
45807881.0,117,160,1.3675213675213675,1,4,117,0
45808882.0,149,1025,6.879194630872483,2,10,106,43
45811621.0,127,992,7.811023622047244,2,11,41,86
45814256.0,189,376,1.9894179894179893,1,5,189,0
45821386.0,102,706,6.921568627450981,3,10,70,32
45822566.0,419,3660,8.735083532219571,2,12,51,368
45826846.0,1,3,3.0,3,3,1,0
45827706.0,107,1063,9.934579439252337,2,12,3,104
45834757.0,125,260,2.08,1,5,125,0
45835235.0,69,153,2.217391304347826,1,4,69,0
45841735.0,2,7,3.5,3,4,2,0
45844738.0,18,54,3.0,2,4,18,0
45846191.0,1,2,2.0,2,2,1,0
45846774.0,30,284,9.466666666666667,2,12,1,29
45852169.0,13,130,10.0,8,11,0,13
45853699.0,78,756,9.692307692307692,4,13,2,76
45854255.0,2,5,2.5,2,3,2,0
45854494.0,76,157,2.0657894736842106,1,4,76,0
45856003.0,6,12,2.0,1,3,6,0
45863468.0,62,421,6.790322580645161,2,9,46,16
45864881.0,27,35,1.2962962962962963,1,3,27,0
45872181.0,291,1437,4.938144329896907,2,8,289,2
45872306.0,11,19,1.7272727272727273,1,3,11,0
45872701.0,179,936,5.229050279329609,2,8,177,2
45872891.0,25,78,3.12,1,5,25,0
45874605.0,168,827,4.9226190476190474,2,8,166,2
45875117.0,26,47,1.8076923076923077,1,4,26,0
45881033.0,28,167,5.964285714285714,3,8,26,2
45881547.0,22,217,9.863636363636363,8,12,0,22
45885882.0,109,743,6.81651376146789,3,9,78,31
45888865.0,38,76,2.0,1,4,38,0
45890014.0,65,427,6.569230769230769,2,9,48,17
45891609.0,50,338,6.76,2,9,37,13
45892559.0,55,375,6.818181818181818,5,9,40,15
45893114.0,69,453,6.565217391304348,2,9,51,18
45893675.0,3,6,2.0,1,3,3,0
45903549.0,30,94,3.1333333333333333,1,6,30,0
45903659.0,186,887,4.768817204301075,2,8,185,1
45906579.0,75,502,6.693333333333333,3,10,62,13
45906932.0,40,271,6.775,2,10,29,11
45907480.0,65,461,7.092307692307692,2,9,41,24
45923290.0,21,103,4.904761904761905,3,7,21,0
45926539.0,1,3,3.0,3,3,1,0
45947254.0,224,475,2.1205357142857144,1,5,224,0
45947376.0,132,280,2.121212121212121,1,4,132,0
45950602.0,33,80,2.4242424242424243,1,5,33,0
45954224.0,13,18,1.3846153846153846,1,3,13,0
45963105.0,35,183,5.228571428571429,3,7,35,0
45963161.0,188,738,3.925531914893617,1,7,188,0
45973538.0,150,290,1.9333333333333333,1,4,150,0
45975729.0,50,63,1.26,1,3,50,0
45980285.0,21,145,6.904761904761905,3,10,16,5
45981294.0,83,415,5.0,2,8,82,1
45982567.0,80,397,4.9625,2,7,80,0
45984124.0,132,279,2.1136363636363638,1,4,132,0
45984403.0,4,6,1.5,1,2,4,0
45988505.0,1,3,3.0,3,3,1,0
45989282.0,1,1,1.0,1,1,1,0
46000369.0,188,733,3.898936170212766,1,7,188,0
46008930.0,12,79,6.583333333333333,5,9,9,3
46009611.0,6,41,6.833333333333333,6,8,5,1
46014679.0,4,9,2.25,2,3,4,0
46015921.0,24,69,2.875,1,5,24,0
46016731.0,67,261,3.8955223880597014,1,7,67,0
46038068.0,3,8,2.6666666666666665,2,3,3,0
46053037.0,5,7,1.4,1,2,5,0
46060050.0,27,181,6.703703703703703,4,9,22,5
46061049.0,18,136,7.555555555555555,5,10,7,11
46061199.0,20,145,7.25,3,9,9,11
46064663.0,104,702,6.75,3,10,75,29
46065771.0,33,275,8.333333333333334,4,10,7,26
46070014.0,49,479,9.775510204081632,3,12,3,46
46078460.0,21,184,8.761904761904763,4,11,3,18
46084732.0,1,3,3.0,3,3,1,0
46086563.0,131,622,4.748091603053435,2,7,131,0
46118957.0,206,1400,6.796116504854369,2,10,146,60
46119635.0,136,1174,8.632352941176471,2,12,19,117
46121375.0,4,8,2.0,2,2,4,0
46122467.0,12,36,3.0,2,4,12,0
46131215.0,18,111,6.166666666666667,2,9,13,5
46131802.0,1,4,4.0,4,4,1,0
46132037.0,7,24,3.4285714285714284,2,5,7,0
46132375.0,3,4,1.3333333333333333,1,2,3,0
46133303.0,4,6,1.5,1,2,4,0
46133390.0,4,7,1.75,1,2,4,0
46168595.0,137,933,6.810218978102189,3,10,105,32
46171636.0,19,126,6.631578947368421,3,8,14,5
46182572.0,71,353,4.971830985915493,2,8,70,1
46189595.0,1,1,1.0,1,1,1,0
46190366.0,57,389,6.824561403508772,4,9,40,17
46196359.0,1,2,2.0,2,2,1,0
46217977.0,168,1625,9.672619047619047,2,13,10,158
46219955.0,6,40,6.666666666666667,6,7,6,0
46228864.0,181,709,3.9171270718232045,1,7,181,0
46256315.0,1,1,1.0,1,1,1,0
46258610.0,4,21,5.25,5,6,4,0
46270205.0,38,194,5.105263157894737,3,7,38,0
46277020.0,2,4,2.0,1,3,2,0
46286871.0,2,3,1.5,1,2,2,0
46306672.0,13,114,8.76923076923077,6,10,2,11
46307847.0,172,1181,6.866279069767442,2,9,123,49
46324365.0,149,1024,6.87248322147651,3,10,109,40
46331351.0,6,46,7.666666666666667,7,8,2,4
46333097.0,50,485,9.7,4,12,3,47
46344170.0,154,1024,6.64935064935065,2,11,118,36
46344279.0,107,735,6.869158878504673,2,9,74,33
46344684.0,140,967,6.9071428571428575,2,10,100,40
46345429.0,35,173,4.942857142857143,3,7,35,0
46347252.0,70,278,3.9714285714285715,1,7,70,0
46347872.0,32,302,9.4375,4,12,2,30
46348662.0,129,499,3.868217054263566,2,7,129,0
46348987.0,137,535,3.9051094890510947,1,7,137,0
46349061.0,168,669,3.982142857142857,1,6,168,0
46349143.0,153,607,3.9673202614379086,2,7,153,0
46366174.0,3,22,7.333333333333333,7,8,2,1
46372262.0,4,11,2.75,1,4,4,0
46374472.0,138,1376,9.971014492753623,2,13,4,134
46388197.0,1,3,3.0,3,3,1,0
46409008.0,97,466,4.804123711340206,2,7,97,0
46413847.0,531,2084,3.9246704331450095,1,7,531,0
46416805.0,538,4728,8.788104089219331,2,13,72,466
46431272.0,23,34,1.4782608695652173,1,3,23,0
46442448.0,1,3,3.0,3,3,1,0
46464310.0,25,173,6.92,2,10,17,8
46466579.0,38,335,8.81578947368421,5,11,4,34
46467979.0,14,51,3.642857142857143,2,5,14,0
46472835.0,63,559,8.873015873015873,4,11,7,56
46500342.0,45,131,2.911111111111111,1,5,45,0
46544267.0,46,187,4.065217391304348,2,7,46,0
46549736.0,96,465,4.84375,2,7,96,0
46564965.0,70,608,8.685714285714285,2,11,11,59
46565987.0,209,1448,6.92822966507177,3,10,145,64
46565988.0,100,847,8.47,3,12,16,84
46576048.0,34,241,7.088235294117647,5,9,22,12
46611870.0,11,23,2.090909090909091,1,3,11,0
46619076.0,31,289,9.32258064516129,2,12,5,26
46632262.0,64,306,4.78125,2,7,64,0
46635765.0,133,1301,9.781954887218046,2,13,6,127
46653997.0,123,620,5.040650406504065,2,8,122,1
46679672.0,44,116,2.6363636363636362,1,5,44,0
46685637.0,5,8,1.6,1,2,5,0
46708522.0,49,197,4.020408163265306,2,6,49,0
46742008.0,66,103,1.5606060606060606,1,3,66,0
46748985.0,110,549,4.990909090909091,2,8,107,3
46764031.0,4,21,5.25,3,7,4,0
46764435.0,44,90,2.0454545454545454,1,4,44,0
46768983.0,236,2291,9.707627118644067,2,13,17,219
46784625.0,56,379,6.767857142857143,2,10,40,16
46785291.0,233,1164,4.9957081545064375,2,8,230,3
46806488.0,26,56,2.1538461538461537,1,5,26,0
46806987.0,548,735,1.3412408759124088,1,4,548,0
46817041.0,108,527,4.87962962962963,2,7,108,0
46825568.0,57,332,5.824561403508772,2,9,53,4
46830431.0,86,183,2.127906976744186,1,4,86,0
46843887.0,1,1,1.0,1,1,1,0
46848814.0,76,165,2.1710526315789473,1,5,76,0
46861241.0,21,40,1.9047619047619047,1,4,21,0
46862637.0,97,478,4.927835051546392,2,8,96,1
46872998.0,3,9,3.0,3,3,3,0
46887312.0,153,444,2.9019607843137254,1,6,153,0
46891999.0,54,315,5.833333333333333,2,9,48,6
46893772.0,29,176,6.068965517241379,4,8,27,2
46893791.0,67,89,1.328358208955224,1,3,67,0
46894476.0,51,348,6.823529411764706,4,9,37,14
46894896.0,78,539,6.910256410256411,2,9,57,21
46894963.0,4,9,2.25,1,3,4,0
46898355.0,32,151,4.71875,3,6,32,0
46901252.0,1,2,2.0,2,2,1,0
46901300.0,149,1020,6.845637583892618,2,9,102,47
46910429.0,150,447,2.98,1,6,150,0
46915442.0,90,289,3.2111111111111112,1,6,90,0
46917141.0,168,341,2.0297619047619047,1,5,168,0
46917867.0,7,55,7.857142857142857,5,10,2,5
46918417.0,45,306,6.8,2,9,33,12
46920813.0,3,4,1.3333333333333333,1,2,3,0
46921827.0,107,1053,9.841121495327103,5,12,2,105
46933406.0,31,155,5.0,3,7,31,0
46934135.0,66,511,7.742424242424242,2,11,25,41
46934960.0,5,30,6.0,4,7,5,0
46938875.0,3,11,3.6666666666666665,2,5,3,0
46939216.0,1,1,1.0,1,1,1,0
46959690.0,11,40,3.6363636363636362,1,5,11,0
46963336.0,192,968,5.041666666666667,1,8,191,1
46965610.0,36,279,7.75,3,11,13,23
46966660.0,82,410,5.0,2,8,80,2
46967113.0,168,1294,7.7023809523809526,2,11,64,104
46977855.0,201,984,4.895522388059701,2,8,199,2
47002462.0,44,304,6.909090909090909,2,9,26,18
47004245.0,123,258,2.097560975609756,1,4,123,0
47040329.0,4,13,3.25,3,4,4,0
47048317.0,202,432,2.1386138613861387,1,4,202,0
47061522.0,3,25,8.333333333333334,8,9,0,3
47062353.0,227,1126,4.960352422907489,2,8,226,1
47064850.0,156,627,4.019230769230769,2,6,156,0
47070124.0,233,2009,8.622317596566523,2,11,33,200
47070653.0,7,56,8.0,6,10,3,4
47071881.0,34,176,5.176470588235294,3,7,34,0
47083186.0,1,2,2.0,2,2,1,0
47109627.0,8,14,1.75,1,3,8,0
47132846.0,230,1167,5.073913043478261,2,8,229,1
47135942.0,334,2599,7.781437125748503,2,11,117,217
47151144.0,11,25,2.272727272727273,1,5,11,0
47151303.0,17,32,1.8823529411764706,1,3,17,0
47151430.0,44,307,6.9772727272727275,4,9,30,14
47167171.0,32,38,1.1875,1,2,32,0
47209967.0,263,1298,4.935361216730038,2,8,259,4
47212745.0,74,643,8.68918918918919,3,11,11,63
47220499.0,33,43,1.303030303030303,1,3,33,0
47228890.0,17,130,7.647058823529412,4,10,5,12
47233963.0,29,154,5.310344827586207,2,8,28,1
47249899.0,35,99,2.8285714285714287,1,5,35,0
47281015.0,10,49,4.9,2,7,10,0
47281430.0,526,2091,3.9752851711026618,1,7,526,0
47281583.0,444,1748,3.936936936936937,1,7,444,0
47307238.0,68,342,5.029411764705882,3,7,68,0
47307278.0,4,15,3.75,3,5,4,0
47307465.0,87,340,3.9080459770114944,1,6,87,0
47307504.0,32,164,5.125,2,8,31,1
47308216.0,100,496,4.96,2,7,100,0
47347769.0,29,209,7.206896551724138,5,9,19,10
47367708.0,2,4,2.0,1,3,2,0
47383722.0,16,48,3.0,1,4,16,0
47397851.0,41,119,2.902439024390244,1,5,41,0
47401884.0,334,1637,4.901197604790419,2,8,329,5
47404677.0,35,346,9.885714285714286,5,12,1,34
47426281.0,73,210,2.8767123287671232,1,6,73,0
47434973.0,233,921,3.9527896995708156,1,7,233,0
47435891.0,261,1741,6.670498084291188,2,10,191,70
47463120.0,1,2,2.0,2,2,1,0
47463653.0,16,121,7.5625,4,10,8,8
47468659.0,78,753,9.653846153846153,2,12,5,73
47490410.0,49,243,4.959183673469388,3,7,49,0
47493974.0,216,856,3.962962962962963,1,7,216,0
47502317.0,241,510,2.116182572614108,1,4,241,0
47526683.0,115,796,6.921739130434783,2,10,74,41
47543761.0,2,14,7.0,7,7,2,0
47574107.0,42,280,6.666666666666667,3,8,31,11
47590224.0,141,290,2.0567375886524824,1,5,141,0
47595904.0,30,119,3.966666666666667,2,6,30,0
47712008.0,1,3,3.0,3,3,1,0
47724322.0,24,185,7.708333333333333,4,10,8,16
47724990.0,81,171,2.111111111111111,1,5,81,0
47727966.0,86,177,2.058139534883721,1,4,86,0
47738729.0,1,3,3.0,3,3,1,0
47768291.0,29,192,6.620689655172414,3,8,24,5
47769310.0,105,706,6.723809523809524,2,10,80,25
47769654.0,3,21,7.0,5,9,2,1
47792181.0,247,1204,4.874493927125506,2,7,247,0
47805996.0,41,275,6.7073170731707314,3,9,31,10
47808986.0,1,1,1.0,1,1,1,0
47813500.0,15,32,2.1333333333333333,1,3,15,0
47828572.0,31,155,5.0,4,7,31,0
47846679.0,170,231,1.3588235294117648,1,4,170,0
47856983.0,8,20,2.5,1,4,8,0
47857123.0,3,10,3.3333333333333335,3,4,3,0
47857478.0,74,291,3.9324324324324325,1,6,74,0
47862830.0,16,166,10.375,9,12,0,16
47880403.0,43,292,6.790697674418604,3,10,35,8
47881356.0,33,67,2.0303030303030303,1,4,33,0
47881575.0,9,11,1.2222222222222223,1,2,9,0
47883453.0,39,88,2.2564102564102564,1,5,39,0
47883460.0,89,187,2.101123595505618,1,5,89,0
47883468.0,28,55,1.9642857142857142,1,4,28,0
47883472.0,21,40,1.9047619047619047,1,4,21,0
47883473.0,58,129,2.2241379310344827,1,4,58,0
47883477.0,46,90,1.9565217391304348,1,4,46,0
47883493.0,46,100,2.1739130434782608,1,5,46,0
47883496.0,63,127,2.015873015873016,1,4,63,0
47883508.0,54,112,2.074074074074074,1,4,54,0
47883510.0,42,89,2.119047619047619,1,4,42,0
47883512.0,53,108,2.0377358490566038,1,4,53,0
47883513.0,44,85,1.9318181818181819,1,4,44,0
47883515.0,121,247,2.041322314049587,1,5,121,0
47883524.0,69,161,2.3333333333333335,1,5,69,0
47883526.0,85,165,1.9411764705882353,1,5,85,0
47883527.0,91,197,2.1648351648351647,1,5,91,0
47883546.0,92,191,2.0760869565217392,1,4,92,0
47883547.0,65,135,2.076923076923077,1,5,65,0
47883548.0,27,56,2.074074074074074,1,4,27,0
47883560.0,82,179,2.182926829268293,1,4,82,0
47883565.0,50,99,1.98,1,4,50,0
47883567.0,140,285,2.0357142857142856,1,5,140,0
47883571.0,134,268,2.0,1,5,134,0
47884467.0,69,140,2.028985507246377,1,5,69,0
47884479.0,38,83,2.1842105263157894,1,4,38,0
47884481.0,61,131,2.1475409836065573,1,4,61,0
47884484.0,40,94,2.35,1,5,40,0
47884485.0,33,74,2.242424242424242,1,5,33,0
47884511.0,101,199,1.9702970297029703,1,4,101,0
47884516.0,135,379,2.8074074074074074,1,6,135,0
47896715.0,24,141,5.875,2,8,22,2
47897389.0,132,284,2.1515151515151514,1,5,132,0
47899220.0,49,467,9.53061224489796,3,12,3,46
47900181.0,122,355,2.9098360655737703,1,5,122,0
47901684.0,9,14,1.5555555555555556,1,3,9,0
47908225.0,121,269,2.2231404958677685,1,5,121,0
47914342.0,125,258,2.064,1,4,125,0
47915506.0,130,256,1.9692307692307693,1,5,130,0
47915999.0,148,315,2.1283783783783785,1,5,148,0
47919473.0,25,127,5.08,3,8,24,1
47924037.0,5,6,1.2,1,2,5,0
47928964.0,63,296,4.698412698412699,2,7,63,0
47931462.0,108,419,3.8796296296296298,2,6,108,0
47932690.0,120,939,7.825,2,10,41,79
47936891.0,61,242,3.9672131147540983,2,6,61,0
47950055.0,95,199,2.094736842105263,1,4,95,0
47952786.0,52,511,9.826923076923077,3,12,2,50
47953891.0,55,532,9.672727272727272,4,12,4,51
47988323.0,17,85,5.0,2,6,17,0
48001890.0,375,3670,9.786666666666667,2,13,13,362
48002664.0,125,396,3.168,1,6,125,0
48007717.0,42,135,3.2142857142857144,1,5,42,0
48023244.0,18,36,2.0,1,4,18,0
48024405.0,161,1527,9.48447204968944,2,13,12,149
48027065.0,411,869,2.1143552311435525,1,5,411,0
48027131.0,437,887,2.0297482837528604,1,5,437,0
48027302.0,449,1790,3.9866369710467704,1,7,449,0
48028903.0,135,404,2.9925925925925925,1,5,135,0
48050314.0,144,717,4.979166666666667,2,8,143,1
48050381.0,95,465,4.894736842105263,3,8,94,1
48050651.0,14,67,4.785714285714286,4,6,14,0
48056856.0,60,76,1.2666666666666666,1,3,60,0
48063859.0,73,372,5.095890410958904,2,8,72,1
48063944.0,255,1535,6.019607843137255,3,9,229,26
48065222.0,4,26,6.5,5,8,3,1
48075156.0,22,44,2.0,1,4,22,0
48089804.0,194,1319,6.798969072164948,2,10,133,61
48094142.0,1,2,2.0,2,2,1,0
48099045.0,66,320,4.848484848484849,2,7,66,0
48102413.0,23,159,6.913043478260869,5,9,17,6
48105121.0,14,73,5.214285714285714,4,7,14,0
48105681.0,119,245,2.0588235294117645,1,5,119,0
48106186.0,3,7,2.3333333333333335,1,3,3,0
48119992.0,117,813,6.948717948717949,3,9,82,35
48122153.0,135,924,6.844444444444444,3,9,97,38
48122207.0,8,57,7.125,2,9,3,5
48122835.0,268,353,1.3171641791044777,1,4,268,0
48127817.0,109,861,7.89908256880734,2,10,28,81
48128627.0,13,93,7.153846153846154,5,10,8,5
48128650.0,109,534,4.89908256880734,2,8,108,1
48128651.0,136,692,5.088235294117647,2,8,135,1
48131490.0,99,403,4.070707070707071,1,6,99,0
48140458.0,16,79,4.9375,2,7,16,0
48140623.0,239,487,2.0376569037656904,1,4,239,0
48152420.0,86,264,3.0697674418604652,1,5,86,0
48152548.0,23,113,4.913043478260869,2,7,23,0
48154960.0,29,61,2.103448275862069,1,4,29,0
48156723.0,58,335,5.775862068965517,3,8,56,2
48173962.0,42,86,2.0476190476190474,1,4,42,0
48176625.0,1,6,6.0,6,6,1,0
48191896.0,18,60,3.3333333333333335,2,5,18,0
48192081.0,2,6,3.0,3,3,2,0
48192419.0,3,9,3.0,2,4,3,0
48204406.0,91,713,7.835164835164835,3,11,32,59
48204964.0,69,139,2.0144927536231885,1,4,69,0
48209526.0,89,525,5.898876404494382,3,8,88,1
48209577.0,12,33,2.75,1,4,12,0
48218623.0,62,251,4.048387096774194,2,7,62,0
48227429.0,1,1,1.0,1,1,1,0
48245090.0,315,1522,4.8317460317460315,2,8,313,2
48248905.0,5,39,7.8,3,10,1,4
48249273.0,84,658,7.833333333333333,2,11,25,59
48251579.0,84,172,2.0476190476190474,1,4,84,0
48262839.0,30,124,4.133333333333334,2,6,30,0
48267071.0,6,10,1.6666666666666667,1,2,6,0
48269599.0,243,1201,4.94238683127572,2,8,240,3
48276489.0,24,52,2.1666666666666665,1,4,24,0
48284153.0,164,311,1.896341463414634,1,4,164,0
48290903.0,66,136,2.0606060606060606,1,4,66,0
48295688.0,4,19,4.75,4,6,4,0
48306657.0,95,817,8.6,3,12,12,83
48306696.0,361,3482,9.645429362880886,2,13,23,338
48313988.0,205,1996,9.736585365853658,2,13,6,199
48315284.0,81,412,5.08641975308642,2,7,81,0
48315547.0,17,88,5.176470588235294,2,7,17,0
48321879.0,4,20,5.0,4,6,4,0
48325709.0,99,215,2.1717171717171717,1,5,99,0
48325979.0,147,727,4.945578231292517,3,8,145,2
48328408.0,46,445,9.673913043478262,2,13,4,42
48354077.0,20,38,1.9,1,4,20,0
48368803.0,67,342,5.104477611940299,3,7,67,0
48377268.0,19,88,4.631578947368421,3,6,19,0
48380491.0,1,9,9.0,9,9,0,1
48389402.0,188,391,2.0797872340425534,1,4,188,0
48413286.0,23,147,6.391304347826087,5,7,23,0
48413555.0,56,378,6.75,3,10,40,16
48417206.0,51,141,2.764705882352941,1,4,51,0
48420767.0,165,1444,8.751515151515152,2,12,17,148
48421435.0,266,1021,3.838345864661654,1,7,266,0
48424035.0,35,73,2.085714285714286,1,4,35,0
48424322.0,97,209,2.154639175257732,1,4,97,0
48437356.0,86,125,1.4534883720930232,1,5,86,0
48441434.0,10,19,1.9,1,3,10,0
48443041.0,105,532,5.066666666666666,2,7,105,0
48478575.0,154,619,4.01948051948052,2,7,154,0
48480789.0,38,46,1.2105263157894737,1,2,38,0
48487214.0,11,35,3.1818181818181817,2,4,11,0
48496263.0,184,1276,6.934782608695652,2,10,123,61
48500880.0,208,1436,6.903846153846154,2,10,142,66
48536655.0,147,291,1.9795918367346939,1,4,147,0
48541841.0,196,970,4.948979591836735,2,8,192,4
48547228.0,147,1282,8.72108843537415,2,12,16,131
48560336.0,64,615,9.609375,3,12,4,60
48561612.0,199,994,4.994974874371859,2,8,197,2
48562260.0,55,277,5.036363636363636,3,7,55,0
48562451.0,48,320,6.666666666666667,3,9,37,11
48562755.0,72,105,1.4583333333333333,1,4,72,0
48565349.0,33,235,7.121212121212121,3,10,19,14
48576634.0,112,227,2.0267857142857144,1,4,112,0
48578363.0,3,11,3.6666666666666665,2,5,3,0
48578390.0,107,840,7.850467289719626,2,10,36,71
48579089.0,18,127,7.055555555555555,5,9,12,6
48583100.0,106,730,6.886792452830188,4,9,77,29
48583336.0,60,411,6.85,2,9,40,20
48587231.0,66,140,2.121212121212121,1,4,66,0
48597973.0,20,74,3.7,2,6,20,0
48600124.0,70,670,9.571428571428571,3,12,2,68
48603724.0,8,18,2.25,1,4,8,0
48604787.0,125,388,3.104,1,6,125,0
48615446.0,27,139,5.148148148148148,3,7,27,0
48615913.0,58,495,8.53448275862069,2,11,10,48
48616183.0,3,23,7.666666666666667,7,8,1,2
48636108.0,12,24,2.0,1,4,12,0
48637544.0,111,167,1.5045045045045045,1,4,111,0
48641220.0,75,238,3.1733333333333333,1,5,75,0
48641441.0,184,382,2.0760869565217392,1,4,184,0
48643914.0,1,1,1.0,1,1,1,0
48652748.0,20,97,4.85,3,7,20,0
48653571.0,17,50,2.9411764705882355,1,5,17,0
48667689.0,120,588,4.9,2,8,119,1
48669129.0,150,601,4.006666666666667,1,7,150,0
48670078.0,202,995,4.925742574257426,2,8,201,1
48672492.0,116,570,4.913793103448276,2,8,114,2
48689454.0,12,23,1.9166666666666667,1,3,12,0
48700588.0,110,1052,9.563636363636364,2,12,7,103
48701272.0,66,323,4.893939393939394,2,7,66,0
48706649.0,287,2534,8.829268292682928,2,12,27,260
48707916.0,207,1396,6.743961352657005,3,10,162,45
48711112.0,264,2580,9.772727272727273,2,12,19,245
48727076.0,350,1757,5.02,2,8,349,1
48732595.0,22,110,5.0,3,7,22,0
48764550.0,144,706,4.902777777777778,3,8,142,2
48766126.0,11,30,2.727272727272727,1,5,11,0
48769234.0,204,1366,6.696078431372549,2,9,151,53
48776160.0,4,30,7.5,7,8,2,2
48782737.0,95,825,8.68421052631579,3,12,16,79
48795728.0,50,99,1.98,1,3,50,0
48796414.0,24,64,2.6666666666666665,2,5,24,0
48800718.0,138,436,3.1594202898550723,1,6,138,0
48802214.0,98,200,2.0408163265306123,1,6,98,0
48818197.0,248,495,1.9959677419354838,1,4,248,0
48818476.0,121,1041,8.603305785123966,2,11,17,104
48818905.0,39,116,2.9743589743589745,1,5,39,0
48821834.0,17,102,6.0,4,8,16,1
48827543.0,1,4,4.0,4,4,1,0
48837496.0,1,4,4.0,4,4,1,0
48839316.0,9,20,2.2222222222222223,1,3,9,0
48839778.0,38,264,6.947368421052632,4,9,25,13
48866696.0,52,398,7.653846153846154,3,11,21,31
48879412.0,94,387,4.117021276595745,1,6,94,0
48886133.0,90,131,1.4555555555555555,1,3,90,0
48892885.0,23,68,2.9565217391304346,1,6,23,0
48908010.0,92,198,2.152173913043478,1,4,92,0
48910179.0,8,62,7.75,7,9,4,4
48911040.0,69,339,4.913043478260869,2,7,69,0
48916167.0,231,1632,7.064935064935065,2,10,153,78
48918146.0,3,15,5.0,4,6,3,0
48926879.0,123,620,5.040650406504065,2,8,122,1
48926899.0,14,54,3.857142857142857,2,5,14,0
48927580.0,33,302,9.151515151515152,2,12,4,29
48928933.0,45,99,2.2,1,5,45,0
48930412.0,1,6,6.0,6,6,1,0
48931417.0,9,21,2.3333333333333335,1,4,9,0
48933981.0,26,250,9.615384615384615,4,12,2,24
48936177.0,88,432,4.909090909090909,2,7,88,0
48937653.0,180,1737,9.65,2,13,10,170
48947898.0,3,7,2.3333333333333335,2,3,3,0
48949263.0,140,694,4.957142857142857,2,8,139,1
48973908.0,20,28,1.4,1,3,20,0
48975403.0,144,1128,7.833333333333333,2,11,50,94
48984766.0,64,84,1.3125,1,4,64,0
48985422.0,90,870,9.666666666666666,2,12,6,84
48985886.0,12,54,4.5,2,8,11,1
49014686.0,162,1113,6.87037037037037,2,9,113,49
49026335.0,67,141,2.1044776119402986,1,4,67,0
49036370.0,1,8,8.0,8,8,0,1
49036726.0,126,239,1.8968253968253967,1,4,126,0
49053023.0,67,194,2.8955223880597014,1,5,67,0
49067339.0,143,297,2.076923076923077,1,5,143,0
49072332.0,21,107,5.095238095238095,4,6,21,0
49072861.0,32,162,5.0625,3,7,32,0
49074773.0,110,648,5.890909090909091,2,9,100,10
49074910.0,120,961,8.008333333333333,2,10,29,91
49084901.0,52,207,3.980769230769231,2,6,52,0
49085752.0,78,176,2.2564102564102564,1,4,78,0
49103093.0,9,16,1.7777777777777777,1,3,9,0
49103855.0,76,156,2.0526315789473686,1,5,76,0
49107202.0,44,81,1.8409090909090908,1,3,44,0
49107204.0,55,119,2.1636363636363636,1,5,55,0
49107205.0,31,68,2.193548387096774,1,4,31,0
49108309.0,22,49,2.227272727272727,1,4,22,0
49109435.0,173,824,4.763005780346821,2,7,173,0
49119595.0,103,203,1.970873786407767,1,5,103,0
49122290.0,59,409,6.932203389830509,4,9,40,19
49122810.0,148,1427,9.641891891891891,3,13,13,135
49124685.0,71,622,8.76056338028169,2,11,8,63
49127488.0,109,430,3.944954128440367,1,7,109,0
49128789.0,75,354,4.72,2,8,74,1
49128852.0,54,506,9.37037037037037,2,13,5,49
49130064.0,411,829,2.017031630170316,1,5,411,0
49135220.0,9,23,2.5555555555555554,1,4,9,0
49135267.0,70,192,2.742857142857143,1,5,70,0
49135372.0,152,747,4.9144736842105265,2,8,151,1
49138963.0,24,162,6.75,2,10,16,8
49139845.0,11,22,2.0,1,4,11,0
49147516.0,13,41,3.1538461538461537,2,4,13,0
49155617.0,22,70,3.1818181818181817,1,5,22,0
49157014.0,71,504,7.098591549295775,5,9,48,23
49164950.0,49,423,8.63265306122449,2,11,6,43
49170269.0,28,52,1.8571428571428572,1,4,28,0
49171732.0,309,913,2.954692556634304,1,6,309,0
49172529.0,42,400,9.523809523809524,3,12,3,39
49173577.0,2,2,1.0,1,1,2,0
49176804.0,2,4,2.0,1,3,2,0
49177673.0,68,122,1.7941176470588236,1,4,68,0
49184176.0,6,11,1.8333333333333333,1,2,6,0
49186036.0,4,7,1.75,1,2,4,0
49188736.0,52,104,2.0,1,4,52,0
49195796.0,32,43,1.34375,1,3,32,0
49202743.0,3,11,3.6666666666666665,3,4,3,0
49204459.0,26,76,2.923076923076923,1,6,26,0
49206824.0,145,608,4.1931034482758625,2,6,145,0
49216120.0,94,718,7.638297872340425,3,10,41,53
49221747.0,19,25,1.3157894736842106,1,2,19,0
49227031.0,28,58,2.0714285714285716,1,4,28,0
49227564.0,90,442,4.911111111111111,3,8,89,1
49238159.0,7,11,1.5714285714285714,1,2,7,0
49238337.0,9,14,1.5555555555555556,1,3,9,0
49241187.0,10,83,8.3,4,10,1,9
49252689.0,20,79,3.95,2,6,20,0
49252880.0,17,86,5.0588235294117645,3,7,17,0
49254397.0,87,583,6.7011494252873565,2,10,64,23
49254852.0,53,113,2.1320754716981134,1,5,53,0
49255155.0,8,39,4.875,4,6,8,0
49259000.0,13,25,1.9230769230769231,1,3,13,0
49266868.0,111,154,1.3873873873873874,1,3,111,0
49266992.0,2,2,1.0,1,1,2,0
49268870.0,12,124,10.333333333333334,9,12,0,12
49269355.0,20,31,1.55,1,4,20,0
49269362.0,25,177,7.08,3,9,15,10
49270130.0,4,5,1.25,1,2,4,0
49270357.0,174,337,1.9367816091954022,1,5,174,0
49272892.0,6,13,2.1666666666666665,1,4,6,0
49274047.0,1,2,2.0,2,2,1,0
49281130.0,424,887,2.0919811320754715,1,5,424,0
49282017.0,280,1863,6.6535714285714285,2,10,213,67
49282422.0,288,2221,7.711805555555555,2,11,112,176
49282586.0,252,1755,6.964285714285714,2,10,173,79
49283321.0,95,464,4.88421052631579,2,8,93,2
49284591.0,328,2532,7.719512195121951,2,11,127,201
49286014.0,45,323,7.177777777777778,4,10,26,19
49289094.0,51,106,2.0784313725490198,1,4,51,0
49289825.0,131,176,1.3435114503816794,1,3,131,0
49296708.0,23,155,6.739130434782608,3,9,17,6
49300557.0,264,1278,4.840909090909091,2,8,261,3
49317039.0,184,918,4.989130434782608,2,7,184,0
49335762.0,8,31,3.875,3,5,8,0
49338271.0,199,577,2.899497487437186,1,6,199,0
49345425.0,1,9,9.0,9,9,0,1
49351414.0,100,398,3.98,2,6,100,0
49352166.0,39,252,6.461538461538462,2,9,28,11
49352417.0,45,312,6.933333333333334,3,9,27,18
49352459.0,12,74,6.166666666666667,4,9,11,1
49352494.0,18,119,6.611111111111111,2,9,12,6
49352542.0,5,10,2.0,1,3,5,0
49355273.0,2,7,3.5,3,4,2,0
49357502.0,32,65,2.03125,1,4,32,0
49361669.0,94,204,2.1702127659574466,1,6,94,0
49373903.0,251,1212,4.828685258964144,2,7,251,0
49377078.0,251,2451,9.764940239043824,2,13,9,242
49377538.0,258,2506,9.713178294573643,2,13,19,239
49378695.0,13,74,5.6923076923076925,2,9,10,3
49381401.0,220,1111,5.05,2,8,219,1
49382143.0,8,14,1.75,1,2,8,0
49395853.0,6,19,3.1666666666666665,2,5,6,0
49409816.0,9,17,1.8888888888888888,1,3,9,0
49411865.0,31,148,4.774193548387097,3,6,31,0
49412306.0,84,330,3.9285714285714284,2,7,84,0
49412836.0,20,185,9.25,5,11,2,18
49423966.0,301,2906,9.654485049833887,2,13,20,281
49429994.0,135,672,4.977777777777778,2,8,134,1
49430459.0,9,19,2.111111111111111,1,4,9,0
49430674.0,264,1300,4.924242424242424,2,8,261,3
49431475.0,31,58,1.8709677419354838,1,3,31,0
49433117.0,74,507,6.851351351351352,2,10,54,20
49433257.0,181,361,1.9944751381215469,1,4,181,0
49433867.0,56,385,6.875,3,9,41,15
49434919.0,45,227,5.044444444444444,3,7,45,0
49435412.0,20,44,2.2,1,4,20,0
49435994.0,139,691,4.971223021582734,2,8,138,1
49453258.0,16,129,8.0625,6,11,5,11
49455758.0,30,209,6.966666666666667,6,9,23,7
49456845.0,41,93,2.268292682926829,1,5,41,0
49460557.0,79,377,4.772151898734177,2,7,79,0
49475369.0,127,1263,9.94488188976378,2,13,4,123
49481938.0,63,131,2.0793650793650795,1,4,63,0
49482021.0,239,2319,9.702928870292887,2,13,19,220
49483041.0,101,501,4.96039603960396,2,7,101,0
49490777.0,26,58,2.230769230769231,1,4,26,0
49492293.0,27,55,2.037037037037037,1,4,27,0
49493252.0,73,169,2.315068493150685,1,4,73,0
49493894.0,43,90,2.0930232558139537,1,4,43,0
49496063.0,4,8,2.0,1,3,4,0
49496524.0,38,78,2.0526315789473686,1,4,38,0
49497698.0,1,9,9.0,9,9,0,1
49498113.0,19,27,1.4210526315789473,1,4,19,0
49499012.0,264,1291,4.890151515151516,2,8,262,2
49509425.0,118,240,2.0338983050847457,1,5,118,0
49510436.0,84,179,2.130952380952381,1,4,84,0
49511262.0,200,1957,9.785,2,13,7,193
49511750.0,61,119,1.9508196721311475,1,4,61,0
49511751.0,66,131,1.9848484848484849,1,4,66,0
49511752.0,70,154,2.2,1,5,70,0
49511753.0,40,83,2.075,1,4,40,0
49511755.0,30,65,2.1666666666666665,1,4,30,0
49512347.0,134,1179,8.798507462686567,3,11,7,127
49512464.0,122,591,4.844262295081967,2,7,122,0
49518565.0,43,333,7.744186046511628,4,10,14,29
49530407.0,2,3,1.5,1,2,2,0
49530568.0,2,2,1.0,1,1,2,0
49530647.0,2,5,2.5,1,4,2,0
49545717.0,84,680,8.095238095238095,3,10,27,57
49556452.0,127,1216,9.5748031496063,2,12,7,120
49561407.0,99,482,4.8686868686868685,2,8,98,1
49563608.0,213,2085,9.788732394366198,2,14,8,205
49565329.0,1,2,2.0,2,2,1,0
49567438.0,11,76,6.909090909090909,6,8,9,2
49577820.0,66,456,6.909090909090909,2,10,46,20
49579028.0,75,523,6.973333333333334,3,9,53,22
49579554.0,184,1808,9.826086956521738,2,13,7,177
49582599.0,50,391,7.82,5,10,17,33
49587878.0,68,675,9.926470588235293,2,13,3,65
49601257.0,266,2583,9.710526315789474,2,13,14,252
49601392.0,37,79,2.135135135135135,1,4,37,0
49601394.0,29,56,1.9310344827586208,1,4,29,0
49603995.0,38,74,1.9473684210526316,1,4,38,0
49603996.0,43,92,2.13953488372093,1,5,43,0
49603997.0,46,92,2.0,1,5,46,0
49603998.0,41,79,1.9268292682926829,1,4,41,0
49603999.0,25,54,2.16,1,4,25,0
49604000.0,48,97,2.0208333333333335,1,3,48,0
49604001.0,28,56,2.0,1,3,28,0
49604002.0,58,114,1.9655172413793103,1,4,58,0
49604004.0,17,34,2.0,1,3,17,0
49604005.0,29,63,2.1724137931034484,1,4,29,0
49605205.0,8,12,1.5,1,2,8,0
49607979.0,236,1171,4.961864406779661,2,8,232,4
49608304.0,1,2,2.0,2,2,1,0
49609590.0,10,12,1.2,1,2,10,0
49610169.0,3,6,2.0,1,3,3,0
49610271.0,2,3,1.5,1,2,2,0
49614572.0,137,955,6.970802919708029,3,10,88,49
49621714.0,5,10,2.0,1,3,5,0
49623223.0,62,128,2.064516129032258,1,5,62,0
49623226.0,15,28,1.8666666666666667,1,4,15,0
49625141.0,36,99,2.75,1,5,36,0
49629881.0,11,25,2.272727272727273,1,3,11,0
49635126.0,75,152,2.026666666666667,1,4,75,0
49643136.0,39,77,1.9743589743589745,1,4,39,0
49643235.0,8,15,1.875,1,4,8,0
49645225.0,48,104,2.1666666666666665,1,4,48,0
49645907.0,3,6,2.0,2,2,3,0
49646056.0,13,25,1.9230769230769231,1,3,13,0
49646409.0,8,17,2.125,1,3,8,0
49646859.0,8,15,1.875,1,4,8,0
49647313.0,9,18,2.0,1,3,9,0
49665712.0,57,230,4.035087719298246,1,6,57,0
49679246.0,152,297,1.9539473684210527,1,4,152,0
49679456.0,101,201,1.99009900990099,1,4,101,0
49687097.0,2,4,2.0,1,3,2,0
49687493.0,78,166,2.128205128205128,1,4,78,0
49691113.0,9,93,10.333333333333334,9,12,0,9
49693987.0,29,58,2.0,1,4,29,0
49696244.0,6,47,7.833333333333333,6,10,2,4
49697521.0,214,1063,4.9672897196261685,2,8,213,1
49699190.0,169,529,3.1301775147928996,1,6,169,0
49699467.0,130,275,2.1153846153846154,1,4,130,0
49700018.0,193,570,2.9533678756476682,1,6,193,0
49702078.0,8,64,8.0,6,9,2,6
49703920.0,74,150,2.027027027027027,1,4,74,0
49704703.0,86,410,4.767441860465116,3,8,85,1
49718595.0,1,5,5.0,5,5,1,0
49720420.0,1,3,3.0,3,3,1,0
49721134.0,189,936,4.9523809523809526,2,8,185,4
49722558.0,212,1050,4.952830188679245,2,8,210,2
49723808.0,17,42,2.4705882352941178,1,4,17,0
49724920.0,33,84,2.5454545454545454,1,4,33,0
49726154.0,186,556,2.989247311827957,1,6,186,0
49726566.0,177,1215,6.864406779661017,2,10,124,53
49727482.0,168,510,3.0357142857142856,1,6,168,0
49727952.0,66,639,9.681818181818182,4,12,4,62
49733208.0,149,454,3.046979865771812,1,6,149,0
49744525.0,162,1548,9.555555555555555,2,13,15,147
49747414.0,101,781,7.732673267326732,2,10,41,60
49751241.0,14,29,2.0714285714285716,1,3,14,0
49753639.0,69,606,8.782608695652174,4,11,7,62
49753825.0,129,760,5.891472868217054,2,8,122,7
49761337.0,14,98,7.0,6,8,10,4
49762094.0,230,1812,7.878260869565217,2,11,78,152
49762789.0,5,9,1.8,1,2,5,0
49764023.0,1,3,3.0,3,3,1,0
49768382.0,268,2574,9.604477611940299,2,13,21,247
49769828.0,161,1534,9.527950310559007,2,12,11,150
49781367.0,23,220,9.565217391304348,4,11,1,22
49782166.0,182,893,4.906593406593407,2,8,181,1
49782326.0,194,1836,9.463917525773196,2,13,17,177
49783289.0,73,133,1.821917808219178,1,4,73,0
49788419.0,88,601,6.829545454545454,2,10,63,25
49789513.0,40,406,10.15,8,12,0,40
49789866.0,12,59,4.916666666666667,4,6,12,0
49790013.0,19,190,10.0,5,12,1,18
49790343.0,8,77,9.625,8,12,0,8
49790624.0,17,164,9.647058823529411,8,11,0,17
49807974.0,55,273,4.963636363636364,3,8,54,1
49808687.0,229,2008,8.768558951965066,2,12,28,201
49811010.0,12,50,4.166666666666667,2,7,12,0
49822311.0,1,3,3.0,3,3,1,0
49833133.0,170,834,4.905882352941177,2,8,168,2
49833677.0,2,9,4.5,4,5,2,0
49834666.0,78,383,4.910256410256411,2,8,77,1
49836364.0,49,427,8.714285714285714,2,11,9,40
49842643.0,112,1084,9.678571428571429,4,12,7,105
49844303.0,152,587,3.861842105263158,2,7,152,0
49847060.0,16,77,4.8125,3,7,16,0
49848304.0,36,68,1.8888888888888888,1,4,36,0
49851685.0,252,2438,9.674603174603174,2,13,17,235
49855628.0,8,22,2.75,1,4,8,0
49855860.0,266,1325,4.981203007518797,2,8,262,4
49857303.0,27,211,7.814814814814815,4,10,8,19
49857999.0,53,508,9.584905660377359,3,12,3,50
49866696.0,108,144,1.3333333333333333,1,3,108,0
49867863.0,170,339,1.9941176470588236,1,4,170,0
49869546.0,31,90,2.903225806451613,1,4,31,0
49870230.0,202,808,4.0,1,8,201,1
49870301.0,140,294,2.1,1,5,140,0
49876849.0,8,35,4.375,3,6,8,0
49894196.0,23,83,3.608695652173913,2,5,23,0
49894513.0,77,153,1.9870129870129871,1,4,77,0
49895015.0,40,309,7.725,6,9,15,25
49896379.0,227,2162,9.524229074889869,2,12,18,209
49898995.0,22,30,1.3636363636363635,1,3,22,0
49900100.0,340,3323,9.773529411764706,3,13,10,330
49900278.0,104,146,1.4038461538461537,1,3,104,0
49900551.0,101,128,1.2673267326732673,1,3,101,0
49900734.0,114,150,1.3157894736842106,1,3,114,0
49902659.0,61,302,4.950819672131147,2,8,59,2
49903568.0,8,57,7.125,6,9,5,3
49908446.0,12,18,1.5,1,3,12,0
49910817.0,132,1173,8.886363636363637,2,12,10,122
49914088.0,133,695,5.225563909774436,3,8,131,2
49917017.0,66,142,2.1515151515151514,1,4,66,0
49920368.0,285,1962,6.88421052631579,2,9,192,93
49922601.0,56,269,4.803571428571429,2,7,56,0
49925860.0,97,570,5.876288659793815,2,8,92,5
49926261.0,20,135,6.75,4,9,16,4
49929215.0,84,321,3.8214285714285716,2,6,84,0
49930121.0,83,164,1.9759036144578312,1,4,83,0
49937989.0,194,1868,9.628865979381443,2,13,13,181
49939100.0,4,7,1.75,1,4,4,0
49939233.0,110,331,3.0090909090909093,1,6,110,0
49941946.0,9,66,7.333333333333333,6,9,6,3
49943739.0,29,94,3.2413793103448274,1,5,29,0
49947635.0,89,355,3.9887640449438204,2,8,88,1
49948332.0,97,843,8.690721649484535,2,12,12,85
49949345.0,30,118,3.933333333333333,2,6,30,0
49953059.0,18,148,8.222222222222221,6,9,4,14
49954706.0,2,2,1.0,1,1,2,0
49955477.0,1,3,3.0,3,3,1,0
49965630.0,6,9,1.5,1,2,6,0
49967744.0,8,24,3.0,2,4,8,0
49973467.0,60,406,6.766666666666667,2,9,42,18
49977143.0,2,4,2.0,1,3,2,0
49977832.0,31,86,2.774193548387097,1,4,31,0
49980611.0,283,1394,4.925795053003534,2,8,281,2
49981079.0,173,1627,9.404624277456648,2,13,18,155
49982681.0,22,154,7.0,4,9,14,8
49982908.0,3,17,5.666666666666667,2,8,2,1
49992239.0,63,193,3.0634920634920637,1,6,63,0
49998462.0,101,489,4.841584158415841,2,7,101,0
50004688.0,2,4,2.0,1,3,2,0
50010098.0,105,307,2.9238095238095236,1,5,105,0
50013269.0,177,1534,8.666666666666666,2,13,19,158
50015676.0,105,425,4.0476190476190474,2,6,105,0
50016276.0,182,1254,6.8901098901098905,2,10,134,48
50016529.0,47,99,2.106382978723404,1,5,47,0
50016748.0,76,216,2.8421052631578947,1,6,76,0
50017424.0,75,148,1.9733333333333334,1,5,75,0
50017463.0,60,232,3.8666666666666667,1,6,60,0
50019582.0,9,22,2.4444444444444446,1,4,9,0
50023318.0,1,4,4.0,4,4,1,0
50024743.0,38,53,1.394736842105263,1,3,38,0
50025021.0,38,252,6.631578947368421,5,8,29,9
50025023.0,14,90,6.428571428571429,2,8,10,4
50025775.0,58,109,1.8793103448275863,1,5,58,0
50027497.0,78,147,1.8846153846153846,1,4,78,0
50027498.0,39,79,2.0256410256410255,1,4,39,0
50027499.0,139,286,2.0575539568345325,1,5,139,0
50037533.0,1,2,2.0,2,2,1,0
50039228.0,32,123,3.84375,2,5,32,0
50039256.0,16,107,6.6875,4,9,14,2
50040384.0,195,1907,9.77948717948718,2,12,10,185
50040480.0,61,81,1.3278688524590163,1,3,61,0
50040755.0,45,59,1.3111111111111111,1,3,45,0
50040802.0,1,12,12.0,12,12,0,1
50041406.0,2,3,1.5,1,2,2,0
50043739.0,15,41,2.7333333333333334,1,4,15,0
50047335.0,52,101,1.9423076923076923,1,4,52,0
50047402.0,116,237,2.043103448275862,1,5,116,0
50049245.0,37,173,4.675675675675675,2,6,37,0
50049716.0,32,124,3.875,2,6,32,0
50052249.0,176,380,2.159090909090909,1,4,176,0
50056511.0,5,7,1.4,1,2,5,0
50060215.0,52,150,2.8846153846153846,1,5,52,0
50069926.0,41,92,2.2439024390243905,1,4,41,0
50076413.0,5,13,2.6,2,4,5,0
50077174.0,1,1,1.0,1,1,1,0
50077189.0,9,18,2.0,1,4,9,0
50079925.0,62,421,6.790322580645161,2,9,42,20
50083576.0,77,532,6.909090909090909,4,9,53,24
50085646.0,115,461,4.008695652173913,2,7,115,0
50089055.0,5,41,8.2,7,9,1,4
50093617.0,6,46,7.666666666666667,6,9,3,3
50093914.0,81,315,3.888888888888889,2,6,81,0
50100680.0,317,1540,4.858044164037855,2,8,315,2
50100960.0,41,284,6.926829268292683,3,9,27,14
50101851.0,73,502,6.876712328767123,4,9,51,22
50103270.0,19,132,6.947368421052632,5,8,13,6
50103803.0,95,921,9.694736842105263,6,13,5,90
50107573.0,12,28,2.3333333333333335,1,4,12,0
50111257.0,6,13,2.1666666666666665,1,3,6,0
50112256.0,218,1481,6.793577981651376,2,9,157,61
50115184.0,1,10,10.0,10,10,0,1
50116918.0,81,338,4.172839506172839,2,7,81,0
50122501.0,45,237,5.266666666666667,3,7,45,0
50123026.0,3,14,4.666666666666667,4,5,3,0
50123222.0,77,153,1.9870129870129871,1,4,77,0
50123307.0,4,18,4.5,4,5,4,0
50123524.0,2,10,5.0,4,6,2,0
50124602.0,64,521,8.140625,2,11,14,50
50125762.0,329,2619,7.96048632218845,2,11,99,230
50127542.0,1,3,3.0,3,3,1,0
50127891.0,61,123,2.0163934426229506,1,4,61,0
50128345.0,180,1765,9.805555555555555,2,13,9,171
50130127.0,327,3121,9.54434250764526,2,13,23,304
50130762.0,2,7,3.5,3,4,2,0
50132001.0,50,110,2.2,1,4,50,0
50132018.0,393,1208,3.073791348600509,1,6,393,0
50132782.0,148,446,3.0135135135135136,1,6,148,0
50133966.0,71,354,4.985915492957746,2,8,70,1
50141259.0,375,2566,6.842666666666666,2,10,267,108
50141356.0,116,597,5.146551724137931,2,8,115,1
50141952.0,165,1425,8.636363636363637,2,11,24,141
50142713.0,5,12,2.4,1,4,5,0
50143073.0,23,97,4.217391304347826,2,6,23,0
50143126.0,4,11,2.75,2,3,4,0
50143252.0,38,336,8.842105263157896,2,11,4,34
50143868.0,337,2312,6.86053412462908,2,10,238,99
50145565.0,335,2320,6.925373134328358,2,10,231,104
50150899.0,56,222,3.9642857142857144,2,6,56,0
50162499.0,4,22,5.5,4,6,4,0
50164116.0,3,10,3.3333333333333335,2,5,3,0
50164298.0,1,9,9.0,9,9,0,1
50165033.0,30,131,4.366666666666666,3,6,30,0
50165668.0,87,258,2.9655172413793105,1,5,87,0
50169005.0,253,751,2.9683794466403164,1,6,253,0
50171002.0,11,23,2.090909090909091,1,3,11,0
50182126.0,19,114,6.0,2,8,17,2
50182420.0,2,7,3.5,3,4,2,0
50182932.0,15,34,2.2666666666666666,1,4,15,0
50183585.0,18,138,7.666666666666667,2,9,6,12
50185253.0,113,547,4.84070796460177,2,8,112,1
50185404.0,72,144,2.0,1,5,72,0
50187235.0,16,117,7.3125,2,9,6,10
50192063.0,23,158,6.869565217391305,5,9,16,7
50201478.0,31,65,2.096774193548387,1,4,31,0
50202478.0,160,1102,6.8875,3,10,110,50
50204157.0,1,2,2.0,2,2,1,0
50206486.0,38,86,2.263157894736842,1,4,38,0
50208226.0,104,499,4.798076923076923,2,7,104,0
50208418.0,17,51,3.0,2,4,17,0
50209792.0,121,583,4.818181818181818,2,8,120,1
50211049.0,47,443,9.425531914893616,3,12,4,43
50211579.0,96,466,4.854166666666667,2,8,95,1
50219393.0,14,24,1.7142857142857142,1,3,14,0
50229790.0,194,957,4.93298969072165,3,7,194,0
50233448.0,3,3,1.0,1,1,3,0
50233995.0,15,71,4.733333333333333,3,6,15,0
50236883.0,5,50,10.0,9,11,0,5
50242459.0,25,115,4.6,2,6,25,0
50243321.0,134,1290,9.626865671641792,2,12,9,125
50245071.0,66,328,4.96969696969697,2,7,66,0
50251412.0,49,154,3.142857142857143,1,5,49,0
50255617.0,9,15,1.6666666666666667,1,3,9,0
50255671.0,271,551,2.0332103321033212,1,5,271,0
50256370.0,200,1370,6.85,2,10,148,52
50256536.0,34,329,9.676470588235293,2,12,1,33
50256766.0,68,256,3.764705882352941,2,6,68,0
50257357.0,40,203,5.075,3,7,40,0
50261952.0,21,168,8.0,3,11,6,15
50265861.0,125,490,3.92,1,6,125,0
50267233.0,3,9,3.0,2,5,3,0
50277316.0,132,669,5.068181818181818,3,8,130,2
50278295.0,18,41,2.2777777777777777,1,3,18,0
50278310.0,17,122,7.176470588235294,5,10,10,7
50279123.0,19,57,3.0,1,4,19,0
50279829.0,12,80,6.666666666666667,5,9,10,2
50283442.0,108,220,2.037037037037037,1,5,108,0
50283444.0,120,260,2.1666666666666665,1,5,120,0
50287615.0,30,239,7.966666666666667,5,10,8,22
50287683.0,2,7,3.5,3,4,2,0
50294479.0,39,382,9.794871794871796,4,12,2,37
50295199.0,6,51,8.5,5,11,2,4
50295830.0,58,284,4.896551724137931,3,7,58,0
50296100.0,88,415,4.715909090909091,2,7,88,0
50297203.0,32,122,3.8125,2,7,32,0
50297270.0,170,367,2.1588235294117646,1,4,170,0
50301129.0,49,411,8.387755102040817,2,12,11,38
50301993.0,140,1353,9.664285714285715,2,12,13,127
50302756.0,143,306,2.13986013986014,1,5,143,0
50302758.0,14,28,2.0,1,3,14,0
50302759.0,29,60,2.0689655172413794,1,4,29,0
50302761.0,26,47,1.8076923076923077,1,4,26,0
50302762.0,41,78,1.9024390243902438,1,4,41,0
50303675.0,15,39,2.6,1,4,15,0
50307459.0,241,739,3.066390041493776,1,6,241,0
50313679.0,16,128,8.0,5,10,4,12
50317500.0,174,1187,6.82183908045977,3,9,128,46
50318860.0,27,64,2.3703703703703702,1,4,27,0
50319034.0,6,35,5.833333333333333,3,8,5,1
50321892.0,16,24,1.5,1,3,16,0
50322773.0,206,1987,9.645631067961165,2,13,14,192
50322959.0,64,129,2.015625,1,4,64,0
50322960.0,31,68,2.193548387096774,1,4,31,0
50322961.0,55,113,2.0545454545454547,1,4,55,0
50322964.0,59,126,2.135593220338983,1,5,59,0
50322965.0,63,127,2.015873015873016,1,4,63,0
50322966.0,29,69,2.3793103448275863,1,5,29,0
50322967.0,16,33,2.0625,1,5,16,0
50327397.0,7,17,2.4285714285714284,1,4,7,0
50330281.0,98,952,9.714285714285714,2,12,5,93
50330666.0,157,1506,9.59235668789809,2,13,10,147
50330723.0,14,44,3.142857142857143,1,5,14,0
50334641.0,13,44,3.3846153846153846,1,5,13,0
50335007.0,18,123,6.833333333333333,5,9,14,4
50337762.0,14,27,1.9285714285714286,1,3,14,0
50337763.0,35,75,2.142857142857143,1,4,35,0
50337764.0,36,77,2.138888888888889,1,5,36,0
50337765.0,7,20,2.857142857142857,1,4,7,0
50337766.0,28,60,2.142857142857143,1,4,28,0
50338600.0,44,296,6.7272727272727275,3,9,36,8
50342648.0,38,286,7.526315789473684,5,9,17,21
50343937.0,4,15,3.75,3,5,4,0
50352346.0,197,985,5.0,2,8,194,3
50357898.0,10,67,6.7,6,8,9,1
50363297.0,60,466,7.766666666666667,4,9,18,42
50367189.0,1,1,1.0,1,1,1,0
50367713.0,1,9,9.0,9,9,0,1
50369590.0,70,670,9.571428571428571,3,12,8,62
50375113.0,1,7,7.0,7,7,1,0
50376870.0,23,161,7.0,6,8,15,8
50383454.0,1,2,2.0,2,2,1,0
50384849.0,14,52,3.7142857142857144,2,5,14,0
50387075.0,15,30,2.0,1,3,15,0
50393424.0,34,283,8.323529411764707,2,11,7,27
50394350.0,76,646,8.5,2,11,12,64
50394596.0,15,18,1.2,1,2,15,0
50394764.0,111,552,4.972972972972973,3,7,111,0
50396541.0,43,414,9.627906976744185,3,12,2,41
50405479.0,160,1100,6.875,2,10,110,50
50406486.0,48,310,6.458333333333333,3,8,39,9
50407230.0,87,170,1.9540229885057472,1,5,87,0
50409931.0,3,9,3.0,2,4,3,0
50416035.0,24,53,2.2083333333333335,1,4,24,0
50426799.0,1,1,1.0,1,1,1,0
50427903.0,2,5,2.5,2,3,2,0
50429091.0,3,19,6.333333333333333,5,7,3,0
50429138.0,43,428,9.953488372093023,8,12,0,43
50430223.0,202,1385,6.856435643564357,2,10,144,58
50430271.0,45,273,6.066666666666666,4,8,41,4
50431096.0,1,1,1.0,1,1,1,0
50431919.0,4,10,2.5,2,3,4,0
50438223.0,205,1013,4.941463414634146,2,7,205,0
50441478.0,68,346,5.088235294117647,3,8,67,1
50444806.0,349,1728,4.951289398280802,2,8,346,3
50445789.0,349,1720,4.92836676217765,2,8,347,2
50452167.0,2,6,3.0,3,3,2,0
50453559.0,172,1192,6.930232558139535,2,10,116,56
50456378.0,155,1066,6.877419354838709,2,10,114,41
50459532.0,259,2532,9.776061776061775,2,13,15,244
50460186.0,65,451,6.938461538461539,2,10,44,21
50467116.0,138,689,4.992753623188406,2,8,137,1
50473232.0,143,297,2.076923076923077,1,5,143,0
50473511.0,4,9,2.25,1,3,4,0
50473512.0,9,58,6.444444444444445,5,8,8,1
50474441.0,2,3,1.5,1,2,2,0
50476526.0,3,25,8.333333333333334,7,9,1,2
50476722.0,52,249,4.788461538461538,2,7,52,0
50476964.0,36,348,9.666666666666666,2,12,3,33
50477093.0,161,813,5.049689440993789,2,8,160,1
50484848.0,100,978,9.78,2,12,6,94
50488273.0,2,6,3.0,2,4,2,0
50493829.0,112,1096,9.785714285714286,2,13,6,106
50499630.0,24,197,8.208333333333334,2,12,5,19
50510999.0,67,475,7.08955223880597,4,9,41,26
50517568.0,71,361,5.084507042253521,2,8,70,1
50518740.0,156,782,5.012820512820513,2,7,156,0
50518826.0,5,8,1.6,1,3,5,0
50518850.0,252,1707,6.773809523809524,2,10,182,70
50522229.0,101,231,2.287128712871287,1,4,101,0
50531537.0,11,77,7.0,6,8,7,4
50533003.0,19,182,9.578947368421053,4,11,1,18
50534685.0,80,158,1.975,1,4,80,0
50536454.0,19,132,6.947368421052632,5,9,13,6
50540002.0,127,855,6.732283464566929,2,10,91,36
50546417.0,5,14,2.8,2,3,5,0
50547832.0,15,107,7.133333333333334,6,8,10,5
50553830.0,122,237,1.9426229508196722,1,4,122,0
50558591.0,58,553,9.53448275862069,3,12,2,56
50560154.0,2,6,3.0,3,3,2,0
50561294.0,38,259,6.815789473684211,2,8,29,9
50562819.0,42,292,6.9523809523809526,2,9,31,11
50563253.0,19,134,7.052631578947368,5,9,13,6
50565776.0,279,2656,9.519713261648745,2,13,16,263
50569972.0,127,264,2.078740157480315,1,4,127,0
50570139.0,148,318,2.1486486486486487,1,5,148,0
50570334.0,124,260,2.096774193548387,1,4,124,0
50572315.0,36,348,9.666666666666666,8,12,0,36
50579791.0,225,2214,9.84,3,14,11,214
50586241.0,211,1443,6.838862559241706,2,10,151,60
50588904.0,40,345,8.625,2,11,6,34
50590474.0,26,81,3.1153846153846154,2,5,26,0
50594563.0,83,721,8.686746987951807,2,11,10,73
50597319.0,11,42,3.8181818181818183,2,6,11,0
50597429.0,83,657,7.9156626506024095,3,10,26,57
50602272.0,6,13,2.1666666666666665,1,4,6,0
50605925.0,28,55,1.9642857142857142,1,4,28,0
50607609.0,41,282,6.878048780487805,4,9,28,13
50608249.0,1,1,1.0,1,1,1,0
50608777.0,283,1367,4.830388692579505,2,7,283,0
50608871.0,50,113,2.26,1,4,50,0
50611076.0,120,838,6.983333333333333,2,10,78,42
50614830.0,5,9,1.8,1,4,5,0
50618869.0,1,8,8.0,8,8,0,1
50625124.0,201,1913,9.517412935323383,2,13,15,186
50626573.0,129,1271,9.852713178294573,2,12,6,123
50629344.0,36,70,1.9444444444444444,1,4,36,0
50630016.0,87,433,4.977011494252873,2,7,87,0
50630630.0,4,23,5.75,3,7,4,0
50630674.0,43,244,5.674418604651163,3,7,43,0
50630719.0,16,93,5.8125,3,8,15,1
50630756.0,41,54,1.3170731707317074,1,3,41,0
50630776.0,4,6,1.5,1,2,4,0
50632348.0,1,3,3.0,3,3,1,0
50634354.0,7,17,2.4285714285714284,1,4,7,0
50638571.0,55,529,9.618181818181819,3,13,3,52
50648604.0,100,200,2.0,1,5,100,0
50653098.0,5,14,2.8,1,4,5,0
50655505.0,4,11,2.75,1,4,4,0
50657160.0,4,19,4.75,4,6,4,0
50664229.0,84,170,2.0238095238095237,1,5,84,0
50665199.0,24,89,3.7083333333333335,1,6,24,0
50665718.0,31,163,5.258064516129032,4,7,31,0
50667683.0,65,326,5.015384615384615,3,7,65,0
50667725.0,21,201,9.571428571428571,4,12,1,20
50668366.0,104,520,5.0,2,7,104,0
50670678.0,137,1291,9.423357664233576,2,12,11,126
50671859.0,62,534,8.612903225806452,3,11,8,54
50673220.0,28,217,7.75,2,10,9,19
50673761.0,13,20,1.5384615384615385,1,3,13,0
50674962.0,94,906,9.638297872340425,3,13,6,88
50677445.0,1,3,3.0,3,3,1,0
50679397.0,6,20,3.3333333333333335,2,5,6,0
50680506.0,20,152,7.6,5,10,8,12
50686284.0,159,791,4.9748427672955975,2,7,159,0
50686800.0,169,684,4.047337278106509,1,7,169,0
50688196.0,72,151,2.0972222222222223,1,4,72,0
50688928.0,116,251,2.163793103448276,1,5,116,0
50702123.0,6,41,6.833333333333333,6,8,4,2
50721932.0,120,171,1.425,1,4,120,0
50722176.0,44,423,9.613636363636363,3,12,4,40
50724146.0,27,76,2.814814814814815,1,5,27,0
50729508.0,17,79,4.647058823529412,2,7,17,0
50736753.0,146,1289,8.82876712328767,2,11,16,130
50737628.0,69,140,2.028985507246377,1,4,69,0
50749429.0,29,233,8.03448275862069,3,10,7,22
50752990.0,31,128,4.129032258064516,3,7,31,0
50760714.0,2,3,1.5,1,2,2,0
50762376.0,234,1586,6.777777777777778,2,9,164,70
50762923.0,42,394,9.380952380952381,2,12,4,38
50765017.0,4,12,3.0,2,4,4,0
50766162.0,109,223,2.0458715596330275,1,4,109,0
50767137.0,23,176,7.6521739130434785,6,10,9,14
50767528.0,103,513,4.980582524271845,2,8,101,2
50767570.0,105,208,1.980952380952381,1,4,105,0
50768594.0,77,153,1.9870129870129871,1,5,77,0
50768638.0,2,9,4.5,4,5,2,0
50769396.0,40,79,1.975,1,3,40,0
50770678.0,24,237,9.875,8,12,0,24
50771700.0,27,245,9.074074074074074,6,11,1,26
50772166.0,13,23,1.7692307692307692,1,4,13,0
50773801.0,2,10,5.0,5,5,2,0
50775788.0,36,111,3.0833333333333335,1,5,36,0
50778023.0,220,1931,8.777272727272727,2,11,28,192
50783086.0,82,806,9.829268292682928,2,13,4,78
50784395.0,87,175,2.0114942528735633,1,4,87,0
50788807.0,29,60,2.0689655172413794,1,4,29,0
50790108.0,27,135,5.0,2,7,27,0
50802052.0,23,178,7.739130434782608,6,10,9,14
50802696.0,139,294,2.115107913669065,1,5,139,0
50811470.0,324,3128,9.654320987654321,3,13,18,306
50812562.0,39,304,7.794871794871795,4,11,14,25
50817542.0,3,10,3.3333333333333335,2,5,3,0
50819712.0,13,90,6.923076923076923,6,8,12,1
50823858.0,84,179,2.130952380952381,1,4,84,0
50830570.0,62,595,9.596774193548388,2,13,4,58
50836676.0,23,164,7.130434782608695,3,9,12,11
50837784.0,3,6,2.0,1,3,3,0
50839134.0,125,502,4.016,1,7,125,0
50840405.0,3,4,1.3333333333333333,1,2,3,0
50844206.0,2,6,3.0,3,3,2,0
50844491.0,5,13,2.6,2,3,5,0
50847843.0,102,518,5.078431372549019,3,7,102,0
50848200.0,8,56,7.0,6,8,5,3
50862505.0,3,6,2.0,2,2,3,0
50862705.0,1,3,3.0,3,3,1,0
50867462.0,133,654,4.917293233082707,2,8,132,1
50870387.0,185,562,3.037837837837838,1,5,185,0
50870399.0,57,384,6.7368421052631575,3,10,46,11
50872371.0,114,1102,9.666666666666666,2,12,6,108
50873864.0,22,103,4.681818181818182,2,6,22,0
50875035.0,107,834,7.794392523364486,2,12,40,67
50875794.0,37,115,3.108108108108108,1,4,37,0
50880528.0,84,596,7.095238095238095,4,9,54,30
50882395.0,57,279,4.894736842105263,2,6,57,0
50885011.0,4,12,3.0,2,4,4,0
50885132.0,1,2,2.0,2,2,1,0
50885165.0,1,7,7.0,7,7,1,0
50885252.0,6,38,6.333333333333333,4,8,4,2
50885363.0,1,9,9.0,9,9,0,1
50885429.0,1,3,3.0,3,3,1,0
50885482.0,1,2,2.0,2,2,1,0
50885536.0,2,5,2.5,2,3,2,0
50887651.0,2,3,1.5,1,2,2,0
50894773.0,6,46,7.666666666666667,6,9,2,4
50895594.0,36,319,8.86111111111111,7,11,5,31
50905997.0,96,826,8.604166666666666,2,12,11,85
50909091.0,38,287,7.552631578947368,3,9,14,24
50909290.0,144,301,2.0902777777777777,1,5,144,0
50910954.0,78,590,7.564102564102564,2,10,33,45
50912706.0,335,3219,9.608955223880598,2,13,21,314
50925490.0,38,329,8.657894736842104,6,11,6,32
50926656.0,61,301,4.934426229508197,2,8,60,1
50927424.0,3,29,9.666666666666666,9,10,0,3
50937756.0,194,408,2.1030927835051547,1,5,194,0
50944974.0,30,86,2.8666666666666667,1,5,30,0
50946039.0,164,971,5.920731707317073,2,8,155,9
50950167.0,12,32,2.6666666666666665,1,4,12,0
50950298.0,108,425,3.935185185185185,2,7,108,0
50951224.0,18,35,1.9444444444444444,1,4,18,0
50956940.0,234,706,3.017094017094017,1,6,234,0
50964479.0,72,425,5.902777777777778,2,8,67,5
50964566.0,20,121,6.05,4,7,20,0
50966590.0,42,205,4.880952380952381,3,7,42,0
50970473.0,26,181,6.961538461538462,5,9,18,8
50972386.0,117,1127,9.632478632478632,2,13,8,109
50972996.0,16,104,6.5,5,10,14,2
50975891.0,26,59,2.269230769230769,1,4,26,0
50976215.0,44,278,6.318181818181818,2,8,39,5
50976501.0,32,72,2.25,1,4,32,0
50978207.0,3,27,9.0,8,10,0,3
50978347.0,4,19,4.75,4,6,4,0
50978653.0,2,18,9.0,8,10,0,2
50983812.0,140,1348,9.628571428571428,3,12,11,129
50984915.0,52,359,6.903846153846154,3,9,36,16
50985153.0,28,58,2.0714285714285716,1,4,28,0
50985986.0,38,356,9.368421052631579,4,14,4,34
50986353.0,197,1867,9.47715736040609,2,12,16,181
50987032.0,10,81,8.1,7,10,3,7
50988194.0,16,101,6.3125,2,8,12,4
50991422.0,125,369,2.952,1,5,125,0
50992757.0,47,235,5.0,3,8,46,1
50995253.0,136,295,2.1691176470588234,1,5,136,0
50995600.0,134,312,2.328358208955224,1,5,134,0
50995991.0,124,265,2.1370967741935485,1,4,124,0
50996305.0,19,63,3.3157894736842106,2,5,19,0
50997018.0,127,263,2.0708661417322833,1,5,127,0
51006715.0,139,683,4.913669064748201,2,8,138,1
51006726.0,4,10,2.5,1,4,4,0
51008115.0,8,36,4.5,4,5,8,0
51008232.0,6,24,4.0,3,5,6,0
51008640.0,104,225,2.1634615384615383,1,4,104,0
51010342.0,19,39,2.0526315789473686,1,3,19,0
51013140.0,125,492,3.936,1,6,125,0
51014930.0,70,671,9.585714285714285,2,11,3,67
51029366.0,149,208,1.395973154362416,1,3,149,0
51031458.0,4,11,2.75,2,3,4,0
51033915.0,229,465,2.03056768558952,1,5,229,0
51035242.0,2,10,5.0,5,5,2,0
51057469.0,175,1322,7.554285714285714,2,10,69,106
51059639.0,108,522,4.833333333333333,3,7,108,0
51059859.0,29,145,5.0,3,6,29,0
51060205.0,5,7,1.4,1,2,5,0
51061279.0,119,246,2.0672268907563027,1,5,119,0
51062188.0,102,217,2.127450980392157,1,5,102,0
51062639.0,82,167,2.0365853658536586,1,4,82,0
51064352.0,46,447,9.717391304347826,4,12,4,42
51065691.0,80,310,3.875,2,6,80,0
51068551.0,6,18,3.0,3,3,6,0
51076193.0,3,25,8.333333333333334,8,9,0,3
51079860.0,213,438,2.056338028169014,1,5,213,0
51084082.0,11,79,7.181818181818182,5,8,7,4
51084342.0,25,56,2.24,1,4,25,0
51099120.0,46,443,9.630434782608695,2,12,4,42
51099544.0,40,71,1.775,1,4,40,0
51105593.0,199,1924,9.668341708542714,2,13,14,185
51108076.0,16,53,3.3125,2,4,16,0
51122059.0,93,299,3.21505376344086,1,6,93,0
51133779.0,122,1212,9.934426229508198,3,12,3,119
51134366.0,95,935,9.842105263157896,2,13,6,89
51134857.0,2,2,1.0,1,1,2,0
51139749.0,105,514,4.895238095238096,2,7,105,0
51142091.0,26,179,6.884615384615385,4,9,18,8
51147470.0,47,135,2.872340425531915,1,5,47,0
51156404.0,50,197,3.94,2,7,50,0
51161504.0,29,87,3.0,1,6,29,0
51163839.0,11,115,10.454545454545455,9,12,0,11
51172385.0,20,59,2.95,1,5,20,0
51173087.0,56,116,2.0714285714285716,1,4,56,0
51180562.0,149,1438,9.651006711409396,2,14,10,139
51181322.0,53,250,4.716981132075472,2,8,52,1
51181369.0,52,515,9.903846153846153,5,12,2,50
51182871.0,20,40,2.0,1,4,20,0
51184278.0,60,121,2.0166666666666666,1,4,60,0
51186204.0,1,1,1.0,1,1,1,0
51190011.0,50,106,2.12,1,4,50,0
51190624.0,7,22,3.142857142857143,2,5,7,0
51199566.0,75,381,5.08,3,8,72,3
51200916.0,4,19,4.75,4,6,4,0
51204527.0,46,428,9.304347826086957,2,13,3,43
51204664.0,31,300,9.67741935483871,8,12,0,31
51204846.0,8,18,2.25,1,4,8,0
51205342.0,11,75,6.818181818181818,5,8,8,3
51209161.0,20,102,5.1,3,7,20,0
51209977.0,1,1,1.0,1,1,1,0
51220671.0,29,58,2.0,1,4,29,0
51221416.0,96,650,6.770833333333333,2,9,70,26
51223314.0,1,2,2.0,2,2,1,0
51223368.0,1,1,1.0,1,1,1,0
51224724.0,10,17,1.7,1,4,10,0
51224981.0,59,407,6.898305084745763,4,9,40,19
51239176.0,13,132,10.153846153846153,9,12,0,13
51239570.0,1,2,2.0,2,2,1,0
51256247.0,65,338,5.2,2,7,65,0
51256457.0,158,1084,6.860759493670886,2,10,114,44
51256503.0,121,1152,9.520661157024794,2,12,9,112
51256509.0,6,12,2.0,1,4,6,0
51256739.0,102,960,9.411764705882353,2,12,10,92
51256823.0,3,9,3.0,1,4,3,0
51257465.0,7,16,2.2857142857142856,1,3,7,0
51258073.0,9,86,9.555555555555555,8,11,0,9
51259702.0,1,3,3.0,3,3,1,0
51268208.0,67,329,4.91044776119403,2,8,66,1
51273089.0,30,59,1.9666666666666666,1,3,30,0
51274060.0,157,757,4.821656050955414,2,8,155,2
51275852.0,56,82,1.4642857142857142,1,3,56,0
51276012.0,27,125,4.62962962962963,2,7,27,0
51276303.0,96,189,1.96875,1,6,96,0
51277464.0,8,20,2.5,1,4,8,0
51277483.0,12,28,2.3333333333333335,1,4,12,0
51277507.0,10,25,2.5,1,4,10,0
51278031.0,21,143,6.809523809523809,3,10,13,8
51278061.0,12,84,7.0,4,8,7,5
51278849.0,45,237,5.266666666666667,3,7,45,0
51279194.0,22,71,3.227272727272727,1,5,22,0
51279239.0,63,124,1.9682539682539681,1,4,63,0
51279985.0,319,659,2.0658307210031346,1,5,319,0
51282810.0,1,8,8.0,8,8,0,1
51286027.0,20,23,1.15,1,2,20,0
51286291.0,33,45,1.3636363636363635,1,3,33,0
51287420.0,229,2017,8.807860262008735,2,12,27,202
51292053.0,19,29,1.5263157894736843,1,4,19,0
51293119.0,185,401,2.1675675675675676,1,5,185,0
51293909.0,33,233,7.0606060606060606,5,9,23,10
51293911.0,16,107,6.6875,3,9,12,4
51294541.0,275,1914,6.96,2,10,187,88
51294651.0,89,773,8.685393258426966,2,12,10,79
51295912.0,1,6,6.0,6,6,1,0
51298074.0,131,494,3.7709923664122136,1,6,131,0
51299107.0,152,1029,6.769736842105263,2,10,115,37
51300335.0,84,337,4.011904761904762,2,7,84,0
51300416.0,149,1298,8.711409395973154,3,11,22,127
51300859.0,159,626,3.9371069182389937,2,7,159,0
51304185.0,5,11,2.2,1,3,5,0
51304537.0,20,44,2.2,1,5,20,0
51306501.0,177,242,1.3672316384180792,1,3,177,0
51315093.0,76,236,3.1052631578947367,1,6,76,0
51315323.0,163,338,2.0736196319018405,1,4,163,0
51315804.0,121,256,2.115702479338843,1,5,121,0
51319104.0,21,150,7.142857142857143,5,9,11,10
51320230.0,116,1146,9.879310344827585,2,13,5,111
51321294.0,4,27,6.75,6,7,4,0
51321684.0,19,123,6.473684210526316,3,9,12,7
51322207.0,32,65,2.03125,1,4,32,0
51322781.0,41,282,6.878048780487805,2,10,31,10
51330867.0,150,578,3.8533333333333335,2,6,150,0
51334635.0,61,416,6.819672131147541,2,9,41,20
51335670.0,36,349,9.694444444444445,7,12,1,35
51335686.0,5,26,5.2,4,6,5,0
51335875.0,22,169,7.681818181818182,5,9,8,14
51336317.0,14,97,6.928571428571429,3,9,9,5
51336810.0,265,2267,8.554716981132076,2,12,40,225
51336967.0,23,147,6.391304347826087,2,9,17,6
51337270.0,20,127,6.35,2,9,18,2
51337777.0,42,316,7.523809523809524,2,11,20,22
51337894.0,18,127,7.055555555555555,5,8,12,6
51338023.0,4,28,7.0,6,8,3,1
51338258.0,8,54,6.75,5,8,5,3
51338616.0,31,235,7.580645161290323,5,11,16,15
51338969.0,6,43,7.166666666666667,6,9,4,2
51340233.0,12,89,7.416666666666667,4,10,5,7
51340501.0,14,109,7.785714285714286,5,10,6,8
51340684.0,1,3,3.0,3,3,1,0
51340871.0,11,77,7.0,2,9,5,6
51341013.0,12,78,6.5,3,10,9,3
51341088.0,10,84,8.4,7,10,1,9
51341256.0,89,187,2.101123595505618,1,6,89,0
51341771.0,14,46,3.2857142857142856,1,5,14,0
51342144.0,4,23,5.75,5,6,4,0
51342328.0,13,41,3.1538461538461537,2,4,13,0
51342927.0,90,269,2.988888888888889,1,5,90,0
51343275.0,97,374,3.8556701030927836,2,6,97,0
51344413.0,80,330,4.125,2,6,80,0
51354851.0,62,287,4.629032258064516,2,6,62,0
51357289.0,43,127,2.953488372093023,1,6,43,0
51357613.0,5,24,4.8,4,5,5,0
51359543.0,223,1713,7.681614349775785,2,10,81,142
51360279.0,47,89,1.8936170212765957,1,4,47,0
51360874.0,196,1320,6.73469387755102,2,10,144,52
51362613.0,85,682,8.023529411764706,3,10,18,67
51362701.0,82,248,3.024390243902439,1,5,82,0
51363201.0,72,145,2.013888888888889,1,5,72,0
51364296.0,160,1564,9.775,2,13,7,153
51368390.0,11,84,7.636363636363637,3,9,3,8
51369024.0,26,182,7.0,4,9,16,10
51380408.0,235,2228,9.480851063829787,2,12,19,216
51395250.0,6,7,1.1666666666666667,1,2,6,0
51396793.0,12,26,2.1666666666666665,1,4,12,0
51397067.0,25,224,8.96,4,11,4,21
51406711.0,36,319,8.86111111111111,2,11,3,33
51407002.0,4,22,5.5,4,7,4,0
51414308.0,209,1219,5.832535885167464,2,9,203,6
51416469.0,27,130,4.814814814814815,2,7,27,0
51416888.0,18,21,1.1666666666666667,1,2,18,0
51418098.0,6,31,5.166666666666667,4,7,6,0
51418354.0,3,6,2.0,1,3,3,0
51418368.0,10,20,2.0,1,3,10,0
51418906.0,22,52,2.3636363636363638,1,4,22,0
51419522.0,16,35,2.1875,1,4,16,0
51421032.0,69,331,4.797101449275362,2,7,69,0
51421761.0,12,39,3.25,1,4,12,0
51423665.0,91,887,9.747252747252746,3,13,5,86
51425199.0,130,1304,10.03076923076923,3,13,5,125
51426172.0,6,8,1.3333333333333333,1,2,6,0
51426249.0,164,342,2.0853658536585367,1,5,164,0
51426701.0,4,6,1.5,1,3,4,0
51427334.0,19,43,2.263157894736842,1,4,19,0
51427636.0,8,18,2.25,1,4,8,0
51428145.0,1,1,1.0,1,1,1,0
51437004.0,142,697,4.908450704225352,2,8,141,1
51437166.0,83,411,4.951807228915663,2,9,82,1
51437619.0,3,3,1.0,1,1,3,0
51437625.0,32,121,3.78125,2,7,32,0
51441093.0,176,860,4.886363636363637,2,8,175,1
51442337.0,220,1504,6.836363636363636,2,10,165,55
51442722.0,160,1103,6.89375,2,10,108,52
51444253.0,43,295,6.8604651162790695,2,9,28,15
51445076.0,20,47,2.35,1,4,20,0
51445201.0,175,244,1.3942857142857144,1,3,175,0
51445216.0,17,112,6.588235294117647,4,9,13,4
51447150.0,186,924,4.967741935483871,2,8,185,1
51448847.0,7,8,1.1428571428571428,1,2,7,0
51457411.0,54,422,7.814814814814815,3,10,17,37
51459687.0,9,25,2.7777777777777777,2,4,9,0
51467866.0,6,58,9.666666666666666,5,12,1,5
51476305.0,3,5,1.6666666666666667,1,3,3,0
51478155.0,117,334,2.8547008547008548,1,5,117,0
51479267.0,206,623,3.0242718446601944,1,6,206,0
51480397.0,12,127,10.583333333333334,9,12,0,12
51480471.0,212,459,2.1650943396226414,1,5,212,0
51486904.0,46,456,9.91304347826087,3,12,1,45
51488054.0,40,278,6.95,2,9,27,13
51496207.0,109,539,4.944954128440367,2,8,108,1
51499128.0,91,447,4.912087912087912,1,7,91,0
51500255.0,69,337,4.884057971014493,2,8,67,2
51500891.0,4,15,3.75,2,5,4,0
51503631.0,7,14,2.0,1,3,7,0
51514213.0,136,930,6.838235294117647,3,9,97,39
51516808.0,91,260,2.857142857142857,1,5,91,0
51517474.0,46,94,2.0434782608695654,1,5,46,0
51518437.0,142,295,2.0774647887323945,1,5,142,0
51533380.0,159,327,2.056603773584906,1,5,159,0
51535184.0,71,675,9.507042253521126,2,12,4,67
51537911.0,185,937,5.064864864864865,3,8,183,2
51538702.0,62,133,2.1451612903225805,1,4,62,0
51545434.0,116,578,4.982758620689655,3,7,116,0
51547702.0,51,246,4.823529411764706,2,7,51,0
51548125.0,135,667,4.940740740740741,2,8,134,1
51548542.0,54,119,2.2037037037037037,1,4,54,0
51549352.0,144,694,4.819444444444445,2,8,143,1
51554244.0,21,104,4.9523809523809526,4,7,21,0
51554823.0,21,33,1.5714285714285714,1,3,21,0
51555472.0,62,128,2.064516129032258,1,4,62,0
51556569.0,135,648,4.8,2,7,135,0
51558455.0,58,287,4.948275862068965,3,8,56,2
51558636.0,1072,5296,4.940298507462686,2,8,1069,3
51558807.0,144,1399,9.715277777777779,2,13,6,138
51566100.0,121,1153,9.52892561983471,2,13,7,114
51569526.0,75,729,9.72,6,12,3,72
51569799.0,65,125,1.9230769230769231,1,4,65,0
51570169.0,71,210,2.9577464788732395,1,5,71,0
51570228.0,79,172,2.1772151898734178,1,4,79,0
51570309.0,59,171,2.8983050847457625,1,5,59,0
51570786.0,6,9,1.5,1,4,6,0
51570964.0,16,18,1.125,1,3,16,0
51571072.0,51,111,2.176470588235294,1,4,51,0
51571111.0,145,720,4.9655172413793105,2,7,145,0
51572042.0,48,101,2.1041666666666665,1,4,48,0
51572195.0,219,648,2.958904109589041,1,5,219,0
51572449.0,74,145,1.9594594594594594,1,4,74,0
51572584.0,98,308,3.142857142857143,1,5,98,0
51572872.0,89,190,2.134831460674157,1,5,89,0
51572947.0,74,216,2.918918918918919,1,5,74,0
51572983.0,83,177,2.1325301204819276,1,4,83,0
51573089.0,51,157,3.0784313725490198,1,5,51,0
51573165.0,57,132,2.3157894736842106,1,4,57,0
51573207.0,40,121,3.025,1,5,40,0
51573244.0,88,266,3.022727272727273,1,6,88,0
51573298.0,49,92,1.8775510204081634,1,4,49,0
51576637.0,37,347,9.378378378378379,2,12,4,33
51577214.0,96,669,6.96875,2,9,66,30
51589837.0,59,563,9.542372881355933,3,12,5,54
51589862.0,43,83,1.930232558139535,1,5,43,0
51591104.0,67,124,1.8507462686567164,1,4,67,0
51592583.0,61,126,2.0655737704918034,1,4,61,0
51594825.0,62,135,2.1774193548387095,1,5,62,0
51595345.0,59,120,2.0338983050847457,1,5,59,0
51599794.0,5,11,2.2,2,3,5,0
51609768.0,36,172,4.777777777777778,3,7,36,0
51611241.0,5,41,8.2,7,9,1,4
51612012.0,209,429,2.0526315789473686,1,4,209,0
51612329.0,67,269,4.014925373134329,2,6,67,0
51612846.0,32,106,3.3125,2,5,32,0
51615125.0,63,190,3.015873015873016,1,5,63,0
51628007.0,1,4,4.0,4,4,1,0
51630671.0,1,3,3.0,3,3,1,0
51633768.0,296,2008,6.783783783783784,2,10,228,68
51633989.0,39,193,4.948717948717949,3,7,39,0
51634109.0,1,2,2.0,2,2,1,0
51637434.0,170,1184,6.964705882352941,2,9,112,58
51647382.0,244,348,1.4262295081967213,1,4,244,0
51648340.0,32,78,2.4375,1,4,32,0
51650229.0,100,388,3.88,2,6,100,0
51654185.0,172,690,4.011627906976744,1,7,172,0
51665447.0,56,572,10.214285714285714,4,14,2,54
51676205.0,2,7,3.5,3,4,2,0
51676835.0,5,13,2.6,2,4,5,0
51677963.0,42,208,4.9523809523809526,3,8,40,2
51679964.0,5,26,5.2,4,6,5,0
51684162.0,81,229,2.8271604938271606,1,6,81,0
51684764.0,3,5,1.6666666666666667,1,2,3,0
51691326.0,78,177,2.269230769230769,1,4,78,0
51696957.0,171,1310,7.6608187134502925,3,10,73,98
51700264.0,127,365,2.874015748031496,1,6,127,0
51701245.0,17,49,2.8823529411764706,1,5,17,0
51702554.0,97,387,3.9896907216494846,2,6,97,0
51702569.0,75,220,2.933333333333333,1,5,75,0
51708167.0,4,14,3.5,2,5,4,0
51711533.0,89,618,6.943820224719101,3,9,62,27
51713784.0,76,224,2.9473684210526314,1,6,76,0
51723737.0,1,4,4.0,4,4,1,0
51724692.0,1,2,2.0,2,2,1,0
51724813.0,1,2,2.0,2,2,1,0
51732294.0,95,194,2.042105263157895,1,4,95,0
51739669.0,38,113,2.973684210526316,1,5,38,0
51740206.0,1,5,5.0,5,5,1,0
51740495.0,1,3,3.0,3,3,1,0
51740727.0,7,14,2.0,1,4,7,0
51740771.0,104,691,6.644230769230769,2,10,79,25
51741291.0,118,239,2.0254237288135593,1,5,118,0
51741861.0,101,707,7.0,2,9,64,37
51742237.0,137,952,6.9489051094890515,2,10,93,44
51742777.0,135,282,2.088888888888889,1,4,135,0
51745261.0,16,144,9.0,7,12,2,14
51752669.0,43,178,4.1395348837209305,2,6,43,0
51756904.0,13,16,1.2307692307692308,1,3,13,0
51757786.0,188,1285,6.835106382978723,2,10,141,47
51758714.0,115,238,2.0695652173913044,1,4,115,0
51759127.0,203,1409,6.940886699507389,2,9,139,64
51759520.0,115,805,7.0,2,10,80,35
51761212.0,167,815,4.880239520958084,2,7,167,0
51762909.0,130,276,2.123076923076923,1,5,130,0
51765403.0,11,32,2.909090909090909,1,5,11,0
51781998.0,48,476,9.916666666666666,6,12,3,45
51811411.0,1,3,3.0,3,3,1,0
51812859.0,35,71,2.0285714285714285,1,4,35,0
51813157.0,2,5,2.5,1,4,2,0
51816512.0,42,85,2.0238095238095237,1,4,42,0
51817414.0,276,1376,4.9855072463768115,2,8,275,1
51819619.0,44,429,9.75,5,12,3,41
51832930.0,10,14,1.4,1,3,10,0
51834121.0,2,7,3.5,3,4,2,0
51836498.0,27,37,1.3703703703703705,1,3,27,0
51837446.0,1,3,3.0,3,3,1,0
51839436.0,15,46,3.066666666666667,2,4,15,0
51840087.0,7,13,1.8571428571428572,1,3,7,0
51842476.0,117,480,4.102564102564102,2,7,117,0
51846616.0,5,28,5.6,4,7,5,0
51852747.0,1,3,3.0,3,3,1,0
51853157.0,221,2158,9.764705882352942,3,13,11,210
51855748.0,157,1504,9.579617834394904,2,12,10,147
51861664.0,78,221,2.8333333333333335,1,6,78,0
51862753.0,1,1,1.0,1,1,1,0
51903639.0,321,1615,5.031152647975078,2,9,319,2
51906548.0,21,144,6.857142857142857,2,9,12,9
51914554.0,52,358,6.884615384615385,3,9,34,18
51915675.0,19,118,6.2105263157894735,3,8,15,4
51920406.0,119,1028,8.638655462184873,2,12,15,104
51921541.0,99,881,8.8989898989899,3,11,8,91
51949631.0,18,131,7.277777777777778,4,10,12,6
51949754.0,41,290,7.073170731707317,3,10,26,15
51949824.0,33,222,6.7272727272727275,4,9,24,9
51949943.0,19,127,6.684210526315789,3,10,14,5
51950057.0,21,153,7.285714285714286,6,9,12,9
51953197.0,146,1009,6.910958904109589,2,9,109,37
51953728.0,141,292,2.0709219858156027,1,5,141,0
51956459.0,3,8,2.6666666666666665,2,4,3,0
51958488.0,114,324,2.8421052631578947,1,5,114,0
51958677.0,133,1290,9.699248120300751,3,13,7,126
51968208.0,78,381,4.884615384615385,3,8,77,1
51970544.0,15,117,7.8,3,10,4,11
51974096.0,116,573,4.939655172413793,2,7,116,0
51974764.0,10,68,6.8,6,8,7,3
51995681.0,119,246,2.0672268907563027,1,4,119,0
51995707.0,1,2,2.0,2,2,1,0
51996096.0,2,7,3.5,3,4,2,0
52008615.0,22,213,9.681818181818182,8,11,0,22
52017808.0,63,481,7.634920634920635,2,10,22,41
52020653.0,209,420,2.0095693779904304,1,4,209,0
52025881.0,222,1062,4.783783783783784,2,7,222,0
52033106.0,234,454,1.9401709401709402,1,5,234,0
52047052.0,11,70,6.363636363636363,5,8,9,2
52048566.0,10,70,7.0,5,9,6,4
52055711.0,40,147,3.675,1,6,40,0
52063667.0,49,343,7.0,3,10,34,15
52063929.0,114,786,6.894736842105263,4,9,86,28
52064011.0,108,227,2.1018518518518516,1,5,108,0
52066098.0,97,395,4.072164948453608,2,6,97,0
52070851.0,15,97,6.466666666666667,4,8,12,3
52074290.0,93,527,5.666666666666667,3,8,90,3
52078607.0,20,65,3.25,1,4,20,0
52078929.0,2,6,3.0,2,4,2,0
52081162.0,77,590,7.662337662337662,2,10,30,47
52087155.0,92,896,9.73913043478261,2,13,5,87
52089835.0,39,59,1.5128205128205128,1,4,39,0
52098624.0,1,7,7.0,7,7,1,0
52098924.0,3,5,1.6666666666666667,1,3,3,0
52099237.0,27,58,2.1481481481481484,1,4,27,0
52099647.0,3,5,1.6666666666666667,1,3,3,0
52100526.0,38,232,6.105263157894737,3,8,36,2
52104425.0,21,59,2.8095238095238093,1,4,21,0
52110493.0,56,103,1.8392857142857142,1,4,56,0
52111726.0,4,11,2.75,1,5,4,0
52115640.0,3,26,8.666666666666666,8,9,0,3
52116295.0,210,1428,6.8,3,10,151,59
52119635.0,19,41,2.1578947368421053,1,5,19,0
52120292.0,12,115,9.583333333333334,3,12,2,10
52120497.0,15,37,2.466666666666667,1,4,15,0
52121131.0,34,242,7.117647058823529,3,9,19,15
52121204.0,329,999,3.0364741641337387,1,6,329,0
52122026.0,138,405,2.9347826086956523,1,5,138,0
52124697.0,46,322,7.0,5,9,31,15
52137330.0,6,11,1.8333333333333333,1,3,6,0
52138329.0,16,125,7.8125,7,9,8,8
52139804.0,20,173,8.65,2,11,3,17
52140331.0,37,294,7.945945945945946,4,10,10,27
52140584.0,51,474,9.294117647058824,2,12,4,47
52144308.0,157,1065,6.7834394904458595,2,9,110,47
52144370.0,5,13,2.6,2,3,5,0
52149334.0,142,1394,9.816901408450704,3,13,7,135
52149730.0,12,66,5.5,4,7,12,0
52158476.0,158,647,4.094936708860759,2,7,158,0
52160220.0,75,372,4.96,2,8,73,2
52160374.0,172,856,4.976744186046512,2,8,171,1
52160394.0,144,724,5.027777777777778,2,8,142,2
52161410.0,90,444,4.933333333333334,2,8,89,1
52161424.0,34,159,4.676470588235294,3,6,34,0
52166119.0,2,3,1.5,1,2,2,0
52178689.0,261,1286,4.9272030651340994,2,8,258,3
52179578.0,13,38,2.923076923076923,1,5,13,0
52180104.0,107,216,2.0186915887850465,1,5,107,0
52180855.0,26,175,6.730769230769231,5,10,19,7
52181083.0,3,28,9.333333333333334,9,10,0,3
52183781.0,16,22,1.375,1,3,16,0
52188992.0,10,20,2.0,1,4,10,0
52191294.0,60,408,6.8,5,9,44,16
52202879.0,110,440,4.0,2,7,110,0
52211216.0,114,782,6.859649122807017,2,9,82,32
52213338.0,3,6,2.0,2,2,3,0
52216561.0,72,624,8.666666666666666,3,11,7,65
52219491.0,127,1229,9.67716535433071,2,12,13,114
52219520.0,255,2444,9.584313725490196,2,13,16,239
52220236.0,58,392,6.758620689655173,4,9,44,14
52221522.0,108,205,1.8981481481481481,1,5,108,0
52221901.0,140,974,6.957142857142857,4,10,104,36
52222181.0,151,1317,8.721854304635762,2,11,21,130
52230971.0,82,409,4.987804878048781,2,8,81,1
52231481.0,4,13,3.25,3,4,4,0
52233837.0,117,240,2.051282051282051,1,5,117,0
52237012.0,26,101,3.8846153846153846,2,6,26,0
52244991.0,1,9,9.0,9,9,0,1
52250229.0,25,47,1.88,1,3,25,0
52250230.0,14,34,2.4285714285714284,1,4,14,0
52250233.0,56,117,2.0892857142857144,1,4,56,0
52250250.0,49,110,2.2448979591836733,1,5,49,0
52250265.0,55,118,2.1454545454545455,1,4,55,0
52250269.0,52,112,2.1538461538461537,1,5,52,0
52250273.0,53,114,2.150943396226415,1,5,53,0
52250278.0,51,94,1.8431372549019607,1,3,51,0
52250279.0,43,79,1.8372093023255813,1,4,43,0
52250280.0,10,17,1.7,1,3,10,0
52250281.0,26,177,6.8076923076923075,5,9,19,7
52250344.0,88,262,2.977272727272727,1,5,88,0
52250645.0,67,346,5.164179104477612,3,8,66,1
52250930.0,15,34,2.2666666666666666,1,4,15,0
52251417.0,2,5,2.5,2,3,2,0
52251620.0,140,1077,7.692857142857143,2,10,50,90
52252946.0,12,80,6.666666666666667,4,9,9,3
52253067.0,43,287,6.674418604651163,2,9,33,10
52253526.0,39,333,8.538461538461538,3,11,8,31
52254195.0,156,757,4.852564102564102,2,8,154,2
52256215.0,141,709,5.028368794326241,2,7,141,0
52257521.0,64,634,9.90625,6,12,1,63
52259039.0,9,40,4.444444444444445,3,6,9,0
52259932.0,53,235,4.433962264150943,2,7,53,0
52262995.0,65,632,9.723076923076922,5,13,3,62
52270901.0,37,138,3.72972972972973,2,6,37,0
52272026.0,74,214,2.891891891891892,1,5,74,0
52272867.0,5,15,3.0,2,4,5,0
52272917.0,1,8,8.0,8,8,0,1
52273762.0,1,3,3.0,3,3,1,0
52274444.0,200,1549,7.745,2,11,73,127
52275760.0,136,699,5.139705882352941,3,8,135,1
52279153.0,1,1,1.0,1,1,1,0
52280693.0,4,25,6.25,5,7,4,0
52284225.0,2,15,7.5,7,8,1,1
52291649.0,19,52,2.736842105263158,1,4,19,0
52297449.0,1,4,4.0,4,4,1,0
52297896.0,2,6,3.0,3,3,2,0
52298262.0,183,368,2.010928961748634,1,5,183,0
52300715.0,9,57,6.333333333333333,2,8,7,2
52303332.0,43,211,4.906976744186046,3,7,43,0
52314283.0,33,100,3.0303030303030303,1,5,33,0
52314351.0,2,9,4.5,4,5,2,0
52314554.0,3,11,3.6666666666666665,3,4,3,0
52314926.0,88,182,2.0681818181818183,1,5,88,0
52315042.0,234,2043,8.73076923076923,2,13,29,205
52315133.0,84,184,2.1904761904761907,1,5,84,0
52315750.0,9,16,1.7777777777777777,1,3,9,0
52318037.0,2,2,1.0,1,1,2,0
52320286.0,46,221,4.804347826086956,2,7,46,0
52323294.0,176,365,2.0738636363636362,1,5,176,0
52323582.0,169,342,2.0236686390532546,1,4,169,0
52324831.0,10,24,2.4,1,4,10,0
52329991.0,13,35,2.6923076923076925,1,4,13,0
52329993.0,39,88,2.2564102564102564,1,5,39,0
52330658.0,31,63,2.032258064516129,1,5,31,0
52331430.0,7,40,5.714285714285714,5,7,7,0
52332556.0,35,81,2.3142857142857145,1,4,35,0
52345541.0,187,1799,9.620320855614974,2,13,12,175
52357231.0,12,94,7.833333333333333,5,9,3,9
52359810.0,129,280,2.1705426356589146,1,5,129,0
52359885.0,10,25,2.5,1,4,10,0
52361630.0,175,1216,6.948571428571428,2,10,125,50
52361682.0,228,1124,4.9298245614035086,2,8,225,3
52361784.0,57,289,5.0701754385964914,2,8,55,2
52361850.0,138,696,5.043478260869565,2,7,138,0
52361968.0,103,493,4.786407766990291,2,8,102,1
52363321.0,217,1863,8.585253456221198,2,12,36,181
52365640.0,63,249,3.9523809523809526,1,6,63,0
52365783.0,24,95,3.9583333333333335,2,6,24,0
52378346.0,67,325,4.850746268656716,2,7,67,0
52378378.0,75,386,5.1466666666666665,2,8,73,2
52379392.0,36,252,7.0,2,9,24,12
52382148.0,5,9,1.8,1,3,5,0
52383782.0,104,421,4.048076923076923,2,7,104,0
52386268.0,67,598,8.925373134328359,5,12,5,62
52386899.0,7,22,3.142857142857143,2,4,7,0
52388713.0,309,1214,3.928802588996764,1,7,309,0
52402632.0,211,1036,4.909952606635071,2,7,211,0
52403116.0,1,2,2.0,2,2,1,0
52404696.0,38,194,5.105263157894737,2,7,38,0
52405233.0,73,206,2.8219178082191783,1,5,73,0
52414977.0,62,179,2.8870967741935485,1,7,62,0
52416211.0,137,681,4.970802919708029,2,8,134,3
52421322.0,61,309,5.065573770491803,3,7,61,0
52422013.0,2,4,2.0,1,3,2,0
52424418.0,86,329,3.8255813953488373,1,6,86,0
52429729.0,121,230,1.9008264462809918,1,5,121,0
52432862.0,180,1211,6.727777777777778,2,9,129,51
52433777.0,85,410,4.823529411764706,2,7,85,0
52434125.0,191,1887,9.879581151832461,2,12,10,181
52437978.0,76,178,2.3421052631578947,1,5,76,0
52439261.0,180,1586,8.811111111111112,2,12,23,157
52440161.0,258,1241,4.810077519379845,2,7,258,0
52441344.0,196,970,4.948979591836735,2,8,195,1
52444926.0,9,37,4.111111111111111,3,5,9,0
52447755.0,43,163,3.7906976744186047,2,6,43,0
52453070.0,77,429,5.571428571428571,2,7,77,0
52453228.0,44,264,6.0,2,8,40,4
52463924.0,6,7,1.1666666666666667,1,2,6,0
52463958.0,2,3,1.5,1,2,2,0
52478763.0,11,81,7.363636363636363,6,9,6,5
52482920.0,28,76,2.7142857142857144,1,5,28,0
52483003.0,117,353,3.017094017094017,1,6,117,0
52483956.0,3,16,5.333333333333333,4,7,3,0
52485142.0,16,81,5.0625,2,7,16,0
52486085.0,9,21,2.3333333333333335,1,4,9,0
52487945.0,14,95,6.785714285714286,5,8,9,5
52492292.0,182,1769,9.719780219780219,2,13,9,173
52501948.0,5,18,3.6,3,4,5,0
52504852.0,239,1161,4.857740585774058,2,8,237,2
52505142.0,7,19,2.7142857142857144,1,4,7,0
52510344.0,24,45,1.875,1,4,24,0
52510451.0,77,376,4.883116883116883,2,7,77,0
52512450.0,89,439,4.932584269662922,2,7,89,0
52521041.0,123,362,2.9430894308943087,1,6,123,0
52521631.0,18,144,8.0,6,10,7,11
52523393.0,36,43,1.1944444444444444,1,2,36,0
52523544.0,129,373,2.891472868217054,1,5,129,0
52523719.0,225,1127,5.0088888888888885,2,8,223,2
52524264.0,32,45,1.40625,1,3,32,0
52524335.0,73,215,2.9452054794520546,1,6,73,0
52524539.0,88,702,7.9772727272727275,5,11,29,59
52529831.0,162,634,3.9135802469135803,1,6,162,0
52530945.0,20,31,1.55,1,3,20,0
52544691.0,205,420,2.048780487804878,1,4,205,0
52547327.0,38,224,5.894736842105263,2,8,37,1
52550563.0,90,171,1.9,1,4,90,0
52551546.0,39,75,1.9230769230769231,1,4,39,0
52552823.0,249,2383,9.570281124497992,2,12,18,231
52559164.0,2,4,2.0,2,2,2,0
52559824.0,394,829,2.1040609137055837,1,5,394,0
52560013.0,4,10,2.5,2,3,4,0
52560176.0,40,90,2.25,1,5,40,0
52560491.0,9,17,1.8888888888888888,1,3,9,0
52564729.0,150,1166,7.773333333333333,2,11,55,95
52565330.0,36,77,2.138888888888889,1,4,36,0
52566623.0,160,1512,9.45,2,13,13,147
52581171.0,155,751,4.84516129032258,2,7,155,0
52590734.0,86,414,4.813953488372093,2,7,86,0
52594482.0,264,2315,8.768939393939394,2,12,26,238
52596516.0,73,337,4.616438356164384,2,7,73,0
52598621.0,30,40,1.3333333333333333,1,4,30,0
52604679.0,7,30,4.285714285714286,3,6,7,0
52607088.0,3,26,8.666666666666666,8,10,0,3
52607106.0,2,16,8.0,8,8,0,2
52607129.0,5,49,9.8,9,11,0,5
52607205.0,4,40,10.0,10,10,0,4
52607226.0,1,11,11.0,11,11,0,1
52607370.0,85,187,2.2,1,4,85,0
52609754.0,84,575,6.845238095238095,2,9,57,27
52610980.0,85,583,6.858823529411764,3,9,62,23
52612163.0,64,89,1.390625,1,3,64,0
52613889.0,2,3,1.5,1,2,2,0
52616535.0,164,1411,8.603658536585366,2,11,26,138
52625403.0,73,710,9.726027397260275,3,12,5,68
52625664.0,19,89,4.684210526315789,3,7,19,0
52626391.0,118,242,2.0508474576271185,1,5,118,0
52626730.0,34,163,4.794117647058823,1,7,34,0
52627012.0,195,762,3.9076923076923076,1,7,195,0
52627581.0,19,79,4.157894736842105,3,6,19,0
52629097.0,14,147,10.5,9,12,0,14
52629367.0,25,254,10.16,8,12,0,25
52629637.0,27,133,4.925925925925926,3,7,27,0
52629783.0,47,228,4.851063829787234,2,7,47,0
52630990.0,66,567,8.590909090909092,2,11,7,59
52639673.0,20,94,4.7,3,6,20,0
52641686.0,38,78,2.0526315789473686,1,4,38,0
52642643.0,90,527,5.855555555555555,2,9,82,8
52644017.0,35,75,2.142857142857143,1,4,35,0
52647184.0,238,1173,4.928571428571429,2,8,237,1
52650050.0,44,91,2.0681818181818183,1,4,44,0
52651940.0,26,50,1.9230769230769231,1,4,26,0
52654345.0,44,349,7.931818181818182,6,10,16,28
52654852.0,187,1629,8.711229946524064,3,11,19,168
52655280.0,117,470,4.017094017094017,2,7,117,0
52661732.0,1,2,2.0,2,2,1,0
52661906.0,8,15,1.875,1,3,8,0
52662057.0,1,2,2.0,2,2,1,0
52663382.0,76,164,2.1578947368421053,1,5,76,0
52663669.0,71,153,2.1549295774647885,1,4,71,0
52663856.0,240,1186,4.941666666666666,2,8,238,2
52664370.0,74,163,2.2027027027027026,1,5,74,0
52666825.0,110,554,5.036363636363636,2,8,108,2
52669185.0,121,248,2.049586776859504,1,5,121,0
52676436.0,46,270,5.869565217391305,3,9,43,3
52677588.0,133,665,5.0,3,7,133,0
52686852.0,104,1010,9.711538461538462,2,13,6,98
52689002.0,4,19,4.75,4,5,4,0
52695342.0,87,517,5.942528735632184,3,9,84,3
52699466.0,37,361,9.756756756756756,3,12,3,34
52715140.0,25,162,6.48,2,9,20,5
52715670.0,168,830,4.940476190476191,2,7,168,0
52716448.0,49,433,8.83673469387755,5,12,5,44
52717111.0,25,147,5.88,4,9,22,3
52717672.0,12,51,4.25,3,6,12,0
52728535.0,119,702,5.899159663865547,2,9,114,5
52731166.0,1,2,2.0,2,2,1,0
52731484.0,146,291,1.9931506849315068,1,5,146,0
52732596.0,3,13,4.333333333333333,4,5,3,0
52746020.0,34,311,9.147058823529411,7,12,1,33
52746774.0,6,18,3.0,2,4,6,0
52746943.0,18,40,2.2222222222222223,1,3,18,0
52747353.0,5,17,3.4,2,5,5,0
52748774.0,34,285,8.382352941176471,3,11,7,27
52753826.0,54,256,4.7407407407407405,2,7,54,0
52762972.0,13,109,8.384615384615385,4,12,3,10
52764070.0,165,315,1.9090909090909092,1,4,165,0
52772179.0,6,7,1.1666666666666667,1,2,6,0
52781203.0,17,33,1.9411764705882353,1,4,17,0
52784155.0,2,3,1.5,1,2,2,0
52786549.0,122,856,7.016393442622951,3,9,82,40
52789842.0,54,433,8.018518518518519,5,10,15,39
52789948.0,40,77,1.925,1,4,40,0
52790649.0,158,922,5.8354430379746836,2,8,154,4
52791200.0,73,158,2.164383561643836,1,5,73,0
52794006.0,11,83,7.545454545454546,5,10,5,6
52795407.0,98,205,2.0918367346938775,1,4,98,0
52813139.0,1,1,1.0,1,1,1,0
52813531.0,18,160,8.88888888888889,7,11,1,17
52814137.0,291,2583,8.876288659793815,2,12,32,259
52816453.0,84,801,9.535714285714286,2,13,5,79
52818014.0,234,1617,6.910256410256411,3,9,165,69
52819157.0,6,12,2.0,1,3,6,0
52819221.0,38,268,7.052631578947368,2,9,23,15
52822366.0,65,371,5.707692307692308,2,9,59,6
52822718.0,35,49,1.4,1,3,35,0
52823242.0,46,288,6.260869565217392,3,8,40,6
52824501.0,8,8,1.0,1,1,8,0
52834660.0,153,734,4.7973856209150325,2,7,153,0
52836407.0,148,299,2.02027027027027,1,5,148,0
52839080.0,20,141,7.05,4,9,12,8
52842300.0,3,11,3.6666666666666665,3,4,3,0
52848896.0,124,171,1.3790322580645162,1,3,124,0
52849591.0,36,173,4.805555555555555,3,7,36,0
52851036.0,70,272,3.8857142857142857,1,7,70,0
52853598.0,55,113,2.0545454545454547,1,4,55,0
52853953.0,89,189,2.1235955056179776,1,5,89,0
52861835.0,201,416,2.0696517412935322,1,4,201,0
52862883.0,116,343,2.956896551724138,1,5,116,0
52867761.0,57,172,3.017543859649123,1,5,57,0
52869821.0,71,142,2.0,1,5,71,0
52870973.0,94,210,2.234042553191489,1,5,94,0
52871976.0,66,149,2.257575757575758,1,4,66,0
52872598.0,171,1164,6.807017543859649,2,10,120,51
52874116.0,7,41,5.857142857142857,4,7,7,0
52874807.0,13,106,8.153846153846153,3,10,2,11
52876734.0,154,588,3.8181818181818183,1,7,154,0
52877663.0,13,15,1.1538461538461537,1,2,13,0
52878285.0,7,12,1.7142857142857142,1,3,7,0
52880209.0,176,858,4.875,2,7,176,0
52882131.0,7,25,3.5714285714285716,3,5,7,0
52883540.0,132,382,2.893939393939394,1,5,132,0
52888459.0,35,178,5.085714285714285,3,7,35,0
52889050.0,50,396,7.92,4,10,18,32
52889412.0,63,305,4.841269841269841,2,7,63,0
52889610.0,19,62,3.263157894736842,2,5,19,0
52890418.0,2,7,3.5,2,5,2,0
52890482.0,3,10,3.3333333333333335,2,4,3,0
52890656.0,366,2541,6.942622950819672,2,10,261,105
52890914.0,26,179,6.884615384615385,5,9,22,4
52893348.0,29,254,8.758620689655173,2,11,3,26
52894894.0,5,24,4.8,4,6,5,0
52895964.0,18,66,3.6666666666666665,3,6,18,0
52897821.0,82,107,1.3048780487804879,1,3,82,0
52898360.0,310,2088,6.735483870967742,2,10,232,78
52910590.0,128,854,6.671875,2,10,97,31
52911198.0,139,195,1.4028776978417266,1,4,139,0
52911399.0,40,122,3.05,1,5,40,0
52912780.0,27,39,1.4444444444444444,1,3,27,0
52916791.0,4,27,6.75,6,7,4,0
52920130.0,130,882,6.7846153846153845,2,10,90,40
52928606.0,59,290,4.915254237288136,3,7,59,0
52930103.0,89,619,6.955056179775281,2,10,64,25
52931278.0,126,1097,8.706349206349206,2,12,16,110
52943949.0,92,198,2.152173913043478,1,6,92,0
52944570.0,17,42,2.4705882352941178,1,4,17,0
52944805.0,20,35,1.75,1,3,20,0
52944824.0,19,37,1.9473684210526316,1,4,19,0
52944882.0,14,30,2.142857142857143,1,3,14,0
52948062.0,157,778,4.955414012738854,2,8,156,1
52953127.0,28,191,6.821428571428571,5,9,20,8
52958192.0,32,306,9.5625,4,12,2,30
52960132.0,13,25,1.9230769230769231,1,3,13,0
52960206.0,18,129,7.166666666666667,6,9,10,8
52960621.0,5,11,2.2,1,4,5,0
52962541.0,193,1309,6.782383419689119,2,10,134,59
52963088.0,5,35,7.0,7,7,5,0
52964096.0,150,1019,6.793333333333333,2,10,110,40
52964504.0,177,1207,6.8192090395480225,2,10,122,55
52965239.0,157,1105,7.038216560509555,2,9,103,54
52965574.0,182,1245,6.84065934065934,2,9,120,62
52965971.0,177,1218,6.88135593220339,2,10,127,50
52966055.0,27,139,5.148148148148148,3,7,27,0
52975833.0,19,181,9.526315789473685,2,12,2,17
52977230.0,19,161,8.473684210526315,4,11,3,16
52979307.0,14,55,3.9285714285714284,2,6,14,0
52980394.0,125,850,6.8,3,9,90,35
52987362.0,75,371,4.946666666666666,2,8,74,1
52993517.0,10,17,1.7,1,3,10,0
52997669.0,97,481,4.958762886597938,2,8,96,1
52999207.0,154,745,4.837662337662338,2,7,154,0
52999469.0,79,402,5.0886075949367084,2,8,78,1
52999915.0,87,440,5.057471264367816,2,8,86,1
53001959.0,107,738,6.897196261682243,2,10,71,36
53002036.0,252,2457,9.75,2,12,16,236
53005506.0,68,216,3.176470588235294,1,6,68,0
53011953.0,147,454,3.0884353741496597,1,5,147,0
53018205.0,78,743,9.525641025641026,3,13,7,71
53025399.0,110,1035,9.409090909090908,2,12,10,100
53025786.0,31,188,6.064516129032258,4,8,29,2
53035554.0,74,442,5.972972972972973,4,9,70,4
53036839.0,53,69,1.3018867924528301,1,3,53,0
53037060.0,142,567,3.992957746478873,1,7,142,0
53038129.0,38,363,9.552631578947368,3,12,2,36
53038550.0,80,103,1.2875,1,3,80,0
53042605.0,10,25,2.5,1,4,10,0
53043869.0,128,1117,8.7265625,2,12,15,113
53046283.0,14,101,7.214285714285714,5,10,9,5
53047193.0,14,100,7.142857142857143,4,9,8,6
53055872.0,5,9,1.8,1,3,5,0
53055878.0,100,950,9.5,2,12,9,91
53056104.0,2,2,1.0,1,1,2,0
53057010.0,79,781,9.886075949367088,3,13,5,74
53057160.0,16,31,1.9375,1,3,16,0
53057255.0,7,47,6.714285714285714,6,8,6,1
53058110.0,5,22,4.4,4,5,5,0
53058202.0,137,273,1.9927007299270072,1,4,137,0
53058511.0,40,82,2.05,1,4,40,0
53058621.0,25,127,5.08,2,7,25,0
53058813.0,75,363,4.84,2,7,75,0
53059073.0,8,18,2.25,2,3,8,0
53059184.0,33,67,2.0303030303030303,1,4,33,0
53072198.0,52,500,9.615384615384615,2,13,3,49
53072951.0,65,442,6.8,3,9,51,14
53085050.0,210,2042,9.723809523809523,3,13,11,199
53085779.0,99,690,6.96969696969697,2,9,65,34
53090569.0,144,568,3.9444444444444446,1,6,144,0
53101051.0,19,37,1.9473684210526316,1,3,19,0
53104994.0,223,1108,4.968609865470852,2,8,220,3
53106972.0,78,396,5.076923076923077,2,8,77,1
53119136.0,37,117,3.1621621621621623,1,5,37,0
53120002.0,162,789,4.87037037037037,2,7,162,0
53121964.0,25,49,1.96,1,3,25,0
53125251.0,3,10,3.3333333333333335,2,5,3,0
53125328.0,1,3,3.0,3,3,1,0
53125354.0,194,944,4.865979381443299,2,8,193,1
53125389.0,2,7,3.5,3,4,2,0
53125718.0,1,4,4.0,4,4,1,0
53125897.0,1,3,3.0,3,3,1,0
53126020.0,1,3,3.0,3,3,1,0
53126120.0,3,3,1.0,1,1,3,0
53126162.0,2,6,3.0,2,4,2,0
53126489.0,2,5,2.5,1,4,2,0
53126545.0,4,9,2.25,1,3,4,0
53138956.0,204,1021,5.004901960784314,2,8,202,2
53139542.0,198,962,4.858585858585859,2,9,196,2
53140353.0,48,250,5.208333333333333,3,8,47,1
53140738.0,49,234,4.775510204081633,2,7,49,0
53144811.0,38,54,1.4210526315789473,1,3,38,0
53145941.0,143,556,3.888111888111888,1,6,143,0
53147000.0,228,2209,9.68859649122807,2,13,15,213
53147774.0,106,1056,9.962264150943396,3,12,4,102
53151633.0,50,455,9.1,5,12,5,45
53158196.0,20,176,8.8,2,12,4,16
53158537.0,41,88,2.1463414634146343,1,5,41,0
53158543.0,12,25,2.0833333333333335,1,3,12,0
53158964.0,147,574,3.9047619047619047,1,7,147,0
53159802.0,2,5,2.5,2,3,2,0
53159843.0,7,60,8.571428571428571,7,10,1,6
53159870.0,3,21,7.0,6,8,2,1
53159888.0,2,16,8.0,8,8,0,2
53159903.0,2,4,2.0,2,2,2,0
53159922.0,5,33,6.6,6,7,5,0
53160561.0,46,183,3.9782608695652173,2,6,46,0
53165526.0,40,114,2.85,1,5,40,0
53166715.0,22,99,4.5,3,6,22,0
53166888.0,26,54,2.076923076923077,1,3,26,0
53169688.0,93,871,9.365591397849462,2,12,11,82
53171523.0,36,190,5.277777777777778,3,7,36,0
53176092.0,198,593,2.994949494949495,1,5,198,0
53180207.0,140,280,2.0,1,4,140,0
53180217.0,13,36,2.769230769230769,1,5,13,0
53180435.0,210,426,2.0285714285714285,1,5,210,0
53186107.0,91,279,3.065934065934066,1,6,91,0
53188720.0,55,126,2.290909090909091,1,5,55,0
53189416.0,54,114,2.111111111111111,1,4,54,0
53192187.0,1,8,8.0,8,8,0,1
53193635.0,83,120,1.4457831325301205,1,3,83,0
53195801.0,40,398,9.95,8,12,0,40
53198715.0,1,7,7.0,7,7,1,0
53199868.0,73,511,7.0,4,9,47,26
53199953.0,16,75,4.6875,2,6,16,0
53207092.0,9,80,8.88888888888889,4,12,2,7
53207341.0,239,1643,6.874476987447698,2,10,170,69
53209368.0,2,18,9.0,9,9,0,2
53212349.0,53,104,1.9622641509433962,1,4,53,0
53217798.0,321,2203,6.862928348909658,2,10,220,101
53218655.0,4,28,7.0,6,8,3,1
53219755.0,73,293,4.013698630136986,2,7,73,0
53225155.0,65,439,6.753846153846154,2,9,49,16
53225206.0,44,98,2.227272727272727,1,4,44,0
53227837.0,5,26,5.2,4,7,5,0
53228209.0,12,43,3.5833333333333335,2,5,12,0
53228340.0,2,16,8.0,8,8,0,2
53236469.0,232,487,2.0991379310344827,1,4,232,0
53242389.0,1,3,3.0,3,3,1,0
53245851.0,7,13,1.8571428571428572,1,3,7,0
53245938.0,29,149,5.137931034482759,3,7,29,0
53249110.0,46,181,3.9347826086956523,2,7,46,0
53252165.0,9,34,3.7777777777777777,2,5,9,0
53257702.0,13,17,1.3076923076923077,1,3,13,0
53266533.0,7,47,6.714285714285714,5,9,6,1
53268021.0,10,21,2.1,1,3,10,0
53270156.0,45,94,2.088888888888889,1,4,45,0
53272539.0,40,49,1.225,1,3,40,0
53275651.0,41,216,5.2682926829268295,3,8,40,1
53285783.0,21,47,2.238095238095238,1,4,21,0
53290836.0,11,20,1.8181818181818181,1,3,11,0
53291728.0,55,72,1.309090909090909,1,3,55,0
53299960.0,69,253,3.6666666666666665,1,5,69,0
53302020.0,78,303,3.8846153846153846,1,6,78,0
53303127.0,102,216,2.1176470588235294,1,5,102,0
53303741.0,67,650,9.701492537313433,6,13,6,61
53304206.0,71,145,2.0422535211267605,1,6,71,0
53305212.0,33,175,5.303030303030303,4,7,33,0
53306659.0,66,131,1.9848484848484849,1,5,66,0
53309013.0,68,94,1.3823529411764706,1,3,68,0
53311651.0,161,471,2.9254658385093166,1,5,161,0
53312656.0,96,934,9.729166666666666,2,13,6,90
53318108.0,133,635,4.774436090225564,2,7,133,0
53318510.0,44,296,6.7272727272727275,3,9,35,9
53321457.0,34,51,1.5,1,3,34,0
53322901.0,47,146,3.106382978723404,1,6,47,0
53334089.0,13,83,6.384615384615385,2,8,10,3
53341816.0,82,115,1.4024390243902438,1,4,82,0
53341955.0,81,105,1.2962962962962963,1,3,81,0
53343059.0,29,66,2.2758620689655173,1,4,29,0
53352217.0,26,56,2.1538461538461537,1,4,26,0
53352240.0,144,691,4.798611111111111,1,7,144,0
53352830.0,133,403,3.030075187969925,1,5,133,0
53354870.0,103,999,9.699029126213592,2,13,7,96
53355095.0,3,27,9.0,8,10,0,3
53355459.0,9,65,7.222222222222222,6,9,6,3
53355903.0,193,406,2.1036269430051813,1,5,193,0
53356307.0,44,297,6.75,2,10,31,13
53366795.0,24,53,2.2083333333333335,1,4,24,0
53368776.0,6,38,6.333333333333333,6,7,6,0
53374437.0,16,45,2.8125,1,5,16,0
53379176.0,34,343,10.088235294117647,8,12,0,34
53383149.0,9,15,1.6666666666666667,1,3,9,0
53388879.0,53,424,8.0,2,10,17,36
53388998.0,127,271,2.1338582677165356,1,5,127,0
53389826.0,16,117,7.3125,6,9,9,7
53390091.0,19,57,3.0,1,5,19,0
53393558.0,93,190,2.043010752688172,1,4,93,0
53394919.0,2,4,2.0,2,2,2,0
53394944.0,47,365,7.76595744680851,2,10,17,30
53395269.0,140,305,2.1785714285714284,1,5,140,0
53397053.0,24,171,7.125,5,9,12,12
53397401.0,6,45,7.5,6,10,4,2
53398509.0,18,51,2.8333333333333335,1,6,18,0
53398896.0,14,85,6.071428571428571,3,8,12,2
53400238.0,65,377,5.8,2,8,58,7
53406784.0,18,118,6.555555555555555,5,8,14,4
53409119.0,42,371,8.833333333333334,2,12,5,37
53411720.0,3,14,4.666666666666667,4,5,3,0
53414472.0,1,2,2.0,2,2,1,0
53426696.0,34,75,2.2058823529411766,1,5,34,0
53428247.0,40,246,6.15,4,8,37,3
53435826.0,9,52,5.777777777777778,5,8,8,1
53439067.0,7,19,2.7142857142857144,2,4,7,0
53440422.0,141,982,6.964539007092198,4,9,101,40
53440828.0,192,576,3.0,1,6,192,0
53442180.0,69,161,2.3333333333333335,1,5,69,0
53458511.0,91,633,6.956043956043956,4,10,65,26
53472749.0,155,762,4.916129032258064,2,8,153,2
53474260.0,82,631,7.695121951219512,2,10,32,50
53475590.0,13,70,5.384615384615385,3,7,13,0
53476682.0,37,138,3.72972972972973,2,6,37,0
53476972.0,44,218,4.954545454545454,2,7,44,0
53478316.0,63,304,4.825396825396825,2,7,63,0
53485410.0,90,360,4.0,2,6,90,0
53486450.0,11,34,3.090909090909091,2,4,11,0
53487277.0,2,14,7.0,6,8,1,1
53487299.0,8,47,5.875,5,7,8,0
53487371.0,30,277,9.233333333333333,8,12,0,30
53487372.0,5,32,6.4,5,8,4,1
53487391.0,3,19,6.333333333333333,5,8,2,1
53487407.0,1,3,3.0,3,3,1,0
53487423.0,2,3,1.5,1,2,2,0
53487824.0,2,4,2.0,1,3,2,0
53487991.0,20,32,1.6,1,4,20,0
53488911.0,56,337,6.017857142857143,3,8,52,4
53489913.0,12,71,5.916666666666667,2,7,12,0
53493292.0,1,3,3.0,3,3,1,0
53494600.0,3,22,7.333333333333333,6,8,1,2
53503237.0,101,706,6.99009900990099,4,10,66,35
53505252.0,63,312,4.9523809523809526,2,7,63,0
53507070.0,11,58,5.2727272727272725,4,8,10,1
53507781.0,122,484,3.9672131147540983,2,7,122,0
53508528.0,140,958,6.8428571428571425,2,9,98,42
53512877.0,107,531,4.962616822429907,3,7,107,0
53514578.0,50,136,2.72,1,5,50,0
53521006.0,192,927,4.828125,2,7,192,0
53523294.0,16,108,6.75,5,9,13,3
53525968.0,102,721,7.068627450980392,2,9,66,36
53528308.0,76,157,2.0657894736842106,1,4,76,0
53528405.0,4,29,7.25,6,8,2,2
53532346.0,87,251,2.8850574712643677,1,5,87,0
53538406.0,140,539,3.85,2,7,140,0
53538776.0,33,68,2.0606060606060606,1,4,33,0
53538970.0,90,895,9.944444444444445,2,12,3,87
53539616.0,47,106,2.25531914893617,1,5,47,0
53540702.0,48,113,2.3541666666666665,1,4,48,0
53540904.0,2,6,3.0,3,3,2,0
53544389.0,269,556,2.066914498141264,1,4,269,0
53548531.0,36,243,6.75,5,9,28,8
53555442.0,128,385,3.0078125,1,6,128,0
53555781.0,107,945,8.83177570093458,3,12,11,96
53558313.0,154,757,4.915584415584416,2,8,153,1
53563820.0,129,526,4.077519379844961,2,7,129,0
53565106.0,87,834,9.586206896551724,3,12,5,82
53565459.0,14,106,7.571428571428571,2,10,4,10
53567812.0,80,479,5.9875,3,9,71,9
53568020.0,97,940,9.690721649484535,4,12,5,92
53574973.0,11,76,6.909090909090909,5,8,7,4
53581674.0,83,182,2.1927710843373496,1,5,83,0
53583283.0,1,4,4.0,4,4,1,0
53584174.0,65,132,2.0307692307692307,1,4,65,0
53584422.0,146,707,4.842465753424658,3,7,146,0
53586358.0,64,316,4.9375,2,8,63,1
53588988.0,28,54,1.9285714285714286,1,3,28,0
53597414.0,132,275,2.0833333333333335,1,4,132,0
53598245.0,109,223,2.0458715596330275,1,4,109,0
53599540.0,53,113,2.1320754716981134,1,4,53,0
53601124.0,11,29,2.6363636363636362,1,4,11,0
53601532.0,10,77,7.7,4,9,3,7
53602913.0,15,106,7.066666666666666,4,9,10,5
53604463.0,160,348,2.175,1,5,160,0
53604598.0,20,58,2.9,1,5,20,0
53606196.0,4,6,1.5,1,2,4,0
53606347.0,15,22,1.4666666666666666,1,3,15,0
53606492.0,1,1,1.0,1,1,1,0
53616596.0,61,129,2.1147540983606556,1,4,61,0
53616747.0,53,443,8.358490566037736,2,11,8,45
53617692.0,99,194,1.9595959595959596,1,5,99,0
53618519.0,7,36,5.142857142857143,4,6,7,0
53619002.0,12,64,5.333333333333333,3,8,11,1
53619270.0,26,123,4.730769230769231,2,7,26,0
53619454.0,86,164,1.9069767441860466,1,4,86,0
53619489.0,34,128,3.764705882352941,2,6,34,0
53619592.0,12,63,5.25,4,7,12,0
53619706.0,49,419,8.551020408163266,2,11,6,43
53619927.0,36,250,6.944444444444445,3,9,25,11
53620191.0,82,173,2.1097560975609757,1,5,82,0
53620580.0,8,15,1.875,1,3,8,0
53620829.0,2,2,1.0,1,1,2,0
53625996.0,156,470,3.0128205128205128,1,6,156,0
53627000.0,166,1145,6.897590361445783,2,9,114,52
53627501.0,123,1072,8.715447154471544,2,11,12,111
53627592.0,218,443,2.032110091743119,1,5,218,0
53639033.0,14,71,5.071428571428571,4,6,14,0
53642270.0,188,1293,6.877659574468085,2,9,132,56
53646154.0,72,290,4.027777777777778,1,7,72,0
53651282.0,109,232,2.128440366972477,1,4,109,0
53652613.0,32,71,2.21875,1,4,32,0
53654464.0,1,4,4.0,4,4,1,0
53655115.0,219,1104,5.041095890410959,1,8,216,3
53657312.0,145,835,5.758620689655173,2,9,140,5
53657884.0,9,31,3.4444444444444446,2,7,9,0
53657895.0,16,39,2.4375,1,4,16,0
53658956.0,1,7,7.0,7,7,1,0
53659002.0,140,1102,7.871428571428571,4,10,49,91
53662660.0,311,2176,6.996784565916399,2,10,212,99
53666531.0,1,6,6.0,6,6,1,0
53667337.0,1,4,4.0,4,4,1,0
53667472.0,1,1,1.0,1,1,1,0
53668434.0,7,8,1.1428571428571428,1,2,7,0
53669590.0,37,304,8.216216216216216,2,11,8,29
53669637.0,26,181,6.961538461538462,4,9,17,9
53672879.0,12,26,2.1666666666666665,1,4,12,0
53680187.0,33,252,7.636363636363637,2,10,12,21
53687404.0,39,197,5.051282051282051,3,8,38,1
53692465.0,58,180,3.103448275862069,1,6,58,0
53693034.0,32,281,8.78125,2,11,5,27
53696205.0,91,708,7.78021978021978,2,11,36,55
53698222.0,24,70,2.9166666666666665,1,5,24,0
53698850.0,7,69,9.857142857142858,6,12,1,6
53700629.0,13,26,2.0,1,3,13,0
53700827.0,143,432,3.020979020979021,1,5,143,0
53702193.0,174,1197,6.879310344827586,2,10,122,52
53705702.0,62,409,6.596774193548387,2,8,48,14
53714783.0,164,813,4.9573170731707314,2,8,163,1
53717393.0,3,7,2.3333333333333335,1,4,3,0
53717717.0,5,31,6.2,5,7,5,0
53719103.0,126,259,2.0555555555555554,1,4,126,0
53729220.0,9,51,5.666666666666667,5,7,9,0
53730767.0,37,54,1.4594594594594594,1,4,37,0
53731670.0,52,269,5.173076923076923,3,7,52,0
53739885.0,207,637,3.077294685990338,1,6,207,0
53745243.0,9,37,4.111111111111111,3,5,9,0
53746355.0,107,539,5.037383177570093,2,8,104,3
53746693.0,92,184,2.0,1,4,92,0
53746842.0,270,1335,4.944444444444445,2,8,268,2
53750242.0,136,928,6.823529411764706,2,10,98,38
53750580.0,4,21,5.25,5,6,4,0
53755801.0,25,52,2.08,1,4,25,0
53756527.0,9,18,2.0,1,4,9,0
53762391.0,53,149,2.811320754716981,1,5,53,0
53762794.0,73,491,6.726027397260274,2,9,56,17
53763239.0,98,482,4.918367346938775,2,7,98,0
53764454.0,29,58,2.0,1,4,29,0
53764455.0,27,56,2.074074074074074,1,4,27,0
53764457.0,59,133,2.2542372881355934,1,4,59,0
53764458.0,24,47,1.9583333333333333,1,4,24,0
53764459.0,18,34,1.8888888888888888,1,3,18,0
53764460.0,32,63,1.96875,1,3,32,0
53764461.0,48,100,2.0833333333333335,1,4,48,0
53764462.0,53,115,2.169811320754717,1,4,53,0
53765206.0,25,48,1.92,1,3,25,0
53776119.0,98,635,6.479591836734694,2,10,77,21
53777369.0,72,145,2.013888888888889,1,4,72,0
53778362.0,24,46,1.9166666666666667,1,4,24,0
53778911.0,160,1393,8.70625,2,11,15,145
53782059.0,62,305,4.919354838709677,2,7,62,0
53787924.0,21,81,3.857142857142857,2,6,21,0
53790608.0,7,44,6.285714285714286,3,7,7,0
53792157.0,11,56,5.090909090909091,3,7,11,0
53795501.0,55,215,3.909090909090909,2,5,55,0
53796467.0,123,710,5.772357723577236,2,9,117,6
53802468.0,167,1321,7.910179640718563,4,11,53,114
53802546.0,145,431,2.972413793103448,1,6,145,0
53803983.0,20,105,5.25,3,8,19,1
53804922.0,31,73,2.3548387096774195,1,4,31,0
53805632.0,15,32,2.1333333333333333,1,4,15,0
53805789.0,18,105,5.833333333333333,5,7,18,0
53806139.0,26,45,1.7307692307692308,1,4,26,0
53806385.0,11,22,2.0,1,3,11,0
53806798.0,2,6,3.0,2,4,2,0
53806986.0,36,64,1.7777777777777777,1,4,36,0
53807235.0,18,42,2.3333333333333335,1,4,18,0
53807656.0,6,12,2.0,1,3,6,0
53807894.0,12,24,2.0,1,3,12,0
53808222.0,6,18,3.0,2,4,6,0
53808601.0,88,201,2.284090909090909,1,5,88,0
53813137.0,11,17,1.5454545454545454,1,3,11,0
53813588.0,28,65,2.3214285714285716,1,5,28,0
53813772.0,127,173,1.3622047244094488,1,4,127,0
53813821.0,20,38,1.9,1,4,20,0
53820116.0,134,630,4.701492537313433,2,7,134,0
53821687.0,94,186,1.9787234042553192,1,4,94,0
53821698.0,22,66,3.0,2,5,22,0
53822522.0,115,242,2.1043478260869564,1,4,115,0
53822773.0,38,115,3.026315789473684,1,6,38,0
53822974.0,34,65,1.911764705882353,1,3,34,0
53823591.0,55,164,2.981818181818182,1,5,55,0
53823660.0,127,626,4.929133858267717,2,7,127,0
53824227.0,73,211,2.8904109589041096,1,5,73,0
53824502.0,55,170,3.090909090909091,1,5,55,0
53824751.0,60,190,3.1666666666666665,1,5,60,0
53825034.0,88,261,2.965909090909091,1,5,88,0
53825064.0,128,266,2.078125,1,4,128,0
53825498.0,25,60,2.4,1,4,25,0
53826598.0,10,24,2.4,1,4,10,0
53839516.0,20,43,2.15,1,5,20,0
53846646.0,8,26,3.25,2,5,8,0
53846650.0,10,24,2.4,1,4,10,0
53847018.0,8,23,2.875,1,4,8,0
53847160.0,11,35,3.1818181818181817,2,4,11,0
53853360.0,61,298,4.885245901639344,2,7,61,0
53854925.0,128,387,3.0234375,1,5,128,0
53856314.0,165,1133,6.866666666666666,3,10,119,46
53860969.0,6,13,2.1666666666666665,1,4,6,0
53861108.0,10,88,8.8,3,11,1,9
53861387.0,12,74,6.166666666666667,2,9,9,3
53863029.0,46,323,7.021739130434782,5,9,29,17
53872794.0,1,1,1.0,1,1,1,0
53873389.0,123,249,2.024390243902439,1,5,123,0
53874029.0,145,195,1.3448275862068966,1,3,145,0
53874831.0,39,85,2.1794871794871793,1,4,39,0
53874990.0,64,378,5.90625,2,8,59,5
53875141.0,220,2132,9.690909090909091,2,13,12,208
53875840.0,1,1,1.0,1,1,1,0
53876059.0,23,107,4.6521739130434785,2,6,23,0
53876705.0,28,190,6.785714285714286,5,9,23,5
53887563.0,57,279,4.894736842105263,2,8,56,1
53889031.0,19,140,7.368421052631579,2,9,8,11
53897480.0,21,28,1.3333333333333333,1,3,21,0
53897625.0,67,386,5.7611940298507465,2,9,63,4
53898049.0,67,393,5.865671641791045,2,8,65,2
53899941.0,52,357,6.865384615384615,3,9,35,17
53900697.0,37,317,8.567567567567568,4,11,6,31
53902438.0,51,347,6.803921568627451,2,9,35,16
53904678.0,48,91,1.8958333333333333,1,4,48,0
53910718.0,174,351,2.0172413793103448,1,5,174,0
53910733.0,26,184,7.076923076923077,5,8,16,10
53916686.0,54,473,8.75925925925926,2,12,4,50
53918129.0,80,573,7.1625,5,10,51,29
53918728.0,14,30,2.142857142857143,1,4,14,0
53919016.0,70,143,2.0428571428571427,1,5,70,0
53929074.0,217,1088,5.013824884792626,2,8,216,1
53931430.0,145,721,4.972413793103448,2,8,144,1
53938913.0,38,366,9.631578947368421,3,12,1,37
53945529.0,142,300,2.112676056338028,1,4,142,0
53945611.0,71,479,6.746478873239437,2,9,52,19
53946129.0,48,148,3.0833333333333335,1,5,48,0
53947464.0,173,862,4.982658959537572,2,8,172,1
53948398.0,42,213,5.071428571428571,3,7,42,0
53950878.0,3,4,1.3333333333333333,1,2,3,0
53954372.0,132,186,1.4090909090909092,1,4,132,0
53955755.0,160,785,4.90625,2,8,159,1
53960376.0,2,9,4.5,4,5,2,0
53960553.0,2,6,3.0,3,3,2,0
53960709.0,2,7,3.5,3,4,2,0
53960846.0,2,10,5.0,5,5,2,0
53961488.0,156,770,4.935897435897436,1,8,153,3
53963851.0,1,2,2.0,2,2,1,0
53964702.0,3,7,2.3333333333333335,2,3,3,0
53965031.0,1,3,3.0,3,3,1,0
53965548.0,1,1,1.0,1,1,1,0
53969471.0,2,5,2.5,2,3,2,0
53969604.0,90,180,2.0,1,4,90,0
53971470.0,140,288,2.057142857142857,1,5,140,0
53975982.0,13,29,2.230769230769231,1,4,13,0
53977787.0,4,15,3.75,3,4,4,0
53978008.0,3,5,1.6666666666666667,1,2,3,0
53978563.0,8,18,2.25,1,3,8,0
53978742.0,26,48,1.8461538461538463,1,4,26,0
53979322.0,7,13,1.8571428571428572,1,3,7,0
53985979.0,29,108,3.7241379310344827,1,6,29,0
53986429.0,16,94,5.875,4,7,16,0
53986670.0,3,3,1.0,1,1,3,0
53988703.0,32,316,9.875,3,12,1,31
53997848.0,2,19,9.5,9,10,0,2
54000525.0,54,115,2.1296296296296298,1,4,54,0
54000809.0,220,1752,7.963636363636364,2,12,65,155
54001058.0,229,1572,6.864628820960698,2,9,162,67
54001177.0,302,2359,7.811258278145695,2,11,119,183
54001268.0,189,1296,6.857142857142857,2,10,132,57
54004759.0,199,1520,7.63819095477387,2,11,74,125
54004937.0,166,1143,6.885542168674699,2,9,117,49
54005120.0,203,1367,6.733990147783251,2,9,149,54
54005280.0,207,1435,6.932367149758454,2,10,144,63
54005556.0,228,1525,6.68859649122807,2,9,159,69
54005607.0,232,1795,7.737068965517241,2,11,84,148
54005662.0,232,1775,7.650862068965517,2,11,80,152
54005736.0,197,408,2.0710659898477157,1,5,197,0
54009045.0,180,1757,9.761111111111111,2,13,9,171
54009759.0,4,5,1.25,1,2,4,0
54010015.0,1,3,3.0,3,3,1,0
54015435.0,7,50,7.142857142857143,5,8,3,4
54017282.0,326,1264,3.8773006134969323,1,6,326,0
54018803.0,154,759,4.928571428571429,3,7,154,0
54020114.0,8,9,1.125,1,2,8,0
54031326.0,21,145,6.904761904761905,5,9,16,5
54032403.0,44,92,2.090909090909091,1,5,44,0
54032404.0,60,125,2.0833333333333335,1,5,60,0
54032406.0,20,45,2.25,1,3,20,0
54032407.0,41,82,2.0,1,4,41,0
54032780.0,238,734,3.0840336134453783,1,7,238,0
54037563.0,380,771,2.028947368421053,1,6,380,0
54043630.0,92,198,2.152173913043478,1,5,92,0
54044659.0,48,390,8.125,2,12,10,38
54045125.0,2,4,2.0,2,2,2,0
54049070.0,47,239,5.085106382978723,2,7,47,0
54049206.0,48,478,9.958333333333334,7,13,2,46
54050140.0,1,1,1.0,1,1,1,0
54051574.0,88,612,6.954545454545454,5,9,65,23
54053053.0,38,122,3.210526315789474,1,5,38,0
54053348.0,61,402,6.590163934426229,2,9,47,14
54053549.0,4,6,1.5,1,3,4,0
54054044.0,54,392,7.2592592592592595,5,10,33,21
54054678.0,36,106,2.9444444444444446,1,4,36,0
54062889.0,2,4,2.0,1,3,2,0
54068663.0,12,56,4.666666666666667,3,6,12,0
54069334.0,6,27,4.5,4,5,6,0
54069746.0,3,14,4.666666666666667,4,6,3,0
54070476.0,17,23,1.3529411764705883,1,3,17,0
54072103.0,13,60,4.615384615384615,2,7,13,0
54077489.0,9,61,6.777777777777778,6,8,7,2
54078284.0,43,311,7.232558139534884,4,10,26,17
54087261.0,32,100,3.125,1,5,32,0
54087455.0,43,274,6.372093023255814,2,9,36,7
54087556.0,121,1074,8.87603305785124,3,12,17,104
54088862.0,36,178,4.944444444444445,3,7,36,0
54088975.0,62,306,4.935483870967742,2,7,62,0
54089064.0,89,434,4.876404494382022,3,7,89,0
54091760.0,86,592,6.883720930232558,2,10,66,20
54101259.0,4,7,1.75,1,4,4,0
54107818.0,14,95,6.785714285714286,6,8,11,3
54114826.0,95,477,5.021052631578947,3,7,95,0
54115101.0,2,22,11.0,11,11,0,2
54115698.0,2,18,9.0,9,9,0,2
54115841.0,2,20,10.0,10,10,0,2
54116082.0,1,9,9.0,9,9,0,1
54116139.0,29,70,2.413793103448276,1,5,29,0
54116403.0,34,175,5.147058823529412,3,8,32,2
54116731.0,2,14,7.0,7,7,2,0
54116975.0,22,65,2.9545454545454546,1,5,22,0
54118352.0,21,168,8.0,5,10,7,14
54118629.0,2,6,3.0,3,3,2,0
54120239.0,238,709,2.9789915966386555,1,5,238,0
54120992.0,9,28,3.111111111111111,2,5,9,0
54121474.0,75,362,4.826666666666667,2,7,75,0
54123879.0,240,727,3.029166666666667,1,5,240,0
54134309.0,108,412,3.814814814814815,1,7,108,0
54135196.0,102,200,1.9607843137254901,1,5,102,0
54135418.0,351,2361,6.726495726495727,2,10,256,95
54135426.0,53,466,8.79245283018868,3,11,4,49
54135537.0,115,1089,9.469565217391304,2,14,7,108
54135749.0,13,106,8.153846153846153,6,9,3,10
54138156.0,6,39,6.5,5,7,6,0
54138240.0,371,2556,6.889487870619946,3,10,266,105
54139981.0,33,73,2.212121212121212,1,4,33,0
54139982.0,38,79,2.0789473684210527,1,4,38,0
54139984.0,63,138,2.1904761904761907,1,4,63,0
54139985.0,37,84,2.27027027027027,1,4,37,0
54139987.0,51,93,1.8235294117647058,1,4,51,0
54139988.0,60,120,2.0,1,4,60,0
54142063.0,125,754,6.032,2,10,117,8
54142097.0,40,280,7.0,4,9,26,14
54152489.0,154,1478,9.597402597402597,2,12,10,144
54153520.0,127,1206,9.496062992125983,3,13,12,115
54153596.0,68,346,5.088235294117647,3,9,67,1
54153680.0,15,77,5.133333333333334,4,7,15,0
54154535.0,46,228,4.956521739130435,3,6,46,0
54155085.0,124,1170,9.435483870967742,2,14,9,115
54155728.0,1,5,5.0,5,5,1,0
54155868.0,119,1147,9.638655462184873,4,13,9,110
54156203.0,5,38,7.6,3,11,2,3
54156284.0,51,193,3.784313725490196,2,6,51,0
54156353.0,2,21,10.5,10,11,0,2
54156360.0,3,10,3.3333333333333335,3,4,3,0
54156566.0,2,17,8.5,8,9,0,2
54156627.0,3,27,9.0,9,9,0,3
54156726.0,1,12,12.0,12,12,0,1
54156765.0,1,11,11.0,11,11,0,1
54157975.0,15,113,7.533333333333333,6,9,5,10
54160348.0,154,588,3.8181818181818183,2,6,154,0
54171242.0,125,1169,9.352,2,13,16,109
54173065.0,209,810,3.875598086124402,1,7,209,0
54179147.0,50,374,7.48,3,10,25,25
54179458.0,161,1524,9.46583850931677,2,13,14,147
54181003.0,15,21,1.4,1,2,15,0
54181416.0,46,301,6.543478260869565,2,9,36,10
54188017.0,4,6,1.5,1,3,4,0
54188045.0,30,181,6.033333333333333,3,8,28,2
54188089.0,8,11,1.375,1,3,8,0
54188108.0,18,23,1.2777777777777777,1,3,18,0
54191032.0,1,4,4.0,4,4,1,0
54191854.0,12,76,6.333333333333333,4,8,11,1
54194482.0,93,192,2.064516129032258,1,4,93,0
54194483.0,54,99,1.8333333333333333,1,4,54,0
54194484.0,58,123,2.1206896551724137,1,4,58,0
54194486.0,80,176,2.2,1,4,80,0
54194487.0,62,123,1.9838709677419355,1,5,62,0
54207097.0,18,35,1.9444444444444444,1,3,18,0
54210757.0,31,49,1.5806451612903225,1,3,31,0
54214021.0,182,1251,6.873626373626373,2,10,123,59
54220676.0,61,600,9.836065573770492,4,13,2,59
54224832.0,76,161,2.1184210526315788,1,4,76,0
54231324.0,34,326,9.588235294117647,3,13,2,32
54235904.0,41,202,4.926829268292683,2,7,41,0
54239451.0,5,17,3.4,2,4,5,0
54239637.0,4,16,4.0,3,5,4,0
54241572.0,98,204,2.0816326530612246,1,4,98,0
54242107.0,213,1457,6.84037558685446,2,10,154,59
54243510.0,13,28,2.1538461538461537,1,4,13,0
54245939.0,106,232,2.188679245283019,1,5,106,0
54251028.0,70,390,5.571428571428571,3,8,68,2
54251149.0,43,252,5.8604651162790695,2,8,42,1
54251172.0,23,126,5.478260869565218,2,7,23,0
54251214.0,1,2,2.0,2,2,1,0
54253764.0,6,33,5.5,4,7,6,0
54253845.0,1,1,1.0,1,1,1,0
54254761.0,85,349,4.105882352941176,1,7,85,0
54255122.0,40,80,2.0,1,4,40,0
54261755.0,2,6,3.0,3,3,2,0
54262228.0,3,12,4.0,3,5,3,0
54263009.0,10,83,8.3,6,10,2,8
54263099.0,3,11,3.6666666666666665,3,4,3,0
54269445.0,167,811,4.8562874251497,2,8,165,2
54271344.0,180,885,4.916666666666667,2,8,178,2
54274933.0,122,263,2.1557377049180326,1,5,122,0
54276569.0,172,821,4.773255813953488,2,7,172,0
54277146.0,169,664,3.9289940828402368,2,7,169,0
54280559.0,38,80,2.1052631578947367,1,4,38,0
54289469.0,47,247,5.25531914893617,2,7,47,0
54292603.0,9,31,3.4444444444444446,1,5,9,0
54293135.0,23,59,2.5652173913043477,1,5,23,0
54299119.0,79,316,4.0,2,6,79,0
54299885.0,98,494,5.040816326530612,2,8,97,1
54304616.0,237,2063,8.70464135021097,2,11,29,208
54313498.0,39,228,5.846153846153846,2,9,35,4
54314134.0,1,4,4.0,4,4,1,0
54318345.0,91,447,4.912087912087912,2,7,91,0
54321076.0,10,78,7.8,6,10,4,6
54323619.0,121,497,4.107438016528926,2,8,120,1
54327163.0,122,1152,9.442622950819672,2,12,11,111
54327888.0,59,281,4.762711864406779,3,6,59,0
54328370.0,20,182,9.1,2,11,3,17
54329920.0,99,865,8.737373737373737,3,11,9,90
54334126.0,39,205,5.256410256410256,3,7,39,0
54335805.0,41,317,7.7317073170731705,2,10,13,28
54336238.0,99,212,2.1414141414141414,1,6,99,0
54336841.0,29,89,3.0689655172413794,1,5,29,0
54338172.0,39,76,1.9487179487179487,1,4,39,0
54347923.0,76,106,1.394736842105263,1,4,76,0
54354290.0,3,3,1.0,1,1,3,0
54354878.0,17,113,6.647058823529412,4,8,16,1
54356387.0,87,833,9.574712643678161,3,12,6,81
54361219.0,40,84,2.1,1,4,40,0
54361480.0,27,81,3.0,1,5,27,0
54364799.0,1,2,2.0,2,2,1,0
54374161.0,12,24,2.0,1,4,12,0
54374816.0,159,789,4.962264150943396,2,7,159,0
54376034.0,20,154,7.7,4,10,8,12
54376202.0,95,851,8.957894736842105,3,11,7,88
54384955.0,154,1506,9.779220779220779,2,13,9,145
54385250.0,165,802,4.86060606060606,2,8,164,1
54385849.0,60,115,1.9166666666666667,1,4,60,0
54390754.0,123,256,2.0813008130081303,1,4,123,0
54395813.0,3,5,1.6666666666666667,1,2,3,0
54400494.0,34,76,2.235294117647059,1,4,34,0
54401095.0,5,43,8.6,2,11,1,4
54401901.0,1,5,5.0,5,5,1,0
54402931.0,8,40,5.0,3,6,8,0
54405636.0,10,91,9.1,6,11,1,9
54407236.0,100,489,4.89,2,8,99,1
54408298.0,56,110,1.9642857142857142,1,4,56,0
4.9758969729073094e+17,119,241,2.0252100840336134,1,4,119,0
4.976687842321633e+17,18,55,3.0555555555555554,1,5,18,0
4.976772591726179e+17,48,100,2.0833333333333335,1,5,48,0
4.991621633188103e+17,12,26,2.1666666666666665,1,4,12,0
5.0057333633166246e+17,56,217,3.875,1,6,56,0
5.0184412345720096e+17,14,131,9.357142857142858,8,11,0,14
5.019100980911151e+17,30,293,9.766666666666667,8,11,0,30
5.021847084342025e+17,29,271,9.344827586206897,7,12,3,26
5.040501264870975e+17,29,153,5.275862068965517,2,8,28,1
5.078345828593251e+17,18,42,2.3333333333333335,1,3,18,0
5.078447178659815e+17,14,26,1.8571428571428572,1,3,14,0
5.093673055277271e+17,4,18,4.5,4,6,4,0
5.163915276495075e+17,42,128,3.0476190476190474,1,5,42,0
5.290073098012099e+17,47,361,7.680851063829787,5,10,20,27
5.302458550821557e+17,39,298,7.641025641025641,2,10,14,25
5.3161680140638304e+17,1,2,2.0,2,2,1,0
5.3164696528914285e+17,1,4,4.0,4,4,1,0
5.317698480375721e+17,2,3,1.5,1,2,2,0
5.3254361833026246e+17,86,667,7.755813953488372,2,11,33,53
5.330732133915853e+17,1,4,4.0,4,4,1,0
5.377101651977396e+17,9,14,1.5555555555555556,1,3,9,0
5.384332162740575e+17,37,356,9.621621621621621,4,12,2,35
5.3894382248171674e+17,143,973,6.804195804195804,2,9,99,44
5.389729650909793e+17,1,3,3.0,3,3,1,0
5.3983056324945485e+17,52,455,8.75,3,11,6,46
5.4115399730993414e+17,21,163,7.761904761904762,3,10,6,15
5.412435094406726e+17,12,33,2.75,2,4,12,0
5.419531603329216e+17,19,169,8.894736842105264,3,11,2,17
5.4246969392471386e+17,65,456,7.015384615384615,5,10,45,20
5.431502878900969e+17,98,214,2.183673469387755,1,4,98,0
5.431965721066425e+17,27,35,1.2962962962962963,1,3,27,0
5.435668649481474e+17,30,84,2.8,1,6,30,0
5.438761499992727e+17,17,149,8.764705882352942,7,10,2,15
5.4387638032146784e+17,17,63,3.7058823529411766,3,5,17,0
5.440979339946483e+17,217,2095,9.654377880184331,2,13,13,204
5.445811461238754e+17,21,80,3.8095238095238093,2,6,21,0
5.445971867408336e+17,7,37,5.285714285714286,4,6,7,0
5.446743866854322e+17,26,102,3.923076923076923,2,6,26,0
5.447172540115653e+17,4,11,2.75,2,4,4,0
5.448356548706019e+17,17,73,4.294117647058823,3,6,17,0
5.449667638511055e+17,140,698,4.985714285714286,1,7,140,0
5.4553600083023366e+17,129,1012,7.844961240310077,2,10,39,90
5.461646533373483e+17,1,2,2.0,2,2,1,0
5.461851870447207e+17,1,3,3.0,3,3,1,0
5.464326666277183e+17,72,160,2.2222222222222223,1,4,72,0
5.468549867331969e+17,3,6,2.0,1,3,3,0
5.468739965766839e+17,36,214,5.944444444444445,4,8,31,5
5.4693973269837894e+17,82,562,6.853658536585366,3,9,58,24
5.469438275591821e+17,125,1085,8.68,2,13,15,110
5.4704729894787635e+17,16,113,7.0625,6,8,12,4
5.475574906997513e+17,1,8,8.0,8,8,0,1
5.476516889825148e+17,72,214,2.9722222222222223,1,5,72,0
5.476592728122053e+17,60,360,6.0,4,8,58,2
5.477788259409107e+17,78,518,6.641025641025641,3,9,61,17
5.4781819401500915e+17,187,1298,6.9411764705882355,2,11,138,49
5.480783990179326e+17,16,143,8.9375,7,10,1,15
5.4825806999077734e+17,12,36,3.0,1,5,12,0
5.482798632938119e+17,4,9,2.25,2,3,4,0
5.483263875618821e+17,127,255,2.0078740157480315,1,4,127,0
5.483583368804109e+17,103,403,3.912621359223301,2,6,103,0
5.4837014817250464e+17,154,1499,9.733766233766234,3,12,9,145
5.4837894177682925e+17,143,835,5.839160839160839,2,8,128,15
5.483966075214192e+17,8,63,7.875,6,11,4,4
5.4848047773101274e+17,62,415,6.693548387096774,2,9,51,11
5.4852012480240166e+17,64,439,6.859375,3,9,49,15
5.4858310574307437e+17,3,8,2.6666666666666665,1,4,3,0
5.4893763898728205e+17,129,520,4.0310077519379846,2,7,129,0
5.489412898376583e+17,38,85,2.236842105263158,1,4,38,0
5.49014749701749e+17,15,50,3.3333333333333335,1,5,15,0
5.490181153035533e+17,62,294,4.741935483870968,2,6,62,0
5.490576805814572e+17,69,205,2.971014492753623,1,6,69,0
5.491209300016076e+17,30,58,1.9333333333333333,1,4,30,0
5.4930144089496723e+17,11,51,4.636363636363637,3,6,11,0
5.4931354886538886e+17,140,689,4.921428571428572,2,8,138,2
5.493255049820376e+17,218,862,3.9541284403669725,1,6,218,0
5.4934768983038803e+17,14,86,6.142857142857143,5,7,14,0
5.496264143429015e+17,1,3,3.0,3,3,1,0
5.496421004329348e+17,1,8,8.0,8,8,0,1
5.496969083733171e+17,10,14,1.4,1,4,10,0
5.4981573262797485e+17,137,1322,9.64963503649635,3,12,11,126
5.4985357750975046e+17,147,315,2.142857142857143,1,5,147,0
5.503731187627081e+17,27,76,2.814814814814815,1,5,27,0
5.5126535966335354e+17,179,871,4.865921787709497,2,7,179,0
5.5138377231206784e+17,31,41,1.3225806451612903,1,3,31,0
5.5139963086062656e+17,28,161,5.75,4,8,27,1
5.514850895796969e+17,13,26,2.0,1,3,13,0
5.5183502121660986e+17,1,2,2.0,2,2,1,0
5.518549590233888e+17,16,20,1.25,1,3,16,0
5.5186122613684506e+17,12,74,6.166666666666667,5,8,10,2
5.518635362413157e+17,15,105,7.0,5,10,9,6
5.518648385132554e+17,11,71,6.454545454545454,5,8,10,1
5.5186601711997466e+17,11,67,6.090909090909091,4,9,10,1
5.5186690394221094e+17,34,218,6.411764705882353,2,8,28,6
5.518671610555902e+17,12,63,5.25,2,8,11,1
5.518733936858554e+17,117,1027,8.777777777777779,2,11,13,104
5.5192796265852666e+17,36,71,1.9722222222222223,1,5,36,0
5.5192846050110835e+17,62,424,6.838709677419355,2,10,44,18
5.51938613134139e+17,75,157,2.0933333333333333,1,5,75,0
5.5195923186701114e+17,31,62,2.0,1,4,31,0
5.5196430175743014e+17,36,232,6.444444444444445,2,9,27,9
5.519878365649194e+17,29,59,2.0344827586206895,1,5,29,0
5.520827509168961e+17,20,71,3.55,1,5,20,0
5.525680028531763e+17,11,49,4.454545454545454,1,6,11,0
5.526430440002137e+17,132,520,3.9393939393939394,2,6,132,0
5.527079407087254e+17,35,105,3.0,1,5,35,0
5.5271747383067136e+17,95,661,6.957894736842105,3,9,67,28
5.52741986990437e+17,4,16,4.0,2,5,4,0
5.527634141056235e+17,5,48,9.6,8,11,0,5
5.529427536612769e+17,25,136,5.44,2,7,25,0
5.5319928741737965e+17,1,4,4.0,4,4,1,0
5.5353326026899296e+17,78,107,1.3717948717948718,1,4,78,0
5.535945122190068e+17,28,196,7.0,6,9,22,6
5.536418838597359e+17,167,822,4.922155688622754,2,7,167,0
5.536890508295347e+17,376,782,2.0797872340425534,1,5,376,0
5.5401035163648806e+17,81,398,4.91358024691358,3,8,80,1
5.5416230980187437e+17,9,76,8.444444444444445,4,10,1,8
5.541663414473746e+17,14,41,2.9285714285714284,2,5,14,0
5.5423973068902656e+17,17,132,7.764705882352941,3,11,6,11
5.542487712516879e+17,163,473,2.901840490797546,1,6,163,0
5.542623778026593e+17,35,95,2.7142857142857144,1,5,35,0
5.544290635912319e+17,175,520,2.9714285714285715,1,5,175,0
5.546734014084887e+17,389,1934,4.97172236503856,2,8,386,3
5.5477862313569805e+17,64,514,8.03125,2,10,17,47
5.548581930480556e+17,1,1,1.0,1,1,1,0
5.5492203515352704e+17,5,10,2.0,1,4,5,0
5.5492838563063565e+17,1,1,1.0,1,1,1,0
5.552069753544905e+17,31,208,6.709677419354839,2,9,27,4
5.55253093299877e+17,25,171,6.84,2,9,17,8
5.5548254999211744e+17,27,180,6.666666666666667,3,9,20,7
5.555703419228408e+17,280,1364,4.871428571428571,2,7,280,0
5.556858929975127e+17,33,70,2.121212121212121,1,5,33,0
5.5572265304813e+17,12,36,3.0,1,5,12,0
5.557514165070488e+17,18,30,1.6666666666666667,1,3,18,0
5.557582117944126e+17,25,170,6.8,3,10,20,5
5.55785536991271e+17,202,1397,6.915841584158416,2,10,153,49
5.557906582920433e+17,88,438,4.9772727272727275,2,8,87,1
5.5583701527442925e+17,21,158,7.523809523809524,5,9,9,12
5.5586533351847616e+17,3,20,6.666666666666667,6,7,3,0
5.55890051098356e+17,13,94,7.230769230769231,5,10,8,5
5.559384202703422e+17,38,262,6.894736842105263,5,9,28,10
5.562122600585176e+17,13,25,1.9230769230769231,1,3,13,0
5.56277205000291e+17,71,629,8.859154929577464,3,12,10,61
5.5641636440966816e+17,90,867,9.633333333333333,3,12,7,83
5.564270303847063e+17,51,260,5.098039215686274,3,7,51,0
5.564270484089134e+17,22,159,7.2272727272727275,3,9,12,10
5.5643717833105184e+17,18,29,1.6111111111111112,1,4,18,0
5.564486550690722e+17,24,164,6.833333333333333,4,8,15,9
5.5646804145387686e+17,7,20,2.857142857142857,1,4,7,0
5.5647046338449446e+17,125,1074,8.592,3,11,15,110
5.56482775624587e+17,13,88,6.769230769230769,5,8,10,3
5.568651364035922e+17,96,206,2.1458333333333335,1,4,96,0
5.569065115657263e+17,7,15,2.142857142857143,1,3,7,0
5.5696524889874374e+17,71,136,1.9154929577464788,1,4,71,0
5.5701583167165485e+17,18,172,9.555555555555555,5,13,2,16
5.570166994967217e+17,21,43,2.0476190476190474,1,5,21,0
5.570274508443831e+17,23,78,3.391304347826087,2,6,23,0
5.570653966708304e+17,35,72,2.057142857142857,1,4,35,0
5.571065491821505e+17,98,487,4.969387755102041,2,7,98,0
5.571838044969538e+17,89,263,2.955056179775281,1,5,89,0
5.5759153722517805e+17,41,288,7.024390243902439,5,9,28,13
5.575919569431318e+17,4,11,2.75,1,4,4,0
5.5764442888161683e+17,394,1218,3.0913705583756346,1,7,394,0
5.5765485781914854e+17,3,6,2.0,1,4,3,0
5.576896702090932e+17,103,1006,9.766990291262136,6,12,5,98
5.5769886469421715e+17,78,151,1.935897435897436,1,4,78,0
5.577131368520188e+17,1,4,4.0,4,4,1,0
5.5776576936576755e+17,1,3,3.0,3,3,1,0
5.5777522552717894e+17,118,579,4.906779661016949,2,8,117,1
5.577844141292159e+17,103,213,2.0679611650485437,1,5,103,0
5.577983155690428e+17,201,1903,9.467661691542288,2,14,19,182
5.578388195301408e+17,3,8,2.6666666666666665,2,4,3,0
5.5786154699092794e+17,65,255,3.923076923076923,2,6,65,0
5.5786350489447405e+17,2,7,3.5,3,4,2,0
5.5807105296378675e+17,1,1,1.0,1,1,1,0
5.583538703187683e+17,39,262,6.717948717948718,3,9,28,11
5.584179413559424e+17,1,5,5.0,5,5,1,0
5.5848322723198624e+17,67,134,2.0,1,4,67,0
5.584841174109496e+17,42,78,1.8571428571428572,1,4,42,0
5.584871430083313e+17,1,1,1.0,1,1,1,0
5.5850228485769286e+17,1,5,5.0,5,5,1,0
5.5850236745103955e+17,5,31,6.2,5,7,5,0
5.585213108431428e+17,154,1344,8.727272727272727,2,12,17,137
5.5854506863427066e+17,43,167,3.883720930232558,2,6,43,0
5.5859605416230394e+17,255,1272,4.988235294117647,2,8,252,3
5.586312220125214e+17,141,695,4.929078014184397,3,7,141,0
5.586464601090723e+17,49,466,9.510204081632653,3,11,3,46
5.5867304716790176e+17,1,8,8.0,8,8,0,1
5.588131408851384e+17,169,342,2.0236686390532546,1,4,169,0
5.5908205145132794e+17,51,355,6.96078431372549,5,10,37,14
5.5917867419960384e+17,1,2,2.0,2,2,1,0
5.5918546914326106e+17,205,1974,9.629268292682926,2,12,14,191
5.592053220559817e+17,145,1359,9.372413793103448,2,12,13,132
5.592928021417421e+17,34,278,8.176470588235293,2,11,8,26
5.593191682658593e+17,72,624,8.666666666666666,2,11,11,61
5.5933753591662176e+17,362,3228,8.917127071823204,2,12,27,335
5.593469683362691e+17,1,3,3.0,3,3,1,0
5.595505057534917e+17,1,3,3.0,3,3,1,0
5.5978809012785574e+17,66,133,2.015151515151515,1,4,66,0
5.598027126061902e+17,36,62,1.7222222222222223,1,3,36,0
5.598691288381746e+17,2,8,4.0,4,4,2,0
5.599374981531788e+17,93,459,4.935483870967742,2,7,93,0
5.599645888691451e+17,1,5,5.0,5,5,1,0
5.599841702319866e+17,339,2339,6.899705014749262,2,10,234,105
5.599883192980386e+17,4,9,2.25,1,3,4,0
5.6002175781800954e+17,133,258,1.9398496240601504,1,5,133,0
5.600271846460388e+17,49,314,6.408163265306122,2,9,35,14
5.601744663206587e+17,63,300,4.761904761904762,2,8,62,1
5.6056121898081894e+17,90,448,4.977777777777778,2,7,90,0
5.605927977050702e+17,113,450,3.982300884955752,2,6,113,0
5.6060418953936435e+17,113,358,3.168141592920354,1,5,113,0
5.60668884236902e+17,47,175,3.723404255319149,2,6,47,0
5.6067433145385395e+17,56,216,3.857142857142857,2,6,56,0
5.6087421575880915e+17,116,1124,9.689655172413794,2,12,6,110
5.6092354696705664e+17,7,49,7.0,6,8,6,1
5.6150876168829926e+17,48,230,4.791666666666667,2,6,48,0
5.6171016536759424e+17,5,10,2.0,1,3,5,0
5.620028349365581e+17,25,46,1.84,1,4,25,0
5.6202863790604736e+17,50,110,2.2,1,6,50,0
5.62041795231583e+17,4,27,6.75,6,8,3,1
5.620438076744664e+17,160,802,5.0125,3,8,159,1
5.6209174551546285e+17,2,20,10.0,10,10,0,2
5.621050290603389e+17,40,353,8.825,2,11,6,34
5.621510332876945e+17,6,18,3.0,2,5,6,0
5.6215784270627296e+17,38,358,9.421052631578947,6,12,2,36
5.622577457688869e+17,43,93,2.1627906976744184,1,4,43,0
5.622708642461928e+17,19,142,7.473684210526316,6,9,11,8
5.6227858245779936e+17,198,430,2.1717171717171717,1,5,198,0
5.628367457031645e+17,90,113,1.2555555555555555,1,3,90,0
5.628999398146445e+17,1,4,4.0,4,4,1,0
5.629809722024301e+17,33,42,1.2727272727272727,1,3,33,0
5.630488444230016e+17,12,120,10.0,8,12,0,12
5.631183793624479e+17,7,9,1.2857142857142858,1,2,7,0
5.634413965655045e+17,169,1637,9.68639053254438,2,13,10,159
5.6347145889645114e+17,83,397,4.783132530120482,2,7,83,0
5.634774565257556e+17,178,365,2.050561797752809,1,5,178,0
5.635211959004123e+17,3,5,1.6666666666666667,1,2,3,0
5.635321419335306e+17,5,17,3.4,3,4,5,0
5.63534438685901e+17,2,7,3.5,3,4,2,0
5.635369206803086e+17,1,2,2.0,2,2,1,0
5.6354024065471514e+17,1,2,2.0,2,2,1,0
5.635403025181689e+17,12,16,1.3333333333333333,1,3,12,0
5.6354134971410304e+17,3,7,2.3333333333333335,1,3,3,0
5.635424535535669e+17,1,2,2.0,2,2,1,0
5.635439277249192e+17,4,12,3.0,2,5,4,0
5.635455389147347e+17,8,23,2.875,1,4,8,0
5.635458827520396e+17,13,24,1.8461538461538463,1,3,13,0
5.636238846049892e+17,67,523,7.8059701492537314,2,10,22,45
5.6380190140253485e+17,2,7,3.5,3,4,2,0
5.638187977013572e+17,3,24,8.0,8,8,0,3
5.6391927975584826e+17,31,92,2.967741935483871,1,5,31,0
5.6416713829760166e+17,89,625,7.022471910112359,3,9,58,31
5.642054184912904e+17,29,52,1.793103448275862,1,4,29,0
5.6420867938715814e+17,21,140,6.666666666666667,4,8,15,6
5.6422796603002394e+17,13,87,6.6923076923076925,4,9,10,3
5.642447783868708e+17,1,9,9.0,9,9,0,1
5.642452083706048e+17,8,13,1.625,1,3,8,0
5.642511625849561e+17,2,8,4.0,4,4,2,0
5.643744286154584e+17,107,1063,9.934579439252337,3,13,3,104
5.644476473241337e+17,124,250,2.0161290322580645,1,4,124,0
5.649047407933359e+17,253,1257,4.968379446640316,2,8,249,4
5.6492980404281926e+17,47,87,1.851063829787234,1,4,47,0
5.649472727036284e+17,83,162,1.9518072289156627,1,5,83,0
5.6495502886664525e+17,357,2449,6.859943977591036,2,9,244,113
5.6496496771018995e+17,58,349,6.017241379310345,3,9,52,6
5.649677211791522e+17,1,1,1.0,1,1,1,0
5.649841097594489e+17,96,480,5.0,3,7,96,0
5.650306382252384e+17,21,62,2.9523809523809526,1,5,21,0
5.6510411589981056e+17,174,1694,9.735632183908047,2,12,10,164
5.651140411869047e+17,76,664,8.736842105263158,3,11,10,66
5.651625110179757e+17,329,669,2.033434650455927,1,4,329,0
5.6520435355896544e+17,114,1107,9.710526315789474,3,12,7,107
5.652206682075834e+17,9,11,1.2222222222222223,1,2,9,0
5.655807687816305e+17,22,118,5.363636363636363,4,8,21,1
5.65600233483493e+17,5,11,2.2,1,4,5,0
5.656120643476942e+17,417,2835,6.798561151079137,2,10,298,119
5.656328849317832e+17,380,2609,6.86578947368421,2,10,260,120
5.6576894425001043e+17,13,102,7.846153846153846,2,10,3,10
5.6578694961680525e+17,331,712,2.1510574018126887,1,5,331,0
5.657930666858696e+17,388,2678,6.902061855670103,2,10,272,116
5.658759950782257e+17,97,477,4.917525773195877,2,8,96,1
5.65943158372064e+17,58,89,1.5344827586206897,1,3,58,0
5.663764993388057e+17,78,778,9.974358974358974,2,12,4,74
5.664034411928378e+17,43,132,3.0697674418604652,1,5,43,0
5.6653769775160435e+17,23,33,1.434782608695652,1,3,23,0
5.6673438521005274e+17,20,169,8.45,3,10,2,18
5.6675562559122374e+17,34,75,2.2058823529411766,1,4,34,0
5.671200834130138e+17,31,101,3.2580645161290325,1,6,31,0
5.671540273320935e+17,9,49,5.444444444444445,5,6,9,0
5.6716603934871936e+17,12,23,1.9166666666666667,1,3,12,0
5.6720434336920774e+17,26,129,4.961538461538462,2,8,25,1
5.6722272525210323e+17,87,169,1.9425287356321839,1,4,87,0
5.673019018139961e+17,133,659,4.954887218045113,3,8,131,2
5.673020065206977e+17,111,537,4.837837837837838,2,8,110,1
5.676341371017294e+17,108,936,8.666666666666666,2,12,15,93
5.677263645981508e+17,106,1020,9.622641509433961,2,13,9,97
5.677268129169506e+17,37,80,2.1621621621621623,1,4,37,0
5.677420853844036e+17,153,1463,9.562091503267974,2,12,8,145
5.677436942008617e+17,237,2298,9.69620253164557,2,12,13,224
5.677468559331335e+17,181,1733,9.574585635359115,2,13,12,169
5.6780867051413056e+17,108,747,6.916666666666667,4,10,74,34
5.6792169837938246e+17,30,211,7.033333333333333,6,11,22,8
5.679249468975697e+17,5,9,1.8,1,3,5,0
5.6797025591027757e+17,131,762,5.816793893129771,2,9,125,6
5.679950586959103e+17,106,912,8.60377358490566,2,12,19,87
5.680263498115796e+17,131,768,5.862595419847328,2,9,121,10
5.6804585557918016e+17,134,759,5.664179104477612,2,9,125,9
5.6807738546041914e+17,147,882,6.0,3,9,134,13
5.680809598926046e+17,50,344,6.88,3,10,35,15
5.681606801472775e+17,31,180,5.806451612903226,4,8,30,1
5.68472467509402e+17,74,354,4.783783783783784,2,8,73,1
5.68474602423782e+17,51,99,1.9411764705882353,1,5,51,0
5.684990851190156e+17,50,68,1.36,1,4,50,0
5.68504865806676e+17,66,265,4.015151515151516,1,7,66,0
5.6854965170998176e+17,11,39,3.5454545454545454,2,5,11,0
5.6856136170905696e+17,43,95,2.2093023255813953,1,5,43,0
5.685701606611709e+17,166,1334,8.036144578313253,2,11,46,120
5.6859416284179245e+17,34,49,1.4411764705882353,1,3,34,0
5.686983767316458e+17,53,381,7.188679245283019,6,10,35,18
5.687149864535148e+17,1,2,2.0,2,2,1,0
5.6881289474835974e+17,7,21,3.0,2,5,7,0
5.6881902358466515e+17,66,439,6.651515151515151,2,9,52,14
5.688890762610105e+17,122,616,5.049180327868853,2,8,120,2
5.689254695342146e+17,5,12,2.4,1,4,5,0
5.6905362387649606e+17,23,63,2.739130434782609,1,5,23,0
5.692610982689115e+17,131,647,4.938931297709924,1,7,131,0
5.693520668668826e+17,3,21,7.0,6,8,2,1
5.6935326983304326e+17,62,319,5.145161290322581,3,7,62,0
5.6941071032430816e+17,22,58,2.6363636363636362,1,6,22,0
5.694200421301047e+17,22,147,6.681818181818182,4,9,19,3
5.694297128992585e+17,100,498,4.98,2,7,100,0
5.6944300120270906e+17,93,191,2.053763440860215,1,5,93,0
5.6953899382614246e+17,23,42,1.826086956521739,1,4,23,0
5.696185949015814e+17,3,23,7.666666666666667,4,11,1,2
5.698859078769611e+17,17,69,4.0588235294117645,3,6,17,0
5.6992029647225376e+17,79,532,6.734177215189874,2,9,54,25
5.699787227382216e+17,136,663,4.875,2,8,135,1
5.700588612580708e+17,6,40,6.666666666666667,5,9,4,2
5.700941673398482e+17,168,357,2.125,1,5,168,0
5.7040546480846886e+17,97,208,2.1443298969072164,1,5,97,0
5.706199629492907e+17,95,475,5.0,3,8,94,1
5.70859560659565e+17,69,686,9.942028985507246,5,14,2,67
5.7092130087762016e+17,1,2,2.0,2,2,1,0
5.709285963295542e+17,1,3,3.0,3,3,1,0
5.709330487421826e+17,124,183,1.4758064516129032,1,4,124,0
5.709919360620647e+17,4,31,7.75,5,10,2,2
5.711286835386266e+17,191,1676,8.774869109947645,2,13,25,166
5.7133463973472294e+17,43,294,6.837209302325581,3,9,29,14
5.7138135742244205e+17,106,957,9.028301886792454,2,12,17,89
5.714335287012994e+17,30,55,1.8333333333333333,1,4,30,0
5.714339646542657e+17,75,291,3.88,2,7,75,0
5.715376191948079e+17,91,192,2.10989010989011,1,4,91,0
5.7157948071784435e+17,119,931,7.823529411764706,2,11,40,79
5.716932683440033e+17,25,58,2.32,1,4,25,0
5.721560658844269e+17,18,23,1.2777777777777777,1,3,18,0
5.721638675276729e+17,114,882,7.7368421052631575,2,11,37,77
5.7217747754235437e+17,26,36,1.3846153846153846,1,3,26,0
5.721924906875432e+17,116,791,6.818965517241379,3,9,79,37
5.72205778663504e+17,33,51,1.5454545454545454,1,5,33,0
5.722172275436305e+17,46,71,1.5434782608695652,1,4,46,0
5.722236550739712e+17,30,45,1.5,1,3,30,0
5.722269012599967e+17,18,26,1.4444444444444444,1,3,18,0
5.722306768182746e+17,2,12,6.0,5,7,2,0
5.7223449332119725e+17,80,399,4.9875,2,7,80,0
5.722418217401777e+17,1,1,1.0,1,1,1,0
5.722620783685036e+17,35,78,2.2285714285714286,1,4,35,0
5.7230992958673965e+17,1,5,5.0,5,5,1,0
5.723829413292162e+17,7,47,6.714285714285714,4,8,5,2
5.725466541141679e+17,29,189,6.517241379310345,2,9,25,4
5.7256854907112416e+17,32,220,6.875,2,10,24,8
5.728196484332853e+17,67,637,9.507462686567164,4,13,5,62
5.728390698583446e+17,35,352,10.057142857142857,6,13,1,34
5.72865287334433e+17,8,15,1.875,1,3,8,0
5.729377360307598e+17,3,4,1.3333333333333333,1,2,3,0
5.7294938230122125e+17,65,505,7.769230769230769,4,10,24,41
5.729883432769053e+17,2,7,3.5,3,4,2,0
5.730231923097899e+17,11,91,8.272727272727273,7,9,2,9
5.73076048790765e+17,24,121,5.041666666666667,3,8,23,1
5.730965539633012e+17,1,2,2.0,2,2,1,0
5.732233661679879e+17,170,351,2.0647058823529414,1,4,170,0
5.732272056990996e+17,25,235,9.4,7,11,2,23
5.7348039427580096e+17,5,33,6.6,6,8,4,1
5.7351661326064096e+17,33,222,6.7272727272727275,4,9,25,8
5.7362571995553715e+17,403,1208,2.997518610421836,1,6,403,0
5.7367565919215296e+17,78,312,4.0,2,6,78,0
5.73722467462301e+17,18,176,9.777777777777779,6,12,1,17
5.7372828026516e+17,50,197,3.94,2,6,50,0
5.7373794076655955e+17,9,45,5.0,5,5,9,0
5.739031950509587e+17,28,138,4.928571428571429,3,6,28,0
5.739708922899383e+17,87,598,6.873563218390805,2,9,60,27
5.7399071440888826e+17,135,1309,9.696296296296296,2,12,7,128
5.743360255813767e+17,89,607,6.820224719101123,2,9,66,23
5.743612966263474e+17,176,1252,7.113636363636363,3,10,108,68
5.743647954068947e+17,8,58,7.25,6,9,5,3
5.7445379903887514e+17,43,91,2.116279069767442,1,4,43,0
5.745071937795704e+17,9,50,5.555555555555555,5,6,9,0
5.745737313286699e+17,66,139,2.106060606060606,1,4,66,0
5.7460192104191846e+17,55,118,2.1454545454545455,1,4,55,0
5.7462086499477856e+17,100,785,7.85,3,10,36,64
5.746316877800523e+17,2,3,1.5,1,2,2,0
5.7495748936397216e+17,16,49,3.0625,2,5,16,0
5.7504625491953606e+17,133,508,3.819548872180451,2,6,133,0
5.750790164361047e+17,52,112,2.1538461538461537,1,4,52,0
5.7510533402788154e+17,56,517,9.232142857142858,2,12,4,52
5.7513860458500595e+17,1,1,1.0,1,1,1,0
5.75185651387757e+17,30,58,1.9333333333333333,1,4,30,0
5.7523426346486035e+17,107,202,1.8878504672897196,1,4,107,0
5.752697860279615e+17,57,161,2.824561403508772,1,5,57,0
5.752947258791656e+17,91,432,4.747252747252747,1,7,91,0
5.754421097369547e+17,46,356,7.739130434782608,2,10,16,30
5.7567826035837184e+17,147,1018,6.925170068027211,3,9,106,41
5.76062863242854e+17,11,102,9.272727272727273,2,12,1,10
5.761061699388105e+17,89,189,2.1235955056179776,1,5,89,0
5.761428532432704e+17,214,296,1.3831775700934579,1,4,214,0
5.772409071733e+17,25,165,6.6,2,9,18,7
5.772544726771703e+17,91,282,3.098901098901099,1,5,91,0
5.772962048658213e+17,85,159,1.8705882352941177,1,4,85,0
5.772962284042916e+17,77,149,1.9350649350649352,1,4,77,0
5.773099260082694e+17,105,895,8.523809523809524,2,11,17,88
5.773875615539818e+17,76,157,2.0657894736842106,1,4,76,0
5.774015797963048e+17,98,215,2.193877551020408,1,6,98,0
5.774048646790671e+17,2,3,1.5,1,2,2,0
5.774716634817028e+17,74,364,4.918918918918919,2,7,74,0
5.775266639624161e+17,176,877,4.982954545454546,2,9,174,2
5.779024373691752e+17,78,164,2.1025641025641026,1,4,78,0
5.7793199456307e+17,5,15,3.0,1,5,5,0
5.77932340637783e+17,71,147,2.0704225352112675,1,5,71,0
5.779336436950586e+17,16,76,4.75,3,6,16,0
5.779507084028019e+17,35,251,7.171428571428572,4,9,24,11
5.779605474514627e+17,123,273,2.2195121951219514,1,4,123,0
5.779775344267293e+17,6,41,6.833333333333333,5,8,4,2
5.780020040787128e+17,80,413,5.1625,2,7,80,0
5.780532708970831e+17,3,29,9.666666666666666,9,10,0,3
5.780766056723144e+17,1,4,4.0,4,4,1,0
5.780904609664942e+17,74,366,4.945945945945946,2,8,73,1
5.78103213747268e+17,7,22,3.142857142857143,1,4,7,0
5.781416072954883e+17,80,244,3.05,1,6,80,0
5.781718030794304e+17,2,5,2.5,2,3,2,0
5.78259073716266e+17,50,107,2.14,1,5,50,0
5.7829311086756e+17,25,170,6.8,5,9,20,5
5.784106968902281e+17,14,48,3.4285714285714284,2,5,14,0
5.786801595746354e+17,68,333,4.897058823529412,2,7,68,0
5.787897824288408e+17,131,1276,9.740458015267176,2,13,7,124
5.787910493709019e+17,10,29,2.9,2,4,10,0
5.788468493980054e+17,69,327,4.739130434782608,2,7,69,0
5.788684706159794e+17,14,26,1.8571428571428572,1,4,14,0
5.788798959876637e+17,122,597,4.89344262295082,2,8,121,1
5.788965788412428e+17,2,6,3.0,3,3,2,0
5.789553501618762e+17,185,1284,6.940540540540541,2,10,125,60
5.79024453928899e+17,7,49,7.0,6,8,4,3
5.794850829455665e+17,60,293,4.883333333333334,2,7,60,0
5.795872737024443e+17,117,572,4.888888888888889,2,7,117,0
5.796627036761871e+17,21,100,4.761904761904762,3,7,21,0
5.79705680354363e+17,7,33,4.714285714285714,3,6,7,0
5.798100475009437e+17,284,2757,9.70774647887324,2,13,17,267
5.798453333227855e+17,39,70,1.794871794871795,1,3,39,0
5.801100098317752e+17,78,770,9.871794871794872,2,12,6,72
5.801438277953637e+17,4,29,7.25,6,8,2,2
5.80376212736072e+17,14,95,6.785714285714286,5,9,10,4
5.80396641948037e+17,1,4,4.0,4,4,1,0
5.804530342714683e+17,65,621,9.553846153846154,2,12,4,61
5.804583622076397e+17,182,381,2.0934065934065935,1,4,182,0
5.809080757502387e+17,189,1292,6.835978835978836,2,10,137,52
5.809664181056448e+17,3,23,7.666666666666667,7,8,1,2
5.811646419690601e+17,75,728,9.706666666666667,2,13,4,71
5.812136637810752e+17,23,168,7.304347826086956,5,10,12,11
5.816309360137219e+17,37,77,2.081081081081081,1,4,37,0
5.816777468903726e+17,40,81,2.025,1,4,40,0
5.817174825530364e+17,2,8,4.0,4,4,2,0
5.818222848483743e+17,40,188,4.7,3,8,39,1
5.818346101991521e+17,54,81,1.5,1,3,54,0
5.820045894655994e+17,47,333,7.085106382978723,5,9,30,17
5.82236385224243e+17,35,47,1.3428571428571427,1,3,35,0
5.82263775881355e+17,40,118,2.95,1,5,40,0
5.822712099202666e+17,96,205,2.1354166666666665,1,5,96,0
5.823607239634648e+17,45,390,8.666666666666666,2,11,5,40
5.823910401365883e+17,8,15,1.875,1,4,8,0
5.82415237924878e+17,11,97,8.818181818181818,7,10,1,10
5.824207241877809e+17,84,344,4.095238095238095,2,6,84,0
5.824230385951475e+17,154,596,3.8701298701298703,1,6,154,0
5.824471905303427e+17,56,541,9.660714285714286,3,12,4,52
5.824903302732887e+17,91,382,4.197802197802198,2,7,91,0
5.82498237782067e+17,93,919,9.881720430107526,6,12,2,91
5.82614149243365e+17,71,685,9.647887323943662,3,12,4,67
5.826455288697326e+17,30,206,6.866666666666666,4,9,22,8
5.82922370774628e+17,144,719,4.993055555555555,1,8,142,2
5.829819284527359e+17,7,16,2.2857142857142856,1,4,7,0
5.830202887275608e+17,52,251,4.826923076923077,2,7,52,0
5.830727908924142e+17,139,297,2.1366906474820144,1,4,139,0
5.83107803291739e+17,24,48,2.0,1,5,24,0
5.832076118719507e+17,154,613,3.9805194805194803,1,7,154,0
5.833843556501516e+17,7,44,6.285714285714286,5,8,6,1
5.834309834001617e+17,32,217,6.78125,3,9,22,10
5.835047625073311e+17,130,272,2.0923076923076924,1,5,130,0
5.836556259699731e+17,41,118,2.8780487804878048,1,6,41,0
5.836643860960406e+17,28,82,2.9285714285714284,1,5,28,0
5.836703698762682e+17,4,13,3.25,2,4,4,0
5.837556862714292e+17,72,220,3.0555555555555554,1,5,72,0
5.837583583314807e+17,85,580,6.823529411764706,2,10,68,17
5.837587322238409e+17,93,635,6.827956989247312,3,9,63,30
5.837660927086843e+17,10,33,3.3,2,5,10,0
5.837973333068052e+17,16,34,2.125,1,4,16,0
5.837975713202971e+17,39,88,2.2564102564102564,1,4,39,0
5.837976524141585e+17,16,25,1.5625,1,4,16,0
5.838616009274432e+17,90,691,7.677777777777778,2,11,36,54
5.839004035718578e+17,56,439,7.839285714285714,2,12,14,42
5.839102194473165e+17,19,141,7.421052631578948,2,10,9,10
5.839117069077103e+17,101,961,9.514851485148515,2,12,8,93
5.839406432351805e+17,14,131,9.357142857142858,5,11,1,13
5.840577667332956e+17,61,464,7.60655737704918,2,10,21,40
5.841435213547199e+17,14,73,5.214285714285714,3,7,14,0
5.844796953948915e+17,23,43,1.8695652173913044,1,3,23,0
5.845501296066141e+17,5,46,9.2,9,10,0,5
5.845727258916741e+17,1,1,1.0,1,1,1,0
5.845743560106577e+17,18,37,2.0555555555555554,1,4,18,0
5.845791615729009e+17,8,51,6.375,3,8,6,2
5.845965997835172e+17,21,58,2.761904761904762,1,4,21,0
5.846197227165322e+17,17,36,2.1176470588235294,1,4,17,0
5.84626350957487e+17,112,444,3.9642857142857144,1,6,112,0
5.846464782665683e+17,1,2,2.0,2,2,1,0
5.84682034491832e+17,13,20,1.5384615384615385,1,3,13,0
5.847500451423982e+17,31,59,1.903225806451613,1,4,31,0
5.847939558223766e+17,143,434,3.034965034965035,1,5,143,0
5.849206451819407e+17,1,1,1.0,1,1,1,0
5.849731393725783e+17,192,396,2.0625,1,5,192,0
5.850642726542579e+17,75,152,2.026666666666667,1,4,75,0
5.851420146739492e+17,22,177,8.045454545454545,3,10,5,17
5.851627275103594e+17,6,16,2.6666666666666665,1,4,6,0
5.851687697667153e+17,2,3,1.5,1,2,2,0
5.851785325287409e+17,102,717,7.029411764705882,2,10,63,39
5.851976838359121e+17,73,378,5.178082191780822,3,8,72,1
5.852199397117687e+17,16,75,4.6875,3,7,16,0
5.852418839492444e+17,110,550,5.0,3,7,110,0
5.85243455087832e+17,5,18,3.6,3,4,5,0
5.859452691205862e+17,82,814,9.926829268292684,3,13,3,79
5.859881745097617e+17,29,285,9.827586206896552,2,12,1,28
5.862007305768278e+17,148,284,1.9189189189189189,1,4,148,0
5.862815053098817e+17,4,33,8.25,7,10,2,2
5.867355662343401e+17,23,151,6.565217391304348,3,8,19,4
5.867759091635288e+17,79,298,3.7721518987341773,2,6,79,0
5.867794882553989e+17,32,315,9.84375,3,12,1,31
5.868150330815055e+17,13,27,2.076923076923077,1,3,13,0
5.868170498740059e+17,97,933,9.618556701030927,2,13,4,93
5.869651192444308e+17,95,377,3.968421052631579,1,6,95,0
5.870164987538262e+17,178,384,2.157303370786517,1,5,178,0
5.870498373877725e+17,177,362,2.0451977401129944,1,4,177,0
5.873514680139276e+17,27,137,5.074074074074074,3,7,27,0
5.874123182692812e+17,1,4,4.0,4,4,1,0
5.874395954074657e+17,31,91,2.935483870967742,1,5,31,0
5.874509419243052e+17,16,108,6.75,2,9,10,6
5.874570899010836e+17,16,20,1.25,1,2,16,0
5.874571945304521e+17,7,53,7.571428571428571,7,8,3,4
5.874720922298604e+17,4,7,1.75,1,3,4,0
5.875309531159741e+17,20,30,1.5,1,3,20,0
5.875452269706235e+17,4,13,3.25,2,5,4,0
5.875911383879457e+17,3,25,8.333333333333334,8,9,0,3
5.87839801886903e+17,76,658,8.657894736842104,2,11,10,66
5.880268837102309e+17,5,46,9.2,7,11,1,4
5.880278801470477e+17,2,18,9.0,9,9,0,2
5.880808851292947e+17,8,15,1.875,1,4,8,0
5.882173080333673e+17,22,148,6.7272727272727275,3,8,18,4
5.882682346968691e+17,44,433,9.840909090909092,4,12,2,42
5.882747925047716e+17,48,99,2.0625,1,5,48,0
5.882990341730131e+17,189,378,2.0,1,4,189,0
5.883047311282205e+17,107,204,1.9065420560747663,1,4,107,0
5.883251378114642e+17,10,16,1.6,1,3,10,0
5.883636524961651e+17,51,489,9.588235294117647,3,12,4,47
5.884493452105412e+17,154,303,1.9675324675324675,1,5,154,0
5.884894384018687e+17,67,454,6.776119402985074,2,9,51,16
5.885191704775154e+17,5,38,7.6,6,9,2,3
5.889045865655574e+17,11,23,2.090909090909091,1,3,11,0
5.88947571810397e+17,16,128,8.0,7,9,4,12
5.890526289059091e+17,12,81,6.75,5,9,9,3
5.890661938747064e+17,42,381,9.071428571428571,3,12,7,35
5.89090613219454e+17,39,79,2.0256410256410255,1,3,39,0
5.891119413312627e+17,25,47,1.88,1,3,25,0
5.892241268328274e+17,126,857,6.801587301587301,3,9,89,37
5.892718851119603e+17,161,1531,9.509316770186336,2,13,15,146
5.895927092787305e+17,22,45,2.0454545454545454,1,3,22,0
5.89614060330806e+17,8,26,3.25,2,5,8,0
5.896307089393748e+17,61,133,2.180327868852459,1,4,61,0
5.896376432202093e+17,208,2031,9.764423076923077,3,12,9,199
5.896903497412623e+17,218,1302,5.972477064220183,2,8,201,17
5.898071880482437e+17,201,598,2.9751243781094527,1,6,201,0
5.89846831605071e+17,116,789,6.801724137931035,3,10,81,35
5.899633913756416e+17,48,323,6.729166666666667,2,10,38,10
5.903500329311624e+17,25,204,8.16,6,11,8,17
5.903971043391133e+17,1,2,2.0,2,2,1,0
5.905581528024951e+17,38,87,2.289473684210526,1,5,38,0
5.905624119765379e+17,74,513,6.9324324324324325,4,9,50,24
5.905972655239319e+17,52,204,3.923076923076923,2,6,52,0
5.906109502668936e+17,8,24,3.0,2,5,8,0
5.907243211856749e+17,3,8,2.6666666666666665,2,3,3,0
5.910933622578744e+17,153,886,5.790849673202614,2,8,148,5
5.911399331443423e+17,257,1475,5.739299610894942,2,9,247,10
5.911525556072842e+17,189,1115,5.8994708994708995,2,9,179,10
5.912792781934621e+17,58,509,8.775862068965518,5,11,7,51
5.913521969416699e+17,114,570,5.0,2,7,114,0
5.916816524816554e+17,68,670,9.852941176470589,4,12,4,64
5.917617954531703e+17,131,1241,9.473282442748092,2,12,11,120
5.918529696786287e+17,67,337,5.029850746268656,3,8,65,2
5.919231314219794e+17,48,235,4.895833333333333,2,7,48,0
5.919277533332567e+17,8,19,2.375,1,3,8,0
5.919456060835063e+17,240,2317,9.654166666666667,2,12,13,227
5.919708558594157e+17,177,884,4.994350282485875,2,7,177,0
5.920493826929125e+17,132,262,1.9848484848484849,1,4,132,0
5.921364489729765e+17,5,8,1.6,1,2,5,0
5.924306044196566e+17,82,181,2.207317073170732,1,4,82,0
5.924437503547739e+17,21,185,8.80952380952381,6,12,4,17
5.924641985624256e+17,31,213,6.870967741935484,5,9,22,9
5.924903525964224e+17,20,158,7.9,6,10,8,12
5.925428934047126e+17,61,548,8.98360655737705,6,12,4,57
5.92587396555893e+17,47,137,2.9148936170212765,1,6,47,0
5.926260205287825e+17,101,206,2.0396039603960396,1,4,101,0
5.927393646754218e+17,186,913,4.908602150537634,3,8,184,2
5.927975042710065e+17,14,111,7.928571428571429,6,10,5,9
5.932319368796526e+17,167,491,2.940119760479042,1,5,167,0
5.933357003025993e+17,15,43,2.8666666666666667,1,5,15,0
5.933399785123437e+17,169,1342,7.940828402366864,2,11,55,114
5.933494781215476e+17,40,160,4.0,2,6,40,0
5.933727940884979e+17,74,220,2.972972972972973,1,6,74,0
5.934459955953764e+17,48,237,4.9375,2,7,48,0
5.939337728814936e+17,3,18,6.0,5,7,3,0
5.940037010521969e+17,1,11,11.0,11,11,0,1
5.940183565050478e+17,117,801,6.846153846153846,3,10,88,29
5.941750201364385e+17,84,414,4.928571428571429,2,7,84,0
5.942031708559078e+17,178,365,2.050561797752809,1,5,178,0
5.942316622549016e+17,19,63,3.3157894736842106,1,5,19,0
5.944262741732041e+17,43,57,1.3255813953488371,1,2,43,0
5.945833583432964e+17,35,340,9.714285714285714,5,12,3,32
5.946765049548472e+17,2,5,2.5,1,4,2,0
5.946860880469725e+17,50,254,5.08,3,7,50,0
5.946907028015675e+17,225,1132,5.0311111111111115,2,7,225,0
5.947979554330587e+17,21,45,2.142857142857143,1,4,21,0
5.94823047101764e+17,36,231,6.416666666666667,2,9,28,8
5.948717444076339e+17,7,70,10.0,9,11,0,7
5.949178179765795e+17,55,525,9.545454545454545,3,12,3,52
5.949519731609823e+17,17,45,2.6470588235294117,1,5,17,0
5.953264697293827e+17,130,863,6.638461538461539,2,9,95,35
5.953383494913752e+17,70,610,8.714285714285714,3,11,8,62
5.953565527369208e+17,2,6,3.0,3,3,2,0
5.953835964687685e+17,49,477,9.73469387755102,3,12,4,45
5.954185960220877e+17,137,539,3.934306569343066,1,6,137,0
5.954201195448748e+17,74,155,2.0945945945945947,1,4,74,0
5.95515095794353e+17,1,2,2.0,2,2,1,0
5.955503090705957e+17,147,303,2.061224489795918,1,5,147,0
5.955725355829499e+17,244,1255,5.14344262295082,3,9,240,4
5.9559120207158e+17,61,541,8.868852459016393,3,11,6,55
5.956121301523489e+17,15,27,1.8,1,3,15,0
5.956382299228768e+17,1,2,2.0,2,2,1,0
5.956855825370033e+17,86,170,1.9767441860465116,1,4,86,0
5.957141086501039e+17,70,155,2.2142857142857144,1,5,70,0
5.957736813504234e+17,386,1902,4.927461139896373,2,8,384,2
5.96036844466719e+17,36,249,6.916666666666667,2,10,27,9
5.962126783488483e+17,12,81,6.75,5,8,9,3
5.96232384930086e+17,2,3,1.5,1,2,2,0
5.962352126837375e+17,7,16,2.2857142857142856,1,3,7,0
5.96274160627416e+17,45,405,9.0,2,12,6,39
5.962850034645299e+17,37,50,1.3513513513513513,1,3,37,0
5.963195386643741e+17,53,100,1.8867924528301887,1,4,53,0
5.966727585751525e+17,12,69,5.75,4,7,12,0
5.96719514901673e+17,193,750,3.8860103626943006,1,6,193,0
5.967609501322601e+17,11,85,7.7272727272727275,6,10,5,6
5.968825941527062e+17,3,14,4.666666666666667,4,5,3,0
5.969145108932353e+17,78,684,8.76923076923077,3,12,7,71
5.969295607047852e+17,20,41,2.05,1,3,20,0
5.970276721379515e+17,39,199,5.102564102564102,2,7,39,0
5.970294617954085e+17,61,297,4.868852459016393,3,8,60,1
5.97046362786794e+17,137,285,2.0802919708029197,1,5,137,0
5.971653218268573e+17,115,459,3.991304347826087,2,7,115,0
5.974500520437285e+17,97,787,8.11340206185567,3,10,27,70
5.974547118555177e+17,32,225,7.03125,2,10,19,13
5.974667569009588e+17,1,3,3.0,3,3,1,0
5.974820817630989e+17,62,315,5.080645161290323,3,9,61,1
5.975333961727764e+17,120,164,1.3666666666666667,1,4,120,0
5.975395699720835e+17,9,65,7.222222222222222,6,9,7,2
5.976374458446694e+17,1,3,3.0,3,3,1,0
5.976440069193846e+17,1,5,5.0,5,5,1,0
5.976646536570929e+17,101,497,4.920792079207921,2,7,101,0
5.976989034719639e+17,39,333,8.538461538461538,4,11,7,32
5.977299984417978e+17,47,321,6.829787234042553,3,11,34,13
5.977600689999278e+17,4,6,1.5,1,2,4,0
5.9784146513976e+17,248,1226,4.943548387096774,2,8,245,3
5.978755723432544e+17,177,1706,9.638418079096045,2,13,7,170
5.981396909012439e+17,6,13,2.1666666666666665,1,3,6,0
5.981437537110104e+17,7,15,2.142857142857143,1,4,7,0
5.982371533084087e+17,20,92,4.6,2,7,20,0
5.982399891049843e+17,91,265,2.912087912087912,1,5,91,0
5.982403774449981e+17,3,12,4.0,3,5,3,0
5.982775439392826e+17,35,232,6.628571428571429,2,8,27,8
5.982918782937463e+17,155,299,1.929032258064516,1,5,155,0
5.983065032154953e+17,55,534,9.709090909090909,3,12,3,52
5.983257438857893e+17,28,162,5.785714285714286,2,8,27,1
5.983335214638583e+17,105,840,8.0,2,10,26,79
5.983344799683731e+17,4,34,8.5,7,10,1,3
5.983630529624435e+17,10,75,7.5,4,10,3,7
5.983843474380544e+17,29,278,9.586206896551724,3,13,4,25
5.983960312544832e+17,88,183,2.0795454545454546,1,4,88,0
5.983986341911388e+17,1,3,3.0,3,3,1,0
5.984137060056966e+17,72,149,2.0694444444444446,1,4,72,0
5.984625869203244e+17,62,121,1.9516129032258065,1,4,62,0
5.985092861342022e+17,106,227,2.141509433962264,1,4,106,0
5.985298061820462e+17,137,549,4.007299270072993,1,7,137,0
5.985442734043589e+17,260,1009,3.8807692307692307,1,7,260,0
5.985733458968567e+17,55,111,2.018181818181818,1,4,55,0
5.985752219259457e+17,323,1588,4.91640866873065,2,7,323,0
5.986000152078182e+17,4,22,5.5,5,6,4,0
5.986131882738771e+17,112,431,3.8482142857142856,1,7,112,0
5.987454007673297e+17,40,269,6.725,2,9,29,11
5.988867219104526e+17,3,9,3.0,2,4,3,0
5.98889862804476e+17,14,21,1.5,1,3,14,0
5.989170449265974e+17,43,87,2.0232558139534884,1,5,43,0
5.989199952183446e+17,97,200,2.0618556701030926,1,4,97,0
5.98935493844049e+17,21,201,9.571428571428571,6,12,1,20
5.989642516886127e+17,21,85,4.0476190476190474,2,5,21,0
5.989715071295327e+17,22,112,5.090909090909091,3,7,22,0
5.989890087394794e+17,2,12,6.0,5,7,2,0
5.990543416471528e+17,84,413,4.916666666666667,2,7,84,0
5.990892137281325e+17,75,168,2.24,1,5,75,0
5.99211191881186e+17,15,156,10.4,9,12,0,15
5.992293424823891e+17,33,202,6.121212121212121,3,8,30,3
5.995749853357628e+17,107,537,5.018691588785047,2,8,106,1
5.996297665611176e+17,44,213,4.840909090909091,2,6,44,0
5.99676119385329e+17,93,186,2.0,1,4,93,0
5.996909236771379e+17,48,101,2.1041666666666665,1,5,48,0
5.996918011164476e+17,49,237,4.836734693877551,2,7,49,0
5.99696908752425e+17,66,217,3.287878787878788,1,6,66,0
5.997160924762212e+17,14,97,6.928571428571429,4,9,10,4
5.99815876214706e+17,217,845,3.8940092165898617,1,7,217,0
5.998707779705423e+17,84,120,1.4285714285714286,1,3,84,0
5.998926912752506e+17,156,608,3.8974358974358974,1,7,156,0
5.998933571319656e+17,199,584,2.9346733668341707,1,6,199,0
5.998998417141568e+17,182,710,3.901098901098901,1,7,182,0
5.999352874707721e+17,11,35,3.1818181818181817,1,5,11,0
5.999697790782528e+17,1,9,9.0,9,9,0,1
5.999916784848517e+17,31,73,2.3548387096774195,1,5,31,0
5.999947156469386e+17,11,29,2.6363636363636362,2,4,11,0
6.000022185480056e+17,53,111,2.0943396226415096,1,5,53,0
6.000181676458956e+17,58,125,2.1551724137931036,1,5,58,0
6.00050171429521e+17,37,249,6.72972972972973,3,10,29,8
6.000511472825373e+17,32,50,1.5625,1,4,32,0
6.000519755294874e+17,174,330,1.896551724137931,1,5,174,0
6.000558139665581e+17,6,12,2.0,1,5,6,0
6.002647713477718e+17,84,408,4.857142857142857,2,8,83,1
6.003459648087214e+17,68,96,1.411764705882353,1,3,68,0
6.003689397146175e+17,376,779,2.0718085106382977,1,5,376,0
6.003985817417889e+17,103,132,1.2815533980582525,1,3,103,0
6.003992897822028e+17,10,36,3.6,1,6,10,0
6.004238263287932e+17,32,35,1.09375,1,2,32,0
6.004248205356782e+17,115,461,4.008695652173913,2,7,115,0
6.004507654022875e+17,2,4,2.0,1,3,2,0
6.004746859777135e+17,3,7,2.3333333333333335,2,3,3,0
6.004933848975854e+17,103,203,1.970873786407767,1,4,103,0
6.00502267658652e+17,202,1383,6.846534653465347,2,10,145,57
6.005256427128556e+17,19,147,7.7368421052631575,4,10,8,11
6.005522778238327e+17,43,60,1.3953488372093024,1,3,43,0
6.006505161081715e+17,21,200,9.523809523809524,3,12,1,20
6.006648039313179e+17,108,414,3.8333333333333335,1,6,108,0
6.006775314955616e+17,165,333,2.018181818181818,1,5,165,0
6.006856695774661e+17,19,123,6.473684210526316,3,8,15,4
6.00786677931689e+17,100,883,8.83,2,11,11,89
6.007899126301189e+17,30,40,1.3333333333333333,1,3,30,0
6.008272082197329e+17,76,679,8.93421052631579,2,12,8,68
6.010411428852247e+17,66,457,6.924242424242424,5,9,44,22
6.010991348212796e+17,68,210,3.088235294117647,1,6,68,0
6.011919517700316e+17,2,5,2.5,2,3,2,0
6.013860028260782e+17,3,30,10.0,9,11,0,3
6.014180886122001e+17,108,507,4.694444444444445,2,7,108,0
6.015019613534999e+17,111,541,4.873873873873874,2,7,111,0
6.015229476324599e+17,7,60,8.571428571428571,6,10,2,5
6.018020901606877e+17,21,161,7.666666666666667,3,10,7,14
6.01953447214628e+17,16,116,7.25,6,9,9,7
6.020031469003404e+17,89,693,7.786516853932584,2,11,42,47
6.020718323602915e+17,38,44,1.1578947368421053,1,4,38,0
6.020724308188294e+17,97,287,2.9587628865979383,1,5,97,0
6.021093976398519e+17,63,130,2.0634920634920637,1,4,63,0
6.025913368914308e+17,101,207,2.0495049504950495,1,4,101,0
6.02623525093862e+17,22,146,6.636363636363637,2,9,16,6
6.026404154575113e+17,86,589,6.848837209302325,2,10,58,28
6.027301786494008e+17,1,3,3.0,3,3,1,0
6.027936343758707e+17,105,516,4.914285714285715,3,7,105,0
6.028012104525722e+17,86,177,2.058139534883721,1,4,86,0
6.028602492436335e+17,31,36,1.1612903225806452,1,2,31,0
6.032389112040927e+17,2,4,2.0,1,3,2,0
6.033385384255049e+17,43,381,8.86046511627907,7,11,6,37
6.03371397867203e+17,9,62,6.888888888888889,5,9,7,2
6.034034762854547e+17,1,3,3.0,3,3,1,0
6.034431551463552e+17,39,162,4.153846153846154,2,7,39,0
6.034831281121514e+17,4,7,1.75,1,2,4,0
6.034842025830412e+17,173,1167,6.745664739884393,2,9,131,42
6.034973663936072e+17,13,64,4.923076923076923,3,6,13,0
6.034987585131631e+17,135,937,6.940740740740741,4,9,95,40
6.03587658288964e+17,48,242,5.041666666666667,2,7,48,0
6.035924666843286e+17,214,1843,8.61214953271028,2,13,26,188
6.036695337588612e+17,41,90,2.1951219512195124,1,4,41,0
6.037098398375252e+17,4,26,6.5,6,7,4,0
6.03977719875166e+17,11,59,5.363636363636363,4,7,11,0
6.040010393411681e+17,5,13,2.6,2,3,5,0
6.040398611180425e+17,2,5,2.5,2,3,2,0
6.040440871300959e+17,42,122,2.9047619047619047,1,4,42,0
6.040923074980763e+17,159,935,5.880503144654088,2,9,146,13
6.041089356561932e+17,1,2,2.0,2,2,1,0
6.041192398304064e+17,29,82,2.8275862068965516,1,5,29,0
6.041427292919452e+17,26,185,7.115384615384615,5,9,16,10
6.041869237745083e+17,31,289,9.32258064516129,2,12,2,29
6.041967159230303e+17,3,10,3.3333333333333335,3,4,3,0
6.042056822252872e+17,29,118,4.068965517241379,2,6,29,0
6.042671825332621e+17,61,409,6.704918032786885,2,9,49,12
6.042870558793402e+17,62,314,5.064516129032258,2,7,62,0
6.042898820868925e+17,58,347,5.982758620689655,2,9,53,5
6.043718849603793e+17,127,1002,7.889763779527559,2,10,39,88
6.044490485254328e+17,46,60,1.3043478260869565,1,3,46,0
6.044506873285874e+17,34,230,6.764705882352941,2,9,26,8
6.047325568002751e+17,184,744,4.043478260869565,2,7,184,0
6.047392379814337e+17,47,333,7.085106382978723,4,9,26,21
6.047527914495406e+17,97,644,6.639175257731959,2,10,72,25
6.048218443008641e+17,1,9,9.0,9,9,0,1
6.048449891561172e+17,43,294,6.837209302325581,2,9,30,13
6.048678456958095e+17,6,47,7.833333333333333,7,9,2,4
6.048974664651414e+17,123,371,3.016260162601626,1,6,123,0
6.050121234990458e+17,220,896,4.072727272727272,1,7,220,0
6.050648375784584e+17,46,94,2.0434782608695654,1,4,46,0
6.053956873267684e+17,6,43,7.166666666666667,6,8,3,3
6.054930753626176e+17,19,128,6.7368421052631575,4,9,13,6
6.055257882985389e+17,7,50,7.142857142857143,6,9,5,2
6.055555874076925e+17,38,322,8.473684210526315,4,11,8,30
6.056091306205915e+17,10,96,9.6,7,12,1,9
6.056356378477409e+17,20,28,1.4,1,4,20,0
6.063296317814611e+17,43,372,8.651162790697674,5,12,7,36
6.063849373958117e+17,5,16,3.2,1,6,5,0
6.066175953799434e+17,67,249,3.716417910447761,2,6,67,0
6.066330345841724e+17,7,49,7.0,6,8,6,1
6.068646950434102e+17,89,287,3.2247191011235956,1,6,89,0
6.069651530252369e+17,2,17,8.5,8,9,0,2
6.070142175794281e+17,29,57,1.9655172413793103,1,4,29,0
6.070292131921719e+17,94,359,3.8191489361702127,2,6,94,0
6.070338668584904e+17,39,347,8.897435897435898,7,11,6,33
6.07033878554284e+17,21,46,2.1904761904761907,1,4,21,0
6.070722334514657e+17,29,70,2.413793103448276,1,5,29,0
6.07106040771866e+17,215,1684,7.832558139534884,2,11,74,141
6.071387581239195e+17,192,943,4.911458333333333,2,7,192,0
6.071396832278395e+17,7,13,1.8571428571428572,1,3,7,0
6.071464360137071e+17,4,8,2.0,1,3,4,0
6.0716792112706e+17,108,1054,9.75925925925926,2,12,6,102
6.071974036447323e+17,22,109,4.954545454545454,3,7,22,0
6.076045054284058e+17,4,10,2.5,2,3,4,0
6.076540880177569e+17,146,734,5.027397260273973,2,9,145,1
6.076560642516472e+17,4,27,6.75,6,8,3,1
6.076922685305114e+17,93,382,4.10752688172043,2,6,93,0
6.076957454637487e+17,10,25,2.5,1,4,10,0
6.077199179688801e+17,188,369,1.9627659574468086,1,5,188,0
6.077325690039332e+17,92,889,9.66304347826087,4,13,6,86
6.077996162475136e+17,63,319,5.063492063492063,2,7,63,0
6.078153990765745e+17,6,13,2.1666666666666665,1,3,6,0
6.078501683456454e+17,124,841,6.782258064516129,2,9,89,35
6.078517094306203e+17,61,127,2.081967213114754,1,5,61,0
6.078695126884644e+17,47,103,2.1914893617021276,1,5,47,0
6.079338922739068e+17,17,27,1.588235294117647,1,3,17,0
6.08042923458045e+17,116,240,2.0689655172413794,1,5,116,0
6.082192235466171e+17,105,703,6.695238095238095,3,9,76,29
6.082873521656902e+17,48,378,7.875,3,10,15,33
6.084646825857151e+17,35,181,5.171428571428572,3,8,34,1
6.085588484414755e+17,6,22,3.6666666666666665,2,5,6,0
6.085863144164229e+17,29,59,2.0344827586206895,1,5,29,0
6.086334694023396e+17,55,558,10.145454545454545,8,13,0,55
6.086723453395793e+17,187,941,5.032085561497326,2,8,185,2
6.08712015041799e+17,235,505,2.148936170212766,1,5,235,0
6.087250699637509e+17,116,804,6.931034482758621,2,10,76,40
6.087265122346232e+17,153,753,4.921568627450981,2,8,151,2
6.090662199430417e+17,6,30,5.0,3,6,6,0
6.091478266624077e+17,32,222,6.9375,2,9,15,17
6.091719693070231e+17,30,139,4.633333333333334,3,7,30,0
6.09422492739767e+17,97,658,6.783505154639175,2,9,65,32
6.094244080806554e+17,109,320,2.9357798165137616,1,5,109,0
6.095182726800969e+17,12,23,1.9166666666666667,1,4,12,0
6.09704767799544e+17,97,571,5.88659793814433,3,8,90,7
6.097574654054886e+17,6,46,7.666666666666667,7,8,2,4
6.098786832666017e+17,6,42,7.0,6,8,5,1
6.098787659795227e+17,25,200,8.0,4,10,4,21
6.09907872964922e+17,17,50,2.9411764705882355,1,5,17,0
6.099124506236402e+17,19,26,1.368421052631579,1,3,19,0
6.099279059809869e+17,126,389,3.0873015873015874,1,7,126,0
6.099381170934596e+17,60,230,3.8333333333333335,2,7,60,0
6.09984316266369e+17,163,1584,9.717791411042946,3,13,9,154
6.10028747822377e+17,275,809,2.941818181818182,1,5,275,0
6.100302106469809e+17,81,402,4.962962962962963,2,7,81,0
6.100694408010309e+17,16,47,2.9375,1,5,16,0
6.100850155735814e+17,147,1418,9.646258503401361,2,12,8,139
6.101292600670764e+17,60,122,2.033333333333333,1,5,60,0
6.102051330054381e+17,66,140,2.121212121212121,1,5,66,0
6.103226490685357e+17,24,95,3.9583333333333335,2,6,24,0
6.106542991415999e+17,2,5,2.5,2,3,2,0
6.108134833689814e+17,6,23,3.8333333333333335,3,5,6,0
6.109429619835715e+17,3,29,9.666666666666666,9,10,0,3
6.111379590316872e+17,191,375,1.963350785340314,1,5,191,0
6.112170046869391e+17,2,10,5.0,4,6,2,0
6.112173465485288e+17,104,213,2.048076923076923,1,5,104,0
6.112180003715891e+17,177,333,1.88135593220339,1,4,177,0
6.112275183987299e+17,95,298,3.136842105263158,1,6,95,0
6.114614438959036e+17,4,18,4.5,2,6,4,0
6.11533877344798e+17,17,162,9.529411764705882,5,12,1,16
6.115663710157623e+17,21,141,6.714285714285714,4,8,14,7
6.11600875982399e+17,63,499,7.920634920634921,2,12,19,44
6.116011307649669e+17,8,19,2.375,1,5,8,0
6.116579742061201e+17,4,13,3.25,2,4,4,0
6.120301623769176e+17,1,3,3.0,3,3,1,0
6.120337125058308e+17,15,121,8.066666666666666,4,11,2,13
6.127092882679288e+17,1,3,3.0,3,3,1,0
6.127159874972156e+17,1,1,1.0,1,1,1,0
6.127261440824632e+17,3,15,5.0,4,6,3,0
6.128359213455374e+17,2,7,3.5,3,4,2,0
6.129057697262542e+17,160,337,2.10625,1,4,160,0
6.129135590164608e+17,3,32,10.666666666666666,10,11,0,3
6.13023933738332e+17,16,101,6.3125,2,9,13,3
6.130425253315927e+17,16,71,4.4375,3,6,16,0
6.130624870415429e+17,159,1073,6.748427672955975,3,9,124,35
6.130741033035236e+17,55,113,2.0545454545454547,1,5,55,0
6.131119881621373e+17,40,380,9.5,6,12,4,36
6.134196549081583e+17,13,96,7.384615384615385,5,9,6,7
6.134234301204115e+17,67,577,8.611940298507463,2,11,11,56
6.134454500985549e+17,72,286,3.9722222222222223,2,6,72,0
6.134461428612978e+17,119,235,1.9747899159663866,1,4,119,0
6.134704379329211e+17,39,79,2.0256410256410255,1,4,39,0
6.13503004298117e+17,310,2686,8.664516129032258,2,11,34,276
6.135041617339813e+17,58,298,5.137931034482759,2,8,57,1
6.135070104913747e+17,65,628,9.661538461538461,4,13,4,61
6.135340012788963e+17,5,35,7.0,6,8,3,2
6.135368770578162e+17,42,197,4.690476190476191,2,6,42,0
6.135742408860563e+17,9,25,2.7777777777777777,2,4,9,0
6.135892756708835e+17,5,16,3.2,2,4,5,0
6.136870010918665e+17,16,22,1.375,1,3,16,0
6.137896098695446e+17,34,237,6.970588235294118,3,10,21,13
6.138847823760458e+17,145,1432,9.875862068965517,2,12,6,139
6.141592999109965e+17,22,120,5.454545454545454,3,7,22,0
6.142245354250088e+17,87,438,5.0344827586206895,2,8,85,2
6.142531695082173e+17,13,96,7.384615384615385,6,9,7,6
6.142719717064575e+17,20,48,2.4,1,4,20,0
6.143240238643841e+17,9,21,2.3333333333333335,1,3,9,0
6.143975006517509e+17,8,53,6.625,5,9,7,1
6.144245816075642e+17,10,21,2.1,1,4,10,0
6.144460882527817e+17,29,66,2.2758620689655173,1,4,29,0
6.146265384265532e+17,14,74,5.285714285714286,4,7,14,0
6.148419652038892e+17,22,45,2.0454545454545454,1,4,22,0
6.149545876322596e+17,10,21,2.1,1,4,10,0
6.149982393231418e+17,207,627,3.028985507246377,1,6,207,0
6.150201329397641e+17,17,111,6.529411764705882,2,9,12,5
6.150216099111444e+17,135,1266,9.377777777777778,2,12,12,123
6.150495168228449e+17,12,87,7.25,2,10,6,6
6.150590882399183e+17,160,658,4.1125,2,7,160,0
6.150907093006437e+17,63,140,2.2222222222222223,1,5,63,0
6.151004101693946e+17,37,148,4.0,2,6,37,0
6.152899863958733e+17,24,172,7.166666666666667,6,9,16,8
6.155618475404507e+17,17,167,9.823529411764707,8,11,0,17
6.155676176386995e+17,2,16,8.0,8,8,0,2
6.155829336208803e+17,3,11,3.6666666666666665,2,5,3,0
6.155970857683722e+17,10,67,6.7,3,8,7,3
6.156084416734212e+17,1,1,1.0,1,1,1,0
6.156542141465574e+17,3,5,1.6666666666666667,1,2,3,0
6.156679031684543e+17,17,43,2.5294117647058822,1,5,17,0
6.156764620680298e+17,39,363,9.307692307692308,3,12,4,35
6.157146768249923e+17,317,1876,5.917981072555205,2,10,289,28
6.157267496830117e+17,23,109,4.739130434782608,3,7,23,0
6.157336234010177e+17,25,47,1.88,1,4,25,0
6.158923187359973e+17,132,272,2.0606060606060606,1,5,132,0
6.161886630461119e+17,157,1512,9.630573248407643,2,12,11,146
6.162118710056228e+17,26,37,1.4230769230769231,1,3,26,0
6.164345610690278e+17,1,6,6.0,6,6,1,0
6.16530063987425e+17,110,938,8.527272727272727,2,12,14,96
6.16549678360018e+17,20,102,5.1,3,7,20,0
6.165750854435703e+17,26,78,3.0,1,4,26,0
6.165925215972287e+17,65,134,2.0615384615384613,1,4,65,0
6.1672267398634e+17,11,75,6.818181818181818,4,8,7,4
6.170697494705007e+17,6,46,7.666666666666667,7,9,3,3
6.17120700737664e+17,62,311,5.016129032258065,2,7,62,0
6.171268038491749e+17,12,61,5.083333333333333,3,7,12,0
6.171447100300264e+17,103,208,2.0194174757281553,1,5,103,0
6.171534100978124e+17,1,7,7.0,7,7,1,0
6.173731200258467e+17,41,310,7.560975609756097,3,10,19,22
6.174285829254264e+17,66,573,8.681818181818182,2,12,9,57
6.174607810393085e+17,3,14,4.666666666666667,4,5,3,0
6.176674807483617e+17,41,388,9.463414634146341,3,11,2,39
6.176970870739732e+17,41,80,1.951219512195122,1,4,41,0
6.179861790549215e+17,37,325,8.783783783783784,2,12,4,33
6.179879086081316e+17,121,927,7.661157024793388,2,10,47,74
6.180605539138255e+17,90,852,9.466666666666667,3,12,10,80
6.181357674272104e+17,1,7,7.0,7,7,1,0
6.181878387732411e+17,5,13,2.6,2,4,5,0
6.184445595466984e+17,15,32,2.1333333333333333,1,4,15,0
6.184525816782509e+17,162,333,2.0555555555555554,1,5,162,0
6.184922128586395e+17,2,5,2.5,2,3,2,0
6.185600859746107e+17,4,5,1.25,1,2,4,0
6.185866194012303e+17,114,1017,8.921052631578947,3,12,7,107
6.185886895484845e+17,2,5,2.5,2,3,2,0
6.18668586875153e+17,123,597,4.853658536585366,2,7,123,0
6.187122729209443e+17,76,233,3.0657894736842106,1,6,76,0
6.187357984444813e+17,264,1269,4.806818181818182,2,7,264,0
6.187563142746259e+17,269,1085,4.033457249070632,1,8,268,1
6.187696591203269e+17,249,1228,4.931726907630522,2,7,249,0
6.187819240614586e+17,256,1261,4.92578125,2,8,253,3
6.188200659581021e+17,29,155,5.344827586206897,3,8,28,1
6.19182690525264e+17,4,9,2.25,1,3,4,0
6.19244724650313e+17,62,134,2.161290322580645,1,5,62,0
6.192548814084439e+17,11,115,10.454545454545455,8,12,0,11
6.192898928204705e+17,219,469,2.141552511415525,1,4,219,0
6.193484076447685e+17,57,287,5.035087719298246,3,7,57,0
6.193592959532141e+17,197,962,4.883248730964467,2,8,193,4
6.193739635265779e+17,2,5,2.5,2,3,2,0
6.193740016401856e+17,5,23,4.6,4,6,5,0
6.194099852525663e+17,197,271,1.3756345177664975,1,4,197,0
6.194696009451218e+17,103,222,2.1553398058252426,1,5,103,0
6.196004233714397e+17,22,108,4.909090909090909,3,7,22,0
6.198487890079244e+17,72,684,9.5,3,12,6,66
6.199472951608946e+17,96,208,2.1666666666666665,1,4,96,0
6.199634607209133e+17,103,216,2.0970873786407767,1,5,103,0
6.199982769960027e+17,112,343,3.0625,1,5,112,0
6.200038667738916e+17,6,12,2.0,1,4,6,0
6.200279964858273e+17,27,181,6.703703703703703,2,9,22,5
6.200452377332955e+17,22,62,2.8181818181818183,1,5,22,0
6.20092063992186e+17,34,178,5.235294117647059,3,7,34,0
6.202292026209315e+17,7,54,7.714285714285714,6,9,3,4
6.206086983783348e+17,110,513,4.663636363636364,2,7,110,0
6.206247805968545e+17,36,180,5.0,3,7,36,0
6.207009165854463e+17,2,5,2.5,2,3,2,0
6.207790946049806e+17,110,528,4.8,1,8,109,1
6.208239345472494e+17,34,49,1.4411764705882353,1,4,34,0
6.208687773053459e+17,69,358,5.188405797101449,3,8,68,1
6.210037070665028e+17,95,208,2.1894736842105265,1,5,95,0
6.214782562438591e+17,25,51,2.04,1,4,25,0
6.21485784311045e+17,10,26,2.6,1,4,10,0
6.217465010060067e+17,32,317,9.90625,4,12,2,30
6.221116323680746e+17,89,269,3.0224719101123596,1,5,89,0
6.221644580479818e+17,56,110,1.9642857142857142,1,4,56,0
6.221689020176031e+17,58,407,7.017241379310345,4,9,37,21
6.222758223335849e+17,100,387,3.87,1,6,100,0
6.222764441238924e+17,82,404,4.926829268292683,2,7,82,0
6.222907089154045e+17,18,119,6.611111111111111,5,9,15,3
6.223759157263351e+17,215,1079,5.018604651162791,2,8,213,2
6.224281271203315e+17,74,150,2.027027027027027,1,4,74,0
6.228620254909467e+17,24,225,9.375,2,12,2,22
6.228743007781359e+17,66,138,2.090909090909091,1,4,66,0
6.228918515816566e+17,7,18,2.5714285714285716,1,4,7,0
6.228983999597274e+17,3,18,6.0,5,7,3,0
6.229163307444425e+17,2,5,2.5,2,3,2,0
6.229703142989914e+17,18,57,3.1666666666666665,2,6,18,0
6.230241549819203e+17,188,1612,8.574468085106384,2,12,29,159
6.230614237633975e+17,67,649,9.686567164179104,3,13,2,65
6.23069488402474e+17,73,224,3.0684931506849313,1,5,73,0
6.23074627213163e+17,13,75,5.769230769230769,4,8,12,1
6.230879104304483e+17,162,1560,9.62962962962963,2,13,12,150
6.230926650454409e+17,25,167,6.68,5,9,19,6
6.231219650148893e+17,5,15,3.0,2,5,5,0
6.231871277866921e+17,95,198,2.0842105263157893,1,4,95,0
6.233246182006047e+17,5,11,2.2,1,3,5,0
6.234920578797851e+17,13,103,7.923076923076923,5,9,4,9
6.235132203714075e+17,132,650,4.924242424242424,2,8,131,1
6.235472295613114e+17,105,204,1.9428571428571428,1,4,105,0
6.235573300160855e+17,1,4,4.0,4,4,1,0
6.235784978031073e+17,1,5,5.0,5,5,1,0
6.235989746311766e+17,2,7,3.5,1,6,2,0
6.236158586474939e+17,100,205,2.05,1,5,100,0
6.236360155138227e+17,49,241,4.918367346938775,2,7,49,0
6.236666369277379e+17,185,900,4.864864864864865,2,8,183,2
6.236711377703652e+17,57,485,8.508771929824562,2,11,9,48
6.236793077133706e+17,37,344,9.297297297297296,2,12,5,32
6.236858831908197e+17,88,439,4.988636363636363,2,8,87,1
6.237019970722383e+17,24,118,4.916666666666667,2,7,24,0
6.237088332234478e+17,15,77,5.133333333333334,3,7,15,0
6.23728692353562e+17,16,36,2.25,1,5,16,0
6.23770118746337e+17,19,92,4.842105263157895,3,6,19,0
6.238716060925082e+17,87,854,9.816091954022989,6,12,4,83
6.239141069490072e+17,16,28,1.75,1,3,16,0
6.239327819905468e+17,28,189,6.75,4,9,22,6
6.242159633777993e+17,10,46,4.6,2,6,10,0
6.242611852879055e+17,73,700,9.58904109589041,2,12,4,69
6.242715332436287e+17,2,4,2.0,2,2,2,0
6.243568328758647e+17,7,20,2.857142857142857,2,4,7,0
6.244491303213059e+17,37,252,6.8108108108108105,4,9,30,7
6.244869235805056e+17,2,15,7.5,7,8,1,1
6.245254898827813e+17,4,15,3.75,3,4,4,0
6.245433275981382e+17,37,186,5.027027027027027,3,7,37,0
6.245800052122184e+17,52,66,1.2692307692307692,1,3,52,0
6.246896556496963e+17,18,40,2.2222222222222223,1,3,18,0
6.250946665820284e+17,14,29,2.0714285714285716,1,5,14,0
6.251030588351425e+17,34,44,1.2941176470588236,1,3,34,0
6.251047445029399e+17,233,481,2.0643776824034337,1,4,233,0
6.251133049612361e+17,1,1,1.0,1,1,1,0
6.251286009966364e+17,1,2,2.0,2,2,1,0
6.251759332982936e+17,19,131,6.894736842105263,4,9,13,6
6.251936558400346e+17,10,35,3.5,2,5,10,0
6.253055928392902e+17,302,2673,8.850993377483444,2,12,36,266
6.25315088765673e+17,15,113,7.533333333333333,2,10,5,10
6.25340542849626e+17,32,263,8.21875,6,10,5,27
6.253486662895671e+17,21,40,1.9047619047619047,1,3,21,0
6.253549312340273e+17,24,50,2.0833333333333335,1,4,24,0
6.254009766105486e+17,144,297,2.0625,1,5,144,0
6.256625125926161e+17,137,665,4.854014598540146,2,8,136,1
6.257818441492548e+17,68,212,3.1176470588235294,1,5,68,0
6.258090989403099e+17,4,6,1.5,1,3,4,0
6.258619565090002e+17,109,234,2.146788990825688,1,4,109,0
6.25868559391128e+17,38,341,8.973684210526315,3,11,7,31
6.258702194244091e+17,18,24,1.3333333333333333,1,3,18,0
6.25942498806678e+17,1,1,1.0,1,1,1,0
6.259626964555636e+17,29,90,3.103448275862069,1,6,29,0
6.259659138458163e+17,85,330,3.8823529411764706,1,6,85,0
6.260085181125887e+17,13,28,2.1538461538461537,1,4,13,0
6.260768542402184e+17,22,32,1.4545454545454546,1,3,22,0
6.26111185565441e+17,13,95,7.3076923076923075,6,9,8,5
6.261728589289612e+17,276,1349,4.88768115942029,2,8,274,2
6.267431306141325e+17,2,13,6.5,6,7,2,0
6.269311000684251e+17,17,30,1.7647058823529411,1,4,17,0
6.272782223436457e+17,173,1674,9.676300578034683,3,13,10,163
6.27281512247135e+17,61,410,6.721311475409836,3,9,46,15
6.272975977869925e+17,89,632,7.101123595505618,2,10,55,34
6.273738834052175e+17,80,770,9.625,2,12,4,76
6.274225590501181e+17,16,138,8.625,6,10,4,12
6.274728024764773e+17,89,865,9.719101123595506,3,12,6,83
6.274811282542735e+17,47,90,1.9148936170212767,1,4,47,0
6.275147654249134e+17,27,252,9.333333333333334,2,12,3,24
6.275533398059662e+17,19,96,5.052631578947368,3,7,19,0
6.275997524415679e+17,5,15,3.0,2,5,5,0
6.276327995335363e+17,7,25,3.5714285714285716,3,4,7,0
6.276391220822623e+17,42,204,4.857142857142857,2,7,42,0
6.279338237065569e+17,41,311,7.585365853658536,3,9,15,26
6.2794293361406e+17,232,2037,8.780172413793103,2,12,29,203
6.28014578986481e+17,317,3034,9.570977917981072,2,13,23,294
6.280193938091823e+17,234,2254,9.632478632478632,3,12,19,215
6.28055237838462e+17,263,2542,9.665399239543726,2,13,14,249
6.280583309109939e+17,224,2147,9.584821428571429,2,12,15,209
6.280629609592494e+17,64,435,6.796875,3,9,45,19
6.281551520292082e+17,170,1168,6.870588235294117,2,10,116,54
6.281665290035767e+17,8,35,4.375,2,6,8,0
6.282077620162847e+17,35,311,8.885714285714286,2,11,3,32
6.28237571714796e+17,216,1482,6.861111111111111,2,11,152,64
6.282380435712772e+17,161,803,4.987577639751553,2,8,160,1
6.282496158309074e+17,195,1330,6.82051282051282,2,10,141,54
6.282605926478104e+17,164,1116,6.804878048780488,2,9,121,43
6.284738794472087e+17,77,378,4.909090909090909,2,7,77,0
6.286371722251113e+17,62,181,2.9193548387096775,1,6,62,0
6.286788112579014e+17,13,77,5.923076923076923,5,8,12,1
6.287175951527233e+17,13,93,7.153846153846154,3,8,6,7
6.287199790279795e+17,103,773,7.504854368932039,2,10,41,62
6.287262409780671e+17,17,85,5.0,4,6,17,0
6.287327165373793e+17,9,61,6.777777777777778,5,9,7,2
6.287659165757297e+17,1,7,7.0,7,7,1,0
6.287805061924982e+17,39,271,6.948717948717949,5,10,25,14
6.287945218051096e+17,38,50,1.3157894736842106,1,3,38,0
6.288026250047208e+17,57,115,2.017543859649123,1,4,57,0
6.288624165388838e+17,280,1408,5.0285714285714285,2,8,278,2
6.288658684140864e+17,277,1374,4.96028880866426,2,8,275,2
6.289514305983594e+17,17,48,2.823529411764706,1,4,17,0
6.29400015902675e+17,20,53,2.65,1,5,20,0
6.294048467234176e+17,35,163,4.6571428571428575,2,7,35,0
6.294375650071428e+17,28,86,3.0714285714285716,2,5,28,0
6.294702396117315e+17,54,519,9.61111111111111,3,12,4,50
6.295034093716977e+17,95,132,1.3894736842105264,1,4,95,0
6.295084995809527e+17,110,144,1.309090909090909,1,3,110,0
6.295105704460218e+17,117,561,4.794871794871795,2,7,117,0
6.295173362412832e+17,272,1334,4.904411764705882,2,8,271,1
6.295271105287654e+17,279,1377,4.935483870967742,2,7,279,0
6.295862259392398e+17,142,969,6.823943661971831,2,9,104,38
6.297239004825752e+17,7,12,1.7142857142857142,1,3,7,0
6.299452649822401e+17,27,139,5.148148148148148,2,7,27,0
6.30069192478624e+17,9,26,2.888888888888889,2,4,9,0
6.300801420526438e+17,162,1114,6.8765432098765435,3,10,111,51
6.30116653021076e+17,123,616,5.008130081300813,2,8,121,2
6.30116995220994e+17,162,1105,6.820987654320987,2,11,116,46
6.301248446489681e+17,142,961,6.767605633802817,2,10,98,44
6.301455855369416e+17,150,1033,6.886666666666667,3,9,107,43
6.301621093790637e+17,7,13,1.8571428571428572,1,4,7,0
6.3016393313894e+17,30,82,2.7333333333333334,1,5,30,0
6.301664836276214e+17,32,65,2.03125,1,3,32,0
6.301726732957966e+17,262,2309,8.812977099236642,2,12,38,224
6.302272251624193e+17,1,8,8.0,8,8,0,1
6.302301493912434e+17,37,128,3.4594594594594597,1,5,37,0
6.302328035020929e+17,77,528,6.857142857142857,2,11,58,19
6.302572401340049e+17,29,151,5.206896551724138,4,8,28,1
6.303475668939516e+17,21,72,3.4285714285714284,2,5,21,0
6.303555444177258e+17,72,155,2.1527777777777777,1,5,72,0
6.303959258191932e+17,57,557,9.771929824561404,2,12,4,53
6.304112642200036e+17,56,280,5.0,2,7,56,0
6.304170728022244e+17,12,58,4.833333333333333,4,7,12,0
6.304343484516321e+17,11,47,4.2727272727272725,2,7,11,0
6.304690257460132e+17,4,9,2.25,2,3,4,0
6.305191297922811e+17,12,24,2.0,1,4,12,0
6.309302631647429e+17,26,32,1.2307692307692308,1,2,26,0
6.3097601695617e+17,7,38,5.428571428571429,4,7,7,0
6.310459236538647e+17,172,1175,6.8313953488372094,2,9,122,50
6.310687500199401e+17,5,9,1.8,1,3,5,0
6.310837635022705e+17,46,83,1.8043478260869565,1,4,46,0
6.310902643419087e+17,1,1,1.0,1,1,1,0
6.312788247754234e+17,6,15,2.5,1,4,6,0
6.316029499948122e+17,1,7,7.0,7,7,1,0
6.316091938296552e+17,96,581,6.052083333333333,3,8,88,8
6.316993829276635e+17,2,6,3.0,2,4,2,0
6.317326363035738e+17,49,107,2.183673469387755,1,4,49,0
6.317768054074662e+17,74,516,6.972972972972973,5,9,49,25
6.317778181163388e+17,44,201,4.568181818181818,2,7,44,0
6.317842431971319e+17,120,592,4.933333333333334,2,7,120,0
6.318302993732471e+17,2,6,3.0,2,4,2,0
6.322645427212666e+17,84,170,2.0238095238095237,1,4,84,0
6.323161017924634e+17,229,2206,9.633187772925764,2,12,16,213
6.326104606889939e+17,71,282,3.971830985915493,1,7,71,0
6.326224150521882e+17,219,1726,7.8812785388127855,2,11,71,148
6.329782560264381e+17,13,66,5.076923076923077,3,7,13,0
6.32979001612975e+17,16,139,8.6875,2,10,2,14
6.330028185046107e+17,51,147,2.8823529411764706,1,6,51,0
6.330191868003526e+17,187,1314,7.026737967914438,2,10,125,62
6.330266943711223e+17,232,1619,6.978448275862069,2,10,156,76
6.330343046318794e+17,264,1035,3.9204545454545454,1,7,264,0
6.330355248320155e+17,167,1141,6.832335329341317,2,10,119,48
6.330377506778926e+17,123,616,5.008130081300813,3,7,123,0
6.330421411292484e+17,181,1244,6.87292817679558,2,10,128,53
6.330423386918216e+17,1,2,2.0,2,2,1,0
6.330541675306472e+17,15,105,7.0,2,8,7,8
6.330555343687762e+17,195,1549,7.943589743589744,2,11,65,130
6.330619177730519e+17,206,1619,7.859223300970874,2,11,76,130
6.330687520707054e+17,249,1975,7.931726907630522,2,11,75,174
6.331148414896831e+17,109,163,1.4954128440366972,1,3,109,0
6.331180147499196e+17,121,698,5.768595041322314,2,9,113,8
6.331299016376694e+17,3,21,7.0,3,10,1,2
6.331353507851992e+17,2,8,4.0,4,4,2,0
6.331422264878804e+17,153,327,2.1372549019607843,1,4,153,0
6.331636615285901e+17,18,89,4.944444444444445,2,7,18,0
6.332652507761873e+17,169,1490,8.816568047337277,4,11,21,148
6.333546628049379e+17,147,1176,8.0,3,11,43,104
6.336656928688068e+17,32,135,4.21875,2,6,32,0
6.337159403194199e+17,5,16,3.2,1,5,5,0
6.337248259611771e+17,5,35,7.0,6,9,4,1
6.337636591131649e+17,17,23,1.3529411764705883,1,2,17,0
6.337637405439405e+17,123,623,5.065040650406504,2,7,123,0
6.337640894403808e+17,2,3,1.5,1,2,2,0
6.337641339234353e+17,259,1076,4.154440154440154,1,7,259,0
6.337810151535574e+17,194,1893,9.757731958762887,2,13,12,182
6.33787165914828e+17,1,4,4.0,4,4,1,0
6.338161972663159e+17,16,39,2.4375,1,4,16,0
6.338218028261759e+17,94,200,2.127659574468085,1,4,94,0
6.338458592844541e+17,81,168,2.074074074074074,1,5,81,0
6.338561645011411e+17,9,33,3.6666666666666665,3,5,9,0
6.338892484596608e+17,80,550,6.875,4,10,58,22
6.339051883003977e+17,55,274,4.9818181818181815,2,7,55,0
6.339343832728168e+17,21,67,3.1904761904761907,1,5,21,0
6.34009665791243e+17,89,444,4.98876404494382,2,8,88,1
6.34039545016767e+17,109,542,4.972477064220183,2,7,109,0
6.340459002668046e+17,4,27,6.75,6,8,3,1
6.340643059654391e+17,114,548,4.807017543859649,2,7,114,0
6.341030068359168e+17,109,759,6.963302752293578,4,9,73,36
6.341888659555181e+17,6,9,1.5,1,3,6,0
6.344119759088308e+17,4,28,7.0,7,7,4,0
6.344510692511913e+17,66,319,4.833333333333333,2,7,66,0
6.344975245315055e+17,96,657,6.84375,2,9,66,30
6.345664680578102e+17,37,71,1.9189189189189189,1,4,37,0
6.345948534069862e+17,91,734,8.065934065934066,4,11,27,64
6.346067370057848e+17,270,1325,4.907407407407407,2,8,269,1
6.346106367859305e+17,1,5,5.0,5,5,1,0
6.347046603516878e+17,8,22,2.75,1,4,8,0
6.34778969267602e+17,5,35,7.0,5,8,3,2
6.351910297564182e+17,77,374,4.857142857142857,2,7,77,0
6.351992060109843e+17,26,55,2.1153846153846154,1,5,26,0
6.352006983248424e+17,31,308,9.935483870967742,3,12,1,30
6.352183576688774e+17,18,175,9.722222222222221,8,12,0,18
6.352223713847512e+17,70,280,4.0,2,7,70,0
6.35240403779773e+17,90,616,6.844444444444444,2,9,66,24
6.352666646866139e+17,95,476,5.010526315789473,2,7,95,0
6.353164734853135e+17,70,149,2.1285714285714286,1,5,70,0
6.353165203748581e+17,23,48,2.0869565217391304,1,3,23,0
6.353235161017549e+17,121,588,4.859504132231405,2,7,121,0
6.353462509596114e+17,36,172,4.777777777777778,2,6,36,0
6.353608847537439e+17,65,450,6.923076923076923,2,9,46,19
6.353640405204036e+17,207,440,2.1256038647342996,1,5,207,0
6.353872068287254e+17,143,723,5.055944055944056,2,7,143,0
6.353980655296794e+17,21,192,9.142857142857142,8,11,0,21
6.354744300074967e+17,85,719,8.458823529411765,2,11,11,74
6.355846256121164e+17,4,11,2.75,2,4,4,0
6.358719431359411e+17,10,29,2.9,1,4,10,0
6.35873188515473e+17,31,244,7.870967741935484,6,9,12,19
6.359250318882632e+17,1,2,2.0,2,2,1,0
6.359354713086194e+17,64,476,7.4375,2,9,29,35
6.360462454169533e+17,6,12,2.0,1,3,6,0
6.361535178019649e+17,87,767,8.816091954022989,2,12,10,77
6.361818361883756e+17,308,1518,4.928571428571429,2,8,306,2
6.361879669596486e+17,2,14,7.0,7,7,2,0
6.362007225450725e+17,306,1515,4.950980392156863,2,8,304,2
6.362074501729797e+17,31,234,7.548387096774194,2,10,11,20
6.36508061931349e+17,211,1018,4.8246445497630335,2,7,211,0
6.366669723240052e+17,10,86,8.6,5,10,1,9
6.366792631143188e+17,1,3,3.0,3,3,1,0
6.367905208809732e+17,14,118,8.428571428571429,5,11,3,11
6.36861496322922e+17,42,289,6.880952380952381,3,10,30,12
6.369304424213972e+17,20,184,9.2,3,12,1,19
6.369615983886222e+17,10,77,7.7,5,9,2,8
6.372899774099256e+17,3,24,8.0,7,10,2,1
6.373048141990317e+17,17,98,5.764705882352941,4,7,17,0
6.37305118378982e+17,10,64,6.4,5,8,9,1
6.373100438746973e+17,109,514,4.715596330275229,2,7,109,0
6.373212862651677e+17,8,73,9.125,6,11,1,7
6.37512680799981e+17,132,392,2.9696969696969697,1,5,132,0
6.375294594890342e+17,34,331,9.735294117647058,4,12,1,33
6.375451145123638e+17,104,514,4.9423076923076925,1,8,103,1
6.375916434263369e+17,185,574,3.1027027027027025,1,5,185,0
6.375921099734002e+17,264,2619,9.920454545454545,2,13,10,254
6.376313608013673e+17,3,10,3.3333333333333335,2,4,3,0
6.376342114521624e+17,211,1994,9.450236966824644,2,13,14,197
6.37635118315969e+17,72,556,7.722222222222222,4,10,29,43
6.377368431859565e+17,119,923,7.756302521008403,3,10,41,78
6.379455997513207e+17,25,57,2.28,1,4,25,0
6.381005505514092e+17,1,5,5.0,5,5,1,0
6.381558459684201e+17,36,169,4.694444444444445,3,7,36,0
6.382163060707862e+17,15,50,3.3333333333333335,1,5,15,0
6.382245212917591e+17,73,296,4.054794520547945,2,7,73,0
6.3824508272894e+17,44,349,7.931818181818182,5,10,12,32
6.382580511870088e+17,73,289,3.958904109589041,1,7,73,0
6.382729924365284e+17,5,25,5.0,4,6,5,0
6.382957957184909e+17,138,1346,9.753623188405797,2,13,7,131
6.383178215581756e+17,4,16,4.0,3,5,4,0
6.38345905225916e+17,53,251,4.735849056603773,2,7,53,0
6.383580199655374e+17,140,303,2.164285714285714,1,5,140,0
6.383594035437211e+17,30,147,4.9,3,7,30,0
6.383795805654358e+17,96,953,9.927083333333334,2,12,3,93
6.38437419256423e+17,111,223,2.009009009009009,1,5,111,0
6.384427531793608e+17,122,1161,9.51639344262295,2,13,6,116
6.387058534850758e+17,3,3,1.0,1,1,3,0
6.387450999739514e+17,12,24,2.0,1,3,12,0
6.387681549873916e+17,85,247,2.9058823529411764,1,5,85,0
6.387681664850935e+17,77,231,3.0,1,6,77,0
6.38794331096792e+17,64,316,4.9375,2,7,64,0
6.388148853596535e+17,6,13,2.1666666666666665,1,4,6,0
6.388447474679901e+17,6,46,7.666666666666667,7,8,2,4
6.388539954715515e+17,7,15,2.142857142857143,1,3,7,0
6.388614693697617e+17,80,315,3.9375,2,7,80,0
6.389099139116411e+17,3,6,2.0,1,3,3,0
6.389187819726292e+17,19,157,8.263157894736842,6,10,4,15
6.38955298062555e+17,24,44,1.8333333333333333,1,3,24,0
6.389623408067754e+17,23,183,7.956521739130435,4,10,7,16
6.389646938232516e+17,2,4,2.0,2,2,2,0
6.390010678303333e+17,40,189,4.725,2,7,40,0
6.390268460559156e+17,101,405,4.00990099009901,2,7,101,0
6.390905218269076e+17,20,191,9.55,2,12,1,19
6.391191788998049e+17,15,44,2.933333333333333,1,5,15,0
6.395135348986875e+17,96,185,1.9270833333333333,1,6,96,0
6.396630929326734e+17,6,40,6.666666666666667,2,9,4,2
6.396695370830573e+17,40,230,5.75,2,9,37,3
6.397011574877782e+17,1,5,5.0,5,5,1,0
6.397380923494026e+17,139,831,5.9784172661870505,2,8,131,8
6.39757391979632e+17,13,79,6.076923076923077,5,7,13,0
6.397794071073501e+17,17,112,6.588235294117647,3,9,14,3
6.398129089308982e+17,31,241,7.774193548387097,2,9,11,20
6.39812973988963e+17,40,80,2.0,1,4,40,0
6.39878588288961e+17,16,118,7.375,3,8,5,11
6.398802733891142e+17,9,60,6.666666666666667,6,8,8,1
6.399066161894881e+17,29,194,6.689655172413793,4,8,23,6
6.399260715861851e+17,7,50,7.142857142857143,6,9,4,3
6.399304029338956e+17,59,113,1.9152542372881356,1,5,59,0
6.399362389914008e+17,13,70,5.384615384615385,4,8,12,1
6.399398566448445e+17,28,68,2.4285714285714284,1,5,28,0
6.399400344925055e+17,67,133,1.9850746268656716,1,4,67,0
6.399468707775914e+17,8,54,6.75,4,8,6,2
6.399631025801006e+17,5,34,6.8,5,8,3,2
6.399796953921585e+17,13,92,7.076923076923077,5,8,8,5
6.399890733827456e+17,4,27,6.75,6,9,3,1
6.402024057926335e+17,100,389,3.89,2,7,100,0
6.403681311799363e+17,47,147,3.127659574468085,1,5,47,0
6.40385927549339e+17,41,366,8.926829268292684,5,12,5,36
6.404080774558808e+17,185,371,2.0054054054054054,1,5,185,0
6.40408436399418e+17,247,1208,4.890688259109312,2,8,245,2
6.404149769226676e+17,73,357,4.890410958904109,2,8,72,1
6.404510802663622e+17,2,19,9.5,8,11,0,2
6.404533964568796e+17,146,429,2.9383561643835616,1,5,146,0
6.404831955161903e+17,126,259,2.0555555555555554,1,5,126,0
6.405238033450015e+17,1,3,3.0,3,3,1,0
6.405361294636977e+17,97,754,7.77319587628866,2,10,37,60
6.405410277155446e+17,182,1739,9.554945054945055,2,13,13,169
6.405778890605187e+17,80,163,2.0375,1,4,80,0
6.406825882882062e+17,13,59,4.538461538461538,2,6,13,0
6.408667810441057e+17,22,84,3.8181818181818183,3,6,22,0
6.409398188077466e+17,30,234,7.8,5,10,8,22
6.410098347312403e+17,22,29,1.3181818181818181,1,3,22,0
6.410158524443348e+17,324,1912,5.901234567901234,2,8,304,20
6.410169797168576e+17,36,165,4.583333333333333,2,6,36,0
6.410296597525902e+17,32,59,1.84375,1,3,32,0
6.410415545233372e+17,8,13,1.625,1,3,8,0
6.410850325470746e+17,213,1044,4.901408450704225,1,7,213,0
6.410919026095645e+17,17,36,2.1176470588235294,1,5,17,0
6.411130761747071e+17,5,35,7.0,6,8,4,1
6.411172774829587e+17,57,506,8.87719298245614,4,11,4,53
6.411207447088287e+17,73,503,6.890410958904109,2,9,50,23
6.411212117297399e+17,34,233,6.852941176470588,3,9,24,10
6.411427738446309e+17,36,74,2.0555555555555554,1,4,36,0
6.415982343071831e+17,33,312,9.454545454545455,8,11,0,33
6.416898886072716e+17,9,71,7.888888888888889,6,9,3,6
6.417437270291805e+17,90,183,2.033333333333333,1,5,90,0
6.417555632795711e+17,89,197,2.2134831460674156,1,5,89,0
6.417913626471457e+17,252,988,3.9206349206349205,2,6,252,0
6.419694643021706e+17,3,25,8.333333333333334,7,11,2,1
6.41988715802547e+17,141,695,4.929078014184397,2,7,141,0
6.42129261379306e+17,62,612,9.870967741935484,4,12,3,59
6.425467470918447e+17,97,474,4.88659793814433,2,7,97,0
6.426066875184937e+17,1,6,6.0,6,6,1,0
6.42699884015459e+17,40,323,8.075,3,11,12,28
6.427174222215379e+17,69,331,4.797101449275362,2,7,69,0
6.431270821310225e+17,126,630,5.0,2,7,126,0
6.431359568374959e+17,70,140,2.0,1,5,70,0
6.431590310082345e+17,2,3,1.5,1,2,2,0
6.43159401920941e+17,46,308,6.695652173913044,2,9,31,15
6.431876930324987e+17,19,85,4.473684210526316,3,6,19,0
6.432504600738787e+17,305,1497,4.908196721311476,2,7,305,0
6.432641096295935e+17,16,96,6.0,2,8,13,3
6.432641603601448e+17,10,15,1.5,1,3,10,0
6.43264246131911e+17,8,43,5.375,4,7,8,0
6.433604614896376e+17,13,53,4.076923076923077,3,5,13,0
6.433854638761966e+17,22,217,9.863636363636363,2,12,1,21
6.434624994342276e+17,179,1706,9.53072625698324,2,12,10,169
6.43462593990514e+17,155,1492,9.625806451612902,2,13,16,139
6.435057596633338e+17,53,222,4.188679245283019,2,6,53,0
6.435409305627181e+17,7,21,3.0,1,5,7,0
6.43810416464172e+17,97,480,4.948453608247423,3,8,96,1
6.438715988740572e+17,54,490,9.074074074074074,2,12,2,52
6.438835530962167e+17,22,221,10.045454545454545,7,11,1,21
6.43887780163735e+17,65,328,5.046153846153846,3,7,65,0
6.439151335776261e+17,13,80,6.153846153846154,2,8,11,2
6.439259210458116e+17,17,151,8.882352941176471,3,11,3,14
6.439372932016845e+17,107,503,4.700934579439252,2,7,107,0
6.439723491064248e+17,68,655,9.632352941176471,3,12,3,65
6.439866913245197e+17,6,28,4.666666666666667,3,6,6,0
6.440169319302237e+17,53,131,2.4716981132075473,1,5,53,0
6.440173941470917e+17,8,41,5.125,4,7,8,0
6.440225944040883e+17,7,13,1.8571428571428572,1,3,7,0
6.440497632588317e+17,5,10,2.0,1,3,5,0
6.440714005916552e+17,93,900,9.67741935483871,2,12,7,86
6.440869587273021e+17,27,56,2.074074074074074,1,4,27,0
6.441733122422025e+17,86,184,2.13953488372093,1,5,86,0
6.444918696551468e+17,25,196,7.84,2,10,9,16
6.445423282367528e+17,115,570,4.956521739130435,3,7,115,0
6.445878682771127e+17,1,3,3.0,3,3,1,0
6.446131132611951e+17,109,235,2.1559633027522938,1,5,109,0
6.44622446454462e+17,1,6,6.0,6,6,1,0
6.446268621279e+17,53,371,7.0,3,10,33,20
6.446365109371519e+17,35,177,5.057142857142857,3,9,34,1
6.446417900019741e+17,18,84,4.666666666666667,2,6,18,0
6.446541818925308e+17,22,87,3.9545454545454546,2,6,22,0
6.446558966664442e+17,23,157,6.826086956521739,3,8,17,6
6.446769745022787e+17,54,105,1.9444444444444444,1,5,54,0
6.446770420530825e+17,6,19,3.1666666666666665,1,5,6,0
6.44677137741892e+17,10,32,3.2,1,5,10,0
6.44704165662668e+17,10,32,3.2,1,4,10,0
6.447240655439702e+17,13,53,4.076923076923077,3,7,13,0
6.447262674416401e+17,33,43,1.303030303030303,1,3,33,0
6.447414509921245e+17,20,40,2.0,1,3,20,0
6.447878425747462e+17,30,146,4.866666666666666,3,7,30,0
6.448057394291434e+17,5,36,7.2,7,8,4,1
6.449516639970501e+17,43,59,1.372093023255814,1,3,43,0
6.44961430232209e+17,8,29,3.625,3,5,8,0
6.449627105039055e+17,320,1554,4.85625,2,8,317,3
6.452731816930781e+17,184,915,4.9728260869565215,2,9,183,1
6.453226293819593e+17,113,867,7.672566371681416,3,11,41,72
6.453269230509327e+17,303,1505,4.966996699669967,3,8,302,1
6.453421235935059e+17,45,373,8.28888888888889,2,12,12,33
6.453522601451086e+17,312,1547,4.958333333333333,2,8,311,1
6.453648342947347e+17,17,80,4.705882352941177,2,6,17,0
6.453659996310885e+17,27,180,6.666666666666667,2,10,21,6
6.453754742706696e+17,320,1572,4.9125,2,9,317,3
6.454118304615075e+17,31,64,2.064516129032258,1,4,31,0
6.454200084483267e+17,86,428,4.976744186046512,3,8,84,2
6.454262333771178e+17,239,1651,6.907949790794979,2,10,170,69
6.454769690300142e+17,9,20,2.2222222222222223,1,4,9,0
6.456576944754454e+17,50,402,8.04,6,10,13,37
6.459373614520161e+17,3,4,1.3333333333333333,1,2,3,0
6.459925895932145e+17,43,158,3.6744186046511627,2,7,43,0
6.459947405302065e+17,62,569,9.17741935483871,2,12,6,56
6.459997563643254e+17,43,392,9.116279069767442,7,11,1,42
6.460076307796024e+17,46,133,2.891304347826087,1,5,46,0
6.460248757760984e+17,121,595,4.917355371900826,2,7,121,0
6.46062067241598e+17,126,503,3.992063492063492,1,7,126,0
6.460752791348128e+17,69,670,9.710144927536232,2,12,4,65
6.46102986841461e+17,80,251,3.1375,1,6,80,0
6.461555418323812e+17,86,345,4.011627906976744,1,7,86,0
6.462211804392315e+17,9,21,2.3333333333333335,1,3,9,0
6.462298322946705e+17,1,2,2.0,2,2,1,0
6.462299286841364e+17,2,13,6.5,5,8,1,1
6.462864850112069e+17,40,122,3.05,1,5,40,0
6.462866760483946e+17,47,235,5.0,2,7,47,0
6.462987738188378e+17,56,470,8.392857142857142,2,12,10,46
6.463193390686936e+17,108,737,6.824074074074074,2,9,79,29
6.463614612067341e+17,4,28,7.0,7,7,4,0
6.463753737118424e+17,90,441,4.9,2,7,90,0
6.463968556512344e+17,71,680,9.577464788732394,2,12,4,67
6.465532934448545e+17,71,557,7.845070422535211,4,11,28,43
6.467800603933551e+17,22,60,2.727272727272727,1,5,22,0
6.468027264394221e+17,1,1,1.0,1,1,1,0
6.468037214228497e+17,33,73,2.212121212121212,1,4,33,0
6.468071914544512e+17,20,22,1.1,1,2,20,0
6.468075766597676e+17,12,62,5.166666666666667,4,7,12,0
6.469015209662e+17,259,2195,8.474903474903474,2,11,46,213
6.469181791418638e+17,122,469,3.8442622950819674,1,6,122,0
6.469882806477745e+17,46,385,8.369565217391305,6,11,10,36
6.469920986088146e+17,172,1637,9.517441860465116,2,12,15,157
6.471168850888986e+17,57,108,1.894736842105263,1,4,57,0
6.471491872678406e+17,33,233,7.0606060606060606,5,9,19,14
6.473675055988698e+17,3,4,1.3333333333333333,1,2,3,0
6.475225425992338e+17,10,70,7.0,3,9,5,5
6.475311890531036e+17,11,17,1.5454545454545454,1,2,11,0
6.475416406785882e+17,19,125,6.578947368421052,2,8,15,4
6.475976915957769e+17,21,44,2.0952380952380953,1,4,21,0
6.476839963955788e+17,136,692,5.088235294117647,2,8,134,2
6.477329588163567e+17,48,96,2.0,1,4,48,0
6.477677392947077e+17,34,319,9.382352941176471,2,14,4,30
6.477915818355592e+17,196,977,4.98469387755102,2,8,195,1
6.478057241290353e+17,5,27,5.4,5,6,5,0
6.478265363291648e+17,44,348,7.909090909090909,5,10,18,26
6.478323358287634e+17,178,1526,8.573033707865168,2,12,29,149
6.478617766087863e+17,49,416,8.489795918367347,3,11,5,44
6.47882011518131e+17,2,4,2.0,2,2,2,0
6.481746260243356e+17,96,798,8.3125,2,11,11,85
6.481949459779428e+17,24,92,3.8333333333333335,2,6,24,0
6.48200967826607e+17,131,265,2.0229007633587788,1,5,131,0
6.482322329079704e+17,15,123,8.2,7,10,2,13
6.482379898187123e+17,37,44,1.1891891891891893,1,3,37,0
6.482570429146989e+17,6,45,7.5,6,9,3,3
6.48273392261514e+17,85,570,6.705882352941177,4,9,68,17
6.48283036477274e+17,62,196,3.161290322580645,1,5,62,0
6.4828699748074e+17,1,10,10.0,10,10,0,1
6.482943051130605e+17,69,668,9.681159420289855,2,13,6,63
6.483153866992662e+17,35,321,9.17142857142857,7,11,2,33
6.483185051230857e+17,3,7,2.3333333333333335,1,3,3,0
6.484436587198729e+17,13,26,2.0,1,4,13,0
6.484761411330628e+17,53,506,9.547169811320755,5,13,3,50
6.485408805734605e+17,10,42,4.2,3,6,10,0
6.485892185640352e+17,68,144,2.1176470588235294,1,4,68,0
6.486163742734463e+17,52,116,2.230769230769231,1,4,52,0
6.489139027708268e+17,109,232,2.128440366972477,1,4,109,0
6.4894017452056e+17,26,173,6.653846153846154,2,9,20,6
6.48946308905273e+17,1,3,3.0,3,3,1,0
6.489486060415433e+17,4,13,3.25,2,5,4,0
6.489567207218828e+17,7,16,2.2857142857142856,1,4,7,0
6.489859632378118e+17,144,273,1.8958333333333333,1,4,144,0
6.49040848341029e+17,88,432,4.909090909090909,3,7,88,0
6.490560338619918e+17,56,116,2.0714285714285716,1,4,56,0
6.490686994188169e+17,273,1366,5.003663003663004,2,9,269,4
6.491565647211475e+17,92,394,4.282608695652174,2,6,92,0
6.492726152856671e+17,102,899,8.813725490196079,4,11,11,91
6.492872059449993e+17,38,176,4.631578947368421,2,7,38,0
6.492909385213693e+17,4,13,3.25,3,4,4,0
6.496732302064657e+17,99,702,7.090909090909091,4,10,62,37
6.497067767848544e+17,176,886,5.034090909090909,2,8,174,2
6.497351985861782e+17,42,287,6.833333333333333,5,9,32,10
6.497432069329992e+17,1,3,3.0,3,3,1,0
6.497518860995762e+17,2,4,2.0,1,3,2,0
6.498340155962872e+17,11,26,2.3636363636363638,1,4,11,0
6.498677057812109e+17,41,196,4.780487804878049,2,7,41,0
6.498757464645034e+17,313,938,2.9968051118210863,1,6,313,0
6.499774006833262e+17,2,3,1.5,1,2,2,0
6.500346200794327e+17,65,142,2.1846153846153844,1,5,65,0
6.503209289122799e+17,31,218,7.032258064516129,5,9,19,12
6.503619251448709e+17,24,155,6.458333333333333,2,8,17,7
6.504025077467132e+17,112,231,2.0625,1,4,112,0
6.50415901845193e+17,192,564,2.9375,1,6,192,0
6.504269763530502e+17,117,580,4.957264957264957,2,7,117,0
6.504472964433473e+17,68,154,2.264705882352941,1,5,68,0
6.504859699948095e+17,7,22,3.142857142857143,1,6,7,0
6.505593776715158e+17,69,142,2.0579710144927534,1,5,69,0
6.5058260229606e+17,84,240,2.857142857142857,1,5,84,0
6.505845510219534e+17,17,88,5.176470588235294,4,8,16,1
6.506283333205734e+17,2,10,5.0,4,6,2,0
6.506778437110908e+17,40,89,2.225,1,4,40,0
6.507081077004914e+17,24,81,3.375,2,5,24,0
6.507871852690172e+17,200,587,2.935,1,6,200,0
6.508788231149786e+17,33,200,6.0606060606060606,4,8,32,1
6.5105837602174e+17,45,100,2.2222222222222223,1,4,45,0
6.51092486960306e+17,110,232,2.109090909090909,1,4,110,0
6.511314804978648e+17,2,4,2.0,2,2,2,0
6.51141059129101e+17,67,138,2.0597014925373136,1,4,67,0
6.512152827636643e+17,28,196,7.0,5,8,20,8
6.512233506730204e+17,86,800,9.30232558139535,2,12,8,78
6.512410191499493e+17,2,4,2.0,1,3,2,0
6.512460984936332e+17,2,4,2.0,2,2,2,0
6.512464421974811e+17,104,965,9.278846153846153,2,12,11,93
6.512465208439493e+17,136,650,4.779411764705882,2,7,136,0
6.512559418286189e+17,27,54,2.0,1,4,27,0
6.512648696264896e+17,13,40,3.076923076923077,2,4,13,0
6.512805011558765e+17,1,4,4.0,4,4,1,0
6.512839046491316e+17,16,46,2.875,1,4,16,0
6.512899177971913e+17,49,152,3.1020408163265305,1,5,49,0
6.51291278605605e+17,8,25,3.125,2,4,8,0
6.512925053113029e+17,1,3,3.0,3,3,1,0
6.513042196643939e+17,72,279,3.875,1,6,72,0
6.513603869457668e+17,1,6,6.0,6,6,1,0
6.513625823553855e+17,161,620,3.8509316770186337,1,7,161,0
6.513749589852772e+17,174,870,5.0,2,8,173,1
6.513918198466237e+17,17,89,5.235294117647059,4,7,17,0
6.514125968346779e+17,91,438,4.813186813186813,2,8,90,1
6.514352946398913e+17,2,12,6.0,5,7,2,0
6.514433420328186e+17,116,232,2.0,1,4,116,0
6.51500051322101e+17,35,338,9.657142857142857,6,13,2,33
6.515560893937463e+17,41,199,4.853658536585366,2,7,41,0
6.517691391368056e+17,34,63,1.8529411764705883,1,4,34,0
6.518041941234533e+17,1,7,7.0,7,7,1,0
6.518059026804294e+17,4,27,6.75,4,9,2,2
6.51860072066078e+17,130,272,2.0923076923076924,1,5,130,0
6.51871225436444e+17,202,1000,4.9504950495049505,1,8,201,1
6.520015669584637e+17,16,81,5.0625,3,7,16,0
6.520221038297727e+17,121,470,3.884297520661157,1,7,121,0
6.52094321563163e+17,10,80,8.0,6,10,4,6
6.521142861198281e+17,50,354,7.08,3,10,32,18
6.521546456949171e+17,15,101,6.733333333333333,4,9,12,3
6.52179962973618e+17,21,149,7.095238095238095,5,9,15,6
6.522471955733276e+17,23,172,7.478260869565218,6,9,12,11
6.522532894294262e+17,35,244,6.9714285714285715,5,9,25,10
6.522572214207565e+17,33,222,6.7272727272727275,5,9,26,7
6.522611189167456e+17,58,403,6.948275862068965,3,10,44,14
6.525649852969082e+17,25,129,5.16,3,7,25,0
6.525675516210916e+17,23,208,9.043478260869565,2,11,2,21
6.525936833779967e+17,249,2206,8.859437751004016,2,11,28,221
6.526454482498765e+17,18,73,4.055555555555555,2,5,18,0
6.527543581743085e+17,59,228,3.864406779661017,2,6,59,0
6.52767983127401e+17,13,15,1.1538461538461537,1,2,13,0
6.528386831136326e+17,2,21,10.5,9,12,0,2
6.52850304228835e+17,6,32,5.333333333333333,5,6,6,0
6.529161194901152e+17,15,47,3.1333333333333333,1,6,15,0
6.532097203270897e+17,5,31,6.2,4,8,4,1
6.532749148348125e+17,88,849,9.647727272727273,2,13,4,84
6.53300283260473e+17,71,156,2.1971830985915495,1,5,71,0
6.533098685034042e+17,136,669,4.919117647058823,2,8,135,1
6.533159613996808e+17,9,24,2.6666666666666665,2,4,9,0
6.5335721880749e+17,70,195,2.7857142857142856,1,5,70,0
6.5336882318497e+17,49,373,7.612244897959184,2,10,23,26
6.53403515578818e+17,12,14,1.1666666666666667,1,2,12,0
6.534105188142296e+17,21,26,1.2380952380952381,1,3,21,0
6.534247425717645e+17,21,47,2.238095238095238,1,4,21,0
6.534308898205139e+17,31,283,9.129032258064516,7,12,1,30
6.534397156499848e+17,3,4,1.3333333333333333,1,2,3,0
6.534415042515446e+17,9,35,3.888888888888889,2,6,9,0
6.534709450173864e+17,128,629,4.9140625,2,7,128,0
6.534785738722367e+17,84,572,6.809523809523809,3,9,59,25
6.534942074697274e+17,2,4,2.0,2,2,2,0
6.535680328004262e+17,3,22,7.333333333333333,7,8,2,1
6.535680926599587e+17,9,21,2.3333333333333335,1,4,9,0
6.535684279206676e+17,4,12,3.0,2,4,4,0
6.53597895629318e+17,9,74,8.222222222222221,6,10,1,8
6.538311539492124e+17,46,455,9.891304347826088,5,13,3,43
6.540175959522898e+17,8,45,5.625,4,8,7,1
6.540447438620841e+17,150,1164,7.76,2,10,51,99
6.540551448461996e+17,176,1191,6.767045454545454,2,9,132,44
6.540692733251446e+17,26,78,3.0,1,6,26,0
6.54080915562183e+17,1,3,3.0,3,3,1,0
6.541079112700298e+17,5,13,2.6,2,4,5,0
6.541177754226185e+17,27,240,8.88888888888889,4,11,1,26
6.541312617300316e+17,63,259,4.111111111111111,2,7,63,0
6.54138920355061e+17,9,68,7.555555555555555,6,9,5,4
6.541823800829437e+17,72,145,2.013888888888889,1,4,72,0
6.541959635004896e+17,201,788,3.9203980099502487,1,6,201,0
6.542187690277073e+17,112,775,6.919642857142857,2,9,78,34
6.542211455251743e+17,116,576,4.9655172413793105,2,7,116,0
6.54259950063005e+17,15,99,6.6,2,9,11,4
6.542666297987793e+17,44,88,2.0,1,4,44,0
6.547428680438766e+17,48,101,2.1041666666666665,1,5,48,0
6.547924182827776e+17,18,38,2.111111111111111,1,3,18,0
6.548827436062408e+17,84,409,4.869047619047619,2,7,84,0
6.549243935201167e+17,44,92,2.090909090909091,1,4,44,0
6.549244117056374e+17,85,170,2.0,1,4,85,0
6.54924483898732e+17,152,773,5.0855263157894735,2,9,151,1
6.549310173327657e+17,98,853,8.704081632653061,3,11,16,82
6.549785254949007e+17,15,116,7.733333333333333,6,10,7,8
6.549800772802355e+17,11,58,5.2727272727272725,2,8,10,1
6.549896780047199e+17,5,36,7.2,7,8,4,1
6.549930780572748e+17,4,38,9.5,9,10,0,4
6.550492505062706e+17,27,65,2.4074074074074074,1,4,27,0
6.55422767793772e+17,113,235,2.079646017699115,1,4,113,0
6.554305284654991e+17,57,492,8.631578947368421,2,11,7,50
6.55447805473615e+17,92,456,4.956521739130435,3,9,91,1
6.554480457037605e+17,46,108,2.347826086956522,1,5,46,0
6.554577359960385e+17,1,3,3.0,3,3,1,0
6.555062729996305e+17,41,89,2.1707317073170733,1,4,41,0
6.555521431646854e+17,1,3,3.0,3,3,1,0
6.555934426903124e+17,48,236,4.916666666666667,2,8,46,2
6.556009429327009e+17,1,3,3.0,3,3,1,0
6.556012300530826e+17,2,7,3.5,1,6,2,0
6.556077879603419e+17,57,391,6.859649122807017,3,9,41,16
6.556156939122779e+17,152,1036,6.815789473684211,2,10,109,43
6.556339708809354e+17,151,313,2.0728476821192054,1,5,151,0
6.556446173122408e+17,45,179,3.977777777777778,2,7,45,0
6.556446901473535e+17,1,4,4.0,4,4,1,0
6.556515694572027e+17,5,22,4.4,2,7,5,0
6.556526365246246e+17,45,175,3.888888888888889,2,6,45,0
6.556535815616676e+17,2,8,4.0,4,4,2,0
6.556545087661537e+17,8,39,4.875,3,6,8,0
6.556687153444883e+17,81,705,8.703703703703704,2,11,9,72
6.558172533177297e+17,11,37,3.3636363636363638,2,5,11,0
6.55836587568856e+17,14,39,2.7857142857142856,1,5,14,0
6.558999747906092e+17,84,567,6.75,4,9,67,17
6.559937033794561e+17,87,428,4.919540229885057,2,7,87,0
6.56159497933259e+17,8,56,7.0,6,8,6,2
6.561734858169096e+17,87,599,6.885057471264368,3,9,64,23
6.561802383150491e+17,74,363,4.905405405405405,2,7,74,0
6.561936634451671e+17,104,1006,9.673076923076923,3,12,8,96
6.562233117087054e+17,14,94,6.714285714285714,2,9,9,5
6.562522189378732e+17,7,12,1.7142857142857142,1,4,7,0
6.562751047044812e+17,3,8,2.6666666666666665,1,5,3,0
6.563687345480458e+17,6,17,2.8333333333333335,2,4,6,0
6.56369321634286e+17,2,6,3.0,3,3,2,0
6.563756691762412e+17,70,540,7.714285714285714,3,11,26,44
6.563778741879423e+17,205,1394,6.8,2,10,146,59
6.563878479013368e+17,3,25,8.333333333333334,8,9,0,3
6.563969907428186e+17,3,12,4.0,2,5,3,0
6.564481916519941e+17,49,100,2.0408163265306123,1,4,49,0
6.564643800023983e+17,13,38,2.923076923076923,1,6,13,0
6.564811902672916e+17,153,330,2.156862745098039,1,4,153,0
6.565397385521791e+17,168,1647,9.803571428571429,2,12,10,158
6.566053518496061e+17,19,123,6.473684210526316,5,8,15,4
6.568365170787603e+17,89,181,2.033707865168539,1,4,89,0
6.569611095601779e+17,89,444,4.98876404494382,3,8,88,1
6.569869552989562e+17,110,550,5.0,2,7,110,0
6.570115397764164e+17,70,611,8.728571428571428,3,11,8,62
6.570276676245279e+17,165,829,5.024242424242424,2,7,165,0
6.571428146379574e+17,40,126,3.15,1,5,40,0
6.571627547901686e+17,31,95,3.064516129032258,1,5,31,0
6.571684046428127e+17,11,83,7.545454545454546,3,9,3,8
6.572105450762862e+17,69,463,6.7101449275362315,2,9,50,19
6.572219924246925e+17,2,15,7.5,7,8,1,1
6.572644081130409e+17,79,364,4.6075949367088604,2,7,79,0
6.57693761690055e+17,25,124,4.96,2,7,25,0
6.577000328123096e+17,69,399,5.782608695652174,2,9,64,5
6.577132866973567e+17,76,736,9.68421052631579,4,12,2,74
6.577146878543113e+17,49,294,6.0,2,8,46,3
6.578673590969647e+17,2,7,3.5,3,4,2,0
6.579220291746907e+17,226,1102,4.876106194690266,2,8,225,1
6.579481925753519e+17,150,756,5.04,2,8,149,1
6.57982343933181e+17,51,145,2.843137254901961,1,5,51,0
6.580044300949583e+17,48,376,7.833333333333333,2,10,16,32
6.580191917493528e+17,1,8,8.0,8,8,0,1
6.58042137713287e+17,3,16,5.333333333333333,4,7,3,0
6.583689552163994e+17,114,221,1.9385964912280702,1,4,114,0
6.583973563191226e+17,18,125,6.944444444444445,5,10,14,4
6.584176672332236e+17,1,4,4.0,4,4,1,0
6.584500135997779e+17,14,112,8.0,7,9,4,10
6.585009484161021e+17,12,38,3.1666666666666665,1,6,12,0
6.585010656010684e+17,1,1,1.0,1,1,1,0
6.585012366779581e+17,7,21,3.0,1,4,7,0
6.585013678067964e+17,3,9,3.0,3,3,3,0
6.586099154311085e+17,105,706,6.723809523809524,2,10,82,23
6.586125641029563e+17,115,237,2.0608695652173914,1,4,115,0
6.586424128953556e+17,2,2,1.0,1,1,2,0
6.586529472656698e+17,9,14,1.5555555555555556,1,3,9,0
6.586551847484732e+17,1,3,3.0,3,3,1,0
6.586596940448211e+17,3,3,1.0,1,1,3,0
6.586607918648012e+17,53,261,4.9245283018867925,2,8,52,1
6.58717269880942e+17,68,271,3.985294117647059,2,6,68,0
6.587443038334158e+17,18,161,8.944444444444445,3,11,3,15
6.587735609576877e+17,2,8,4.0,3,5,2,0
6.590392651415804e+17,13,93,7.153846153846154,3,9,7,6
6.590961041516417e+17,72,348,4.833333333333333,2,7,72,0
6.591051991235827e+17,19,146,7.684210526315789,2,9,4,15
6.591215925299489e+17,12,26,2.1666666666666665,1,4,12,0
6.59123054635759e+17,58,286,4.931034482758621,2,7,58,0
6.592049033580436e+17,4,33,8.25,8,9,0,4
6.592054367644096e+17,38,341,8.973684210526315,5,11,2,36
6.592640919528422e+17,135,1136,8.414814814814815,2,12,27,108
6.592715190770621e+17,14,92,6.571428571428571,4,9,11,3
6.592715807481326e+17,1,7,7.0,7,7,1,0
6.592737534031068e+17,25,74,2.96,1,5,25,0
6.592848846085498e+17,3,21,7.0,7,7,3,0
6.593302407852269e+17,35,269,7.685714285714286,2,10,11,24
6.593303756892216e+17,31,157,5.064516129032258,2,7,31,0
6.593319952306789e+17,14,25,1.7857142857142858,1,4,14,0
6.593377730493791e+17,8,10,1.25,1,2,8,0
6.59338820860875e+17,46,424,9.217391304347826,7,12,1,45
6.593550030654246e+17,19,125,6.578947368421052,5,9,15,4
6.594050207564908e+17,6,43,7.166666666666667,7,8,5,1
6.594244903754852e+17,77,364,4.7272727272727275,2,7,77,0
6.594505855489247e+17,37,150,4.054054054054054,1,6,37,0
6.594644176619643e+17,12,108,9.0,7,11,1,11
6.596496872254277e+17,13,87,6.6923076923076925,5,8,10,3
6.59786032315435e+17,39,84,2.1538461538461537,1,4,39,0
6.598476005604539e+17,98,959,9.785714285714286,3,13,3,95
6.599717729698886e+17,16,37,2.3125,1,4,16,0
6.600959843492643e+17,194,1305,6.72680412371134,2,9,142,52
6.60128357628261e+17,124,629,5.07258064516129,2,8,123,1
6.601326463441329e+17,15,111,7.4,6,9,9,6
6.601395005378524e+17,2,3,1.5,1,2,2,0
6.60146344334075e+17,138,671,4.86231884057971,2,9,136,2
6.601774242061998e+17,62,292,4.709677419354839,2,8,61,1
6.602795781042276e+17,1,6,6.0,6,6,1,0
6.604981490684485e+17,38,259,6.815789473684211,2,8,29,9
6.605355970999421e+17,86,192,2.2325581395348837,1,4,86,0
6.605372742582322e+17,98,658,6.714285714285714,2,9,76,22
6.605857756500539e+17,5,7,1.4,1,2,5,0
6.605927635422921e+17,5,7,1.4,1,2,5,0
6.606033154824564e+17,2,6,3.0,3,3,2,0
6.606292814409457e+17,1,4,4.0,4,4,1,0
6.606722233820549e+17,146,716,4.904109589041096,2,8,144,2
6.607286061303406e+17,123,255,2.073170731707317,1,4,123,0
6.60741357327306e+17,48,480,10.0,6,11,2,46
6.60768168439825e+17,186,1796,9.655913978494624,2,13,10,176
6.607690100926035e+17,95,206,2.168421052631579,1,4,95,0
6.608033632480502e+17,20,67,3.35,1,6,20,0
6.608328398931704e+17,100,203,2.03,1,4,100,0
6.608517654792145e+17,66,262,3.9696969696969697,2,6,66,0
6.608598593155242e+17,76,312,4.105263157894737,2,7,76,0
6.609006818290294e+17,15,36,2.4,1,5,15,0
6.609291788609368e+17,4,9,2.25,2,3,4,0
6.609633642632823e+17,11,28,2.5454545454545454,1,4,11,0
6.609676351671501e+17,68,469,6.897058823529412,2,9,47,21
6.612092828443208e+17,248,1948,7.854838709677419,2,11,82,166
6.61249348312272e+17,54,371,6.87037037037037,2,10,38,16
6.612851281224307e+17,6,14,2.3333333333333335,1,3,6,0
6.6139552364065e+17,51,250,4.901960784313726,2,7,51,0
6.614774188965009e+17,9,44,4.888888888888889,3,7,9,0
6.615166705493824e+17,13,97,7.461538461538462,2,11,5,8
6.615829509260154e+17,60,124,2.066666666666667,1,4,60,0
6.616246617445736e+17,213,1861,8.737089201877934,2,12,29,184
6.616664611891092e+17,78,635,8.14102564102564,2,11,20,58
6.61674440160675e+17,28,172,6.142857142857143,4,9,26,2
6.616853604806493e+17,20,109,5.45,4,7,20,0
6.617459698387854e+17,14,130,9.285714285714286,7,11,1,13
6.619491430471972e+17,9,91,10.11111111111111,8,11,0,9
6.619596134587048e+17,23,231,10.043478260869565,8,12,0,23
6.620656923655722e+17,31,282,9.096774193548388,2,12,5,26
6.620779666761778e+17,2,4,2.0,2,2,2,0
6.621538178715683e+17,4,9,2.25,1,4,4,0
6.621559672208928e+17,16,163,10.1875,9,12,0,16
6.62176684531751e+17,60,288,4.8,2,7,60,0
6.621875309940703e+17,3,27,9.0,7,11,1,2
6.622161647454858e+17,9,53,5.888888888888889,4,7,9,0
6.622226436466156e+17,7,69,9.857142857142858,9,11,0,7
6.62308790654049e+17,7,11,1.5714285714285714,1,3,7,0
6.623133754682866e+17,265,2535,9.566037735849056,2,13,16,249
6.623793507394737e+17,50,492,9.84,4,12,3,47
6.627664895287598e+17,18,52,2.888888888888889,1,5,18,0
6.629814047451036e+17,48,431,8.979166666666666,5,11,8,40
6.630253306150264e+17,3,14,4.666666666666667,4,5,3,0
6.630402517638317e+17,18,119,6.611111111111111,4,9,13,5
6.63439437414367e+17,71,546,7.690140845070423,2,11,23,48
6.634771364905382e+17,33,233,7.0606060606060606,2,9,19,14
6.63501471409695e+17,6,16,2.6666666666666665,1,4,6,0
6.63513012415017e+17,3,28,9.333333333333334,8,10,0,3
6.635151161723462e+17,1,1,1.0,1,1,1,0
6.635155745376758e+17,185,536,2.8972972972972975,1,5,185,0
6.635587046917492e+17,9,59,6.555555555555555,5,8,7,2
6.635647948595406e+17,13,69,5.3076923076923075,3,7,13,0
6.635873177993654e+17,17,37,2.176470588235294,1,4,17,0
6.635922480910164e+17,31,235,7.580645161290323,4,10,9,22
6.635923857615008e+17,12,23,1.9166666666666667,1,4,12,0
6.63626148442044e+17,19,39,2.0526315789473686,1,4,19,0
6.637241051141711e+17,6,50,8.333333333333334,8,9,0,6
6.637348829271137e+17,17,141,8.294117647058824,2,11,5,12
6.637626729930619e+17,46,389,8.456521739130435,5,10,5,41
6.641078384246227e+17,2,4,2.0,1,3,2,0
6.64145414584973e+17,1,2,2.0,2,2,1,0
6.641552270769299e+17,15,34,2.2666666666666666,1,4,15,0
6.641640780603251e+17,60,119,1.9833333333333334,1,5,60,0
6.6417476486683e+17,13,16,1.2307692307692308,1,2,13,0
6.641797376520493e+17,9,30,3.3333333333333335,2,4,9,0
6.642184647976864e+17,15,18,1.2,1,3,15,0
6.642274035740604e+17,187,1621,8.668449197860962,3,11,29,158
6.642745760181276e+17,32,245,7.65625,3,9,12,20
6.642816427471859e+17,81,779,9.617283950617283,2,12,7,74
6.643132616785522e+17,21,150,7.142857142857143,4,10,14,7
6.643133767080045e+17,32,71,2.21875,1,4,32,0
6.643269567494333e+17,28,245,8.75,5,11,5,23
6.643453918786824e+17,48,107,2.2291666666666665,1,4,48,0
6.643467777191916e+17,44,86,1.9545454545454546,1,4,44,0
6.643645425551546e+17,2,5,2.5,2,3,2,0
6.643941294712207e+17,1,1,1.0,1,1,1,0
6.643984986949216e+17,70,344,4.914285714285715,2,7,70,0
6.64411557550853e+17,5,11,2.2,1,3,5,0
6.64412467151667e+17,38,110,2.8947368421052633,1,6,38,0
6.64419672491324e+17,21,98,4.666666666666667,3,6,21,0
6.644380375043707e+17,59,359,6.084745762711864,4,8,55,4
6.644495728413252e+17,27,57,2.111111111111111,1,4,27,0
6.644597832756236e+17,132,658,4.984848484848484,2,8,130,2
6.645207627487963e+17,65,177,2.723076923076923,1,5,65,0
6.645493332672111e+17,6,15,2.5,1,4,6,0
6.64606002507666e+17,71,275,3.8732394366197185,2,8,70,1
6.648189872469806e+17,1,4,4.0,4,4,1,0
6.649439944871002e+17,3,5,1.6666666666666667,1,2,3,0
6.649543786105842e+17,20,162,8.1,5,10,5,15
6.649619177133486e+17,35,272,7.771428571428571,3,11,16,19
6.649871275886327e+17,26,224,8.615384615384615,2,11,4,22
6.650175063743717e+17,70,496,7.085714285714285,4,9,42,28
6.650302294782774e+17,45,353,7.844444444444444,4,10,17,28
6.650746810834477e+17,24,86,3.5833333333333335,2,5,24,0
6.65235109170047e+17,2,3,1.5,1,2,2,0
6.652578281221929e+17,11,20,1.8181818181818181,1,3,11,0
6.655299734625915e+17,110,546,4.963636363636364,2,7,110,0
6.655691480741299e+17,67,452,6.746268656716418,2,9,48,19
6.65593853518415e+17,57,107,1.8771929824561404,1,4,57,0
6.656411658472413e+17,31,185,5.967741935483871,4,8,29,2
6.65655694634306e+17,115,558,4.852173913043479,2,7,115,0
6.656936970813005e+17,45,346,7.688888888888889,6,9,19,26
6.658280419182734e+17,20,64,3.2,1,5,20,0
6.658947265157684e+17,86,576,6.6976744186046515,2,9,70,16
6.659094116884307e+17,69,463,6.7101449275362315,3,9,56,13
6.659201367377407e+17,60,306,5.1,2,8,59,1
6.660454628356307e+17,37,187,5.054054054054054,3,8,36,1
6.662782027313242e+17,141,573,4.0638297872340425,1,7,141,0
6.663475719419844e+17,200,1402,7.01,4,10,140,60
6.663485122638039e+17,15,48,3.2,2,5,15,0
6.664107085072698e+17,131,898,6.854961832061068,2,9,89,42
6.664406229639986e+17,56,376,6.714285714285714,2,9,41,15
6.664516341686264e+17,13,36,2.769230769230769,1,5,13,0
6.664708823397261e+17,166,814,4.903614457831325,2,7,166,0
6.665308896886624e+17,37,76,2.054054054054054,1,4,37,0
6.665508345913908e+17,3,4,1.3333333333333333,1,2,3,0
6.665739958593816e+17,137,699,5.102189781021898,2,7,137,0
6.666517165258472e+17,15,121,8.066666666666666,4,11,4,11
6.666723274501261e+17,64,133,2.078125,1,4,64,0
6.667807939413596e+17,18,174,9.666666666666666,5,12,1,17
6.671447721660627e+17,101,310,3.0693069306930694,1,5,101,0
6.671499018250205e+17,14,90,6.428571428571429,2,8,12,2
6.671650585786289e+17,87,163,1.8735632183908046,1,4,87,0
6.672213836561786e+17,22,45,2.0454545454545454,1,3,22,0
6.672313727478632e+17,58,404,6.9655172413793105,3,9,44,14
6.672336015246487e+17,34,332,9.764705882352942,4,12,2,32
6.672354003316631e+17,62,558,9.0,2,12,8,54
6.67242118784992e+17,20,193,9.65,6,11,1,19
6.672710335727162e+17,128,1218,9.515625,2,13,10,118
6.672724129916534e+17,35,115,3.2857142857142856,1,5,35,0
6.672751313517144e+17,5,23,4.6,2,6,5,0
6.673385354265329e+17,179,376,2.100558659217877,1,5,179,0
6.677878517950863e+17,8,11,1.375,1,2,8,0
6.677961795619695e+17,6,8,1.3333333333333333,1,2,6,0
6.678302349576449e+17,3,4,1.3333333333333333,1,2,3,0
6.679652143590376e+17,46,409,8.891304347826088,5,11,6,40
6.680063068952957e+17,1,8,8.0,8,8,0,1
6.680553359955807e+17,5,8,1.6,1,3,5,0
6.680578172906779e+17,58,554,9.551724137931034,5,12,5,53
6.680800151994007e+17,225,894,3.973333333333333,1,7,225,0
6.681110108334858e+17,7,15,2.142857142857143,2,3,7,0
6.681342933850778e+17,32,279,8.71875,2,11,4,28
6.681419152609599e+17,17,52,3.0588235294117645,1,5,17,0
6.681762945365311e+17,8,76,9.5,9,11,0,8
6.684514006147933e+17,32,63,1.96875,1,4,32,0
6.684610789351712e+17,97,871,8.97938144329897,2,13,10,87
6.68502504953998e+17,39,125,3.2051282051282053,1,6,39,0
6.685169685656037e+17,1,2,2.0,2,2,1,0
6.685956484928684e+17,21,162,7.714285714285714,7,9,8,13
6.686376332117404e+17,27,217,8.037037037037036,6,10,9,18
6.686564140711729e+17,173,1644,9.502890173410405,2,12,10,163
6.686816215541065e+17,2,8,4.0,4,4,2,0
6.688888843485101e+17,60,576,9.6,2,13,5,55
6.689166876858835e+17,55,377,6.8545454545454545,2,9,32,23
6.691855824503951e+17,3,5,1.6666666666666667,1,2,3,0
6.692646379252329e+17,9,18,2.0,1,3,9,0
6.692759868631054e+17,72,275,3.8194444444444446,2,6,72,0
6.692805324192675e+17,81,564,6.962962962962963,3,9,57,24
6.693150837335909e+17,134,1289,9.619402985074627,3,12,8,126
6.693830281977542e+17,2,2,1.0,1,1,2,0
6.694015923394061e+17,2,13,6.5,6,7,2,0
6.69401681247195e+17,7,14,2.0,1,3,7,0
6.694082013271644e+17,1,1,1.0,1,1,1,0
6.694504595430447e+17,1,4,4.0,4,4,1,0
6.694505580355954e+17,21,29,1.380952380952381,1,3,21,0
6.694542239327899e+17,49,248,5.061224489795919,3,8,48,1
6.694559570860293e+17,97,489,5.041237113402062,3,7,97,0
6.694560046899107e+17,1,1,1.0,1,1,1,0
6.694647414820951e+17,1,1,1.0,1,1,1,0
6.695659888337755e+17,45,212,4.711111111111111,2,7,45,0
6.699527113355958e+17,22,177,8.045454545454545,6,10,8,14
6.699737365775763e+17,60,299,4.983333333333333,3,7,60,0
6.699798729905174e+17,104,204,1.9615384615384615,1,5,104,0
6.70011316904003e+17,5,42,8.4,7,10,2,3
6.700148130681335e+17,15,121,8.066666666666666,6,9,4,11
6.700181100092823e+17,14,29,2.0714285714285716,1,4,14,0
6.700326277508476e+17,153,310,2.026143790849673,1,4,153,0
6.702075968958348e+17,34,78,2.2941176470588234,1,4,34,0
6.702645859911089e+17,148,603,4.074324324324325,1,7,148,0
6.702962233054102e+17,2,4,2.0,1,3,2,0
6.702974186122588e+17,24,242,10.083333333333334,7,12,1,23
6.703693627534423e+17,7,21,3.0,1,4,7,0
6.706220362452024e+17,11,96,8.727272727272727,7,10,2,9
6.706531724211958e+17,29,245,8.448275862068966,3,11,3,26
6.706846009031162e+17,166,1145,6.897590361445783,2,9,113,53
6.706956510908672e+17,42,289,6.880952380952381,3,10,27,15
6.707346607754097e+17,95,647,6.810526315789474,2,9,65,30
6.707384480010205e+17,26,128,4.923076923076923,3,7,26,0
6.707566482207028e+17,19,40,2.1052631578947367,1,3,19,0
6.707741458995914e+17,2,6,3.0,2,4,2,0
6.70782364112938e+17,40,277,6.925,4,9,27,13
6.708172725145582e+17,29,228,7.862068965517241,6,10,12,17
6.709026652279423e+17,30,148,4.933333333333334,3,7,30,0
6.709449988122886e+17,83,409,4.927710843373494,2,8,82,1
6.709866192280419e+17,77,760,9.87012987012987,2,13,3,74
6.709912161765217e+17,171,243,1.4210526315789473,1,4,171,0
6.710194657591878e+17,3,17,5.666666666666667,5,6,3,0
6.710284766162029e+17,97,467,4.814432989690721,2,8,96,1
6.713700928872261e+17,90,277,3.077777777777778,1,5,90,0
6.713855855441292e+17,125,1218,9.744,2,13,7,118
6.713858589008032e+17,51,98,1.9215686274509804,1,5,51,0
6.713972321952072e+17,26,57,2.1923076923076925,1,4,26,0
6.71423252789512e+17,53,108,2.0377358490566038,1,5,53,0
6.714274080921408e+17,5,17,3.4,3,5,5,0
6.714349527318806e+17,69,211,3.0579710144927534,1,6,69,0
6.714793845412865e+17,2,3,1.5,1,2,2,0
6.714925174306442e+17,6,35,5.833333333333333,2,8,5,1
6.715010975025257e+17,3,12,4.0,3,5,3,0
6.715085217050957e+17,103,598,5.805825242718447,2,9,98,5
6.715179676882415e+17,5,16,3.2,3,4,5,0
6.715398901937435e+17,51,400,7.8431372549019605,5,10,20,31
6.715413207263433e+17,152,1441,9.480263157894736,2,12,12,140
6.715501240975594e+17,1,7,7.0,7,7,1,0
6.716177116013308e+17,47,307,6.531914893617022,2,9,37,10
6.716219757395165e+17,212,436,2.056603773584906,1,5,212,0
6.717135813483677e+17,67,338,5.044776119402985,2,7,67,0
6.71735729242187e+17,188,930,4.946808510638298,2,7,188,0
6.717484560059365e+17,6,39,6.5,5,9,5,1
6.717804129923619e+17,1,6,6.0,6,6,1,0
6.717981479844102e+17,47,364,7.74468085106383,2,10,18,29
6.718011569018861e+17,32,193,6.03125,4,9,28,4
6.720994618348067e+17,36,251,6.972222222222222,5,10,28,8
6.721142178873389e+17,24,88,3.6666666666666665,2,6,24,0
6.721756785158973e+17,145,738,5.089655172413793,3,8,144,1
6.722093887704818e+17,173,874,5.0520231213872835,2,8,170,3
6.722228907473225e+17,5,42,8.4,7,9,1,4
6.722519419925706e+17,13,65,5.0,3,7,13,0
6.72293681430476e+17,4,12,3.0,2,5,4,0
6.723149439098231e+17,56,564,10.071428571428571,7,13,1,55
6.723175509953263e+17,150,728,4.8533333333333335,2,7,150,0
6.723913937494705e+17,30,226,7.533333333333333,2,11,14,16
6.724042228010729e+17,194,746,3.845360824742268,1,6,194,0
6.72404303820269e+17,186,743,3.9946236559139785,2,6,186,0
6.724201538590354e+17,25,174,6.96,3,9,17,8
6.724520971260671e+17,1,2,2.0,2,2,1,0
6.724692723176936e+17,5,8,1.6,1,2,5,0
6.725474184068566e+17,13,28,2.1538461538461537,1,4,13,0
6.728034332900381e+17,3,9,3.0,2,4,3,0
6.728058764060544e+17,73,299,4.095890410958904,2,6,73,0
6.728342733289212e+17,198,981,4.954545454545454,2,7,198,0
6.728444982111398e+17,33,95,2.878787878787879,2,6,33,0
6.729290308689258e+17,5,19,3.8,3,5,5,0
6.72930894275087e+17,79,768,9.721518987341772,2,12,4,75
6.73007493629606e+17,99,577,5.828282828282828,2,8,89,10
6.73032470516613e+17,5,10,2.0,1,4,5,0
6.730701983641143e+17,173,866,5.005780346820809,2,8,172,1
6.731110686371926e+17,4,28,7.0,6,9,3,1
6.731223965863052e+17,171,1504,8.7953216374269,2,12,17,154
6.732123726964264e+17,98,304,3.1020408163265305,1,5,98,0
6.73234238664284e+17,97,293,3.020618556701031,1,6,97,0
6.732405408035703e+17,78,295,3.782051282051282,1,7,78,0
6.734050789644628e+17,113,480,4.247787610619469,2,6,113,0
6.735716353261624e+17,54,72,1.3333333333333333,1,3,54,0
6.735902504470431e+17,12,26,2.1666666666666665,1,3,12,0
6.736787205319158e+17,1,3,3.0,3,3,1,0
6.736874022307384e+17,13,90,6.923076923076923,5,9,9,4
6.737025054109578e+17,7,12,1.7142857142857142,1,4,7,0
6.737035159218056e+17,20,141,7.05,4,9,15,5
6.73706579752678e+17,16,30,1.875,1,4,16,0
6.737183469571305e+17,120,817,6.808333333333334,4,9,82,38
6.737490347580104e+17,99,955,9.646464646464647,2,13,6,93
6.737750019486636e+17,2,2,1.0,1,1,2,0
6.738079045397916e+17,3,9,3.0,2,4,3,0
6.738212554071764e+17,2,11,5.5,5,6,2,0
6.738435844742941e+17,124,877,7.07258064516129,3,10,81,43
6.738533623576513e+17,70,145,2.0714285714285716,1,4,70,0
6.738715093074595e+17,3,5,1.6666666666666667,1,2,3,0
6.739407703278527e+17,20,135,6.75,4,8,13,7
6.73972409605507e+17,17,110,6.470588235294118,3,8,13,4
6.739724568054812e+17,23,158,6.869565217391305,5,9,17,6
6.742513552638579e+17,1,1,1.0,1,1,1,0
6.742810530109377e+17,1,3,3.0,3,3,1,0
6.742995856639148e+17,171,827,4.83625730994152,2,7,171,0
6.743106327402081e+17,3,24,8.0,7,9,1,2
6.743128242418281e+17,3,17,5.666666666666667,4,7,3,0
6.743411039672206e+17,21,144,6.857142857142857,5,9,16,5
6.743853111078394e+17,14,93,6.642857142857143,4,9,11,3
6.744587214461153e+17,11,49,4.454545454545454,3,6,11,0
6.744702907557809e+17,304,2691,8.851973684210526,2,13,26,278
6.744796484205932e+17,29,205,7.068965517241379,5,9,21,8
6.744998518953161e+17,10,78,7.8,6,9,3,7
6.745130936782164e+17,30,59,1.9666666666666666,1,4,30,0
6.745678028062008e+17,12,27,2.25,1,4,12,0
6.747772947150675e+17,122,353,2.8934426229508197,1,6,122,0
6.749681639445549e+17,24,229,9.541666666666666,3,12,1,23
6.749929568076554e+17,62,421,6.790322580645161,4,9,42,20
6.7500416653552e+17,26,180,6.923076923076923,4,9,15,11
6.75011114180572e+17,90,429,4.766666666666667,2,8,89,1
6.750453552775377e+17,12,77,6.416666666666667,4,8,10,2
6.751297232168961e+17,11,71,6.454545454545454,5,8,10,1
6.751376845230217e+17,27,187,6.925925925925926,5,9,20,7
6.751672833952782e+17,12,71,5.916666666666667,4,9,11,1
6.752351647507242e+17,2,3,1.5,1,2,2,0
6.752500048368905e+17,82,416,5.073170731707317,2,7,82,0
6.75337485936813e+17,31,223,7.193548387096774,4,8,20,11
6.753991511072246e+17,24,246,10.25,8,13,0,24
6.757789642646129e+17,13,49,3.769230769230769,3,5,13,0
6.757796868499658e+17,22,155,7.045454545454546,6,9,18,4
6.758147107432428e+17,80,299,3.7375,1,6,80,0
6.758739690453676e+17,23,163,7.086956521739131,5,9,16,7
6.758756313119907e+17,14,56,4.0,2,6,14,0
6.758806766494029e+17,2,16,8.0,7,9,1,1
6.759470313555794e+17,6,40,6.666666666666667,6,7,6,0
6.760047057943199e+17,29,284,9.793103448275861,8,12,0,29
6.760174164025553e+17,3,31,10.333333333333334,10,11,0,3
6.760757460062819e+17,2,3,1.5,1,2,2,0
6.760857637823494e+17,145,1434,9.889655172413793,2,13,5,140
6.761088380347187e+17,1,3,3.0,3,3,1,0
6.762278927142853e+17,5,8,1.6,1,3,5,0
6.763566956131717e+17,3,9,3.0,2,4,3,0
6.76456804610406e+17,27,53,1.962962962962963,1,3,27,0
6.76466895120218e+17,15,29,1.9333333333333333,1,4,15,0
6.764719159521004e+17,41,80,1.951219512195122,1,4,41,0
6.764875886001938e+17,5,32,6.4,4,8,4,1
6.764884962229001e+17,13,30,2.3076923076923075,1,4,13,0
6.764908653274999e+17,11,84,7.636363636363637,6,9,4,7
6.765284902153446e+17,63,613,9.73015873015873,4,12,4,59
6.765301446985728e+17,16,109,6.8125,5,8,12,4
6.765455583160261e+17,64,140,2.1875,1,4,64,0
6.765599149512927e+17,12,56,4.666666666666667,2,6,12,0
6.765600724304067e+17,1,2,2.0,2,2,1,0
6.766340438867418e+17,11,44,4.0,2,5,11,0
6.767493192929112e+17,2,5,2.5,2,3,2,0
6.767820590526331e+17,14,28,2.0,1,5,14,0
6.767883841645147e+17,1,1,1.0,1,1,1,0
6.772563900777138e+17,69,520,7.536231884057971,2,11,30,39
6.772595277187186e+17,8,38,4.75,3,6,8,0
6.773141479912116e+17,21,150,7.142857142857143,5,8,13,8
6.773517797959318e+17,6,51,8.5,7,10,1,5
6.775263102392413e+17,359,1423,3.9637883008356547,1,7,359,0
6.77570932073619e+17,101,971,9.613861386138614,2,13,6,95
6.782026671563963e+17,74,216,2.918918918918919,1,5,74,0
6.782172478209414e+17,85,839,9.870588235294118,3,12,1,84
6.786842752416627e+17,184,1826,9.923913043478262,2,13,6,178
6.78699787724721e+17,54,276,5.111111111111111,3,7,54,0
6.787117080137156e+17,15,44,2.933333333333333,1,4,15,0
6.787261039729978e+17,89,439,4.932584269662922,2,8,88,1
6.7872764154488e+17,67,316,4.7164179104477615,2,7,67,0
6.787609341148874e+17,112,467,4.169642857142857,1,7,112,0
6.788098074643427e+17,242,2125,8.78099173553719,2,11,29,213
6.788234501494413e+17,2,2,1.0,1,1,2,0
6.788395114405646e+17,26,157,6.038461538461538,4,8,25,1
6.788466634221194e+17,5,13,2.6,1,3,5,0
6.788535787031519e+17,158,1382,8.746835443037975,2,11,21,137
6.78863668140978e+17,277,2412,8.707581227436823,2,12,30,247
6.788658875197437e+17,2,4,2.0,1,3,2,0
6.788694507298949e+17,1,1,1.0,1,1,1,0
6.788732417280682e+17,104,398,3.826923076923077,2,6,104,0
6.78885614618009e+17,53,315,5.943396226415095,2,8,49,4
6.789098258355642e+17,120,233,1.9416666666666667,1,4,120,0
6.789246847432376e+17,27,231,8.555555555555555,2,11,3,24
6.78996658231803e+17,5,40,8.0,7,9,1,4
6.790076854556042e+17,28,236,8.428571428571429,4,10,6,22
6.790865759391325e+17,31,242,7.806451612903226,6,10,15,16
6.791153845395526e+17,64,484,7.5625,2,11,29,35
6.793451457774542e+17,103,1024,9.941747572815533,6,12,3,100
6.793657102913692e+17,10,74,7.4,2,9,3,7
6.793883077444278e+17,10,39,3.9,3,6,10,0
6.793916789555889e+17,84,169,2.011904761904762,1,5,84,0
6.794070012388346e+17,2,13,6.5,6,7,2,0
6.794125224470824e+17,14,77,5.5,2,7,14,0
6.794715209006061e+17,134,911,6.798507462686567,4,10,98,36
6.795848365522061e+17,1,2,2.0,2,2,1,0
6.796134484257908e+17,33,73,2.212121212121212,1,5,33,0
6.796138946514776e+17,92,448,4.869565217391305,2,8,90,2
6.796803110412576e+17,95,192,2.0210526315789474,1,5,95,0
6.800459995999779e+17,11,53,4.818181818181818,3,7,11,0
6.801237096188577e+17,57,120,2.1052631578947367,1,5,57,0
6.801635179799479e+17,86,256,2.9767441860465116,1,6,86,0
6.801699298245964e+17,32,198,6.1875,3,8,31,1
6.801721914037362e+17,34,71,2.088235294117647,1,4,34,0
6.801819364596424e+17,74,693,9.364864864864865,3,12,8,66
6.802105469443314e+17,22,154,7.0,5,9,16,6
6.802289866393412e+17,59,412,6.983050847457627,4,10,39,20
6.802761400726744e+17,7,50,7.142857142857143,6,9,5,2
6.803525060362001e+17,11,111,10.090909090909092,8,12,0,11
6.803634430703732e+17,8,68,8.5,2,12,2,6
6.803823386749092e+17,28,252,9.0,2,11,3,25
6.804164031563581e+17,5,41,8.2,7,9,2,3
6.80416963520953e+17,33,234,7.090909090909091,5,10,22,11
6.804320943764259e+17,4,35,8.75,8,9,0,4
6.804369622699489e+17,80,684,8.55,2,11,11,69
6.804382680465729e+17,89,433,4.865168539325842,2,8,87,2
6.804781968464041e+17,51,253,4.96078431372549,3,7,51,0
6.805627998022876e+17,52,506,9.73076923076923,4,13,2,50
6.808050049175781e+17,77,383,4.974025974025974,3,7,77,0
6.808162406657339e+17,34,50,1.4705882352941178,1,3,34,0
6.808502085545105e+17,47,96,2.0425531914893615,1,4,47,0
6.808609114448465e+17,1,1,1.0,1,1,1,0
6.808852174418513e+17,18,182,10.11111111111111,5,13,1,17
6.808870428645769e+17,1,1,1.0,1,1,1,0
6.808878601777645e+17,41,279,6.804878048780488,5,8,31,10
6.808990498203931e+17,14,137,9.785714285714286,8,11,0,14
6.809193675042794e+17,194,1859,9.582474226804123,2,12,13,181
6.809242104567837e+17,82,793,9.670731707317072,2,13,5,77
6.809313251766708e+17,39,367,9.41025641025641,2,12,2,37
6.809340787548586e+17,5,44,8.8,7,10,1,4
6.809373228620717e+17,10,62,6.2,3,8,8,2
6.80938206353428e+17,12,114,9.5,2,12,1,11
6.809413868292516e+17,2,3,1.5,1,2,2,0
6.809423627570697e+17,35,339,9.685714285714285,2,12,1,34
6.809495885483849e+17,10,90,9.0,3,11,1,9
6.809502549357056e+17,75,507,6.76,2,10,53,22
6.809537092034812e+17,85,257,3.023529411764706,1,6,85,0
6.80956833449076e+17,24,225,9.375,3,11,3,21
6.809762642224563e+17,41,360,8.78048780487805,2,11,7,34
6.811003040406606e+17,38,85,2.236842105263158,1,4,38,0
6.811113721642036e+17,3,16,5.333333333333333,5,6,3,0
6.81114489380308e+17,16,100,6.25,2,8,14,2
6.811146397385965e+17,10,68,6.8,2,9,5,5
6.811147236767521e+17,10,67,6.7,4,9,7,3
6.81114824375478e+17,23,165,7.173913043478261,5,9,14,9
6.811181076327589e+17,23,172,7.478260869565218,5,9,9,14
6.811679550277153e+17,233,2250,9.656652360515022,2,13,18,215
6.815202205737777e+17,16,40,2.5,1,4,16,0
6.815441969178646e+17,13,94,7.230769230769231,4,9,7,6
6.815738703442299e+17,143,705,4.93006993006993,2,8,141,2
6.815872339956009e+17,2,3,1.5,1,2,2,0
6.816610246958292e+17,1,2,2.0,2,2,1,0
6.816766192706884e+17,146,688,4.712328767123288,2,8,144,2
6.816926378850563e+17,9,38,4.222222222222222,2,5,9,0
6.817276281633596e+17,24,50,2.0833333333333335,1,4,24,0
6.817277884119246e+17,64,130,2.03125,1,4,64,0
6.817293466025751e+17,35,74,2.1142857142857143,1,5,35,0
6.81730684902179e+17,67,136,2.029850746268657,1,4,67,0
6.817386601964865e+17,1,3,3.0,3,3,1,0
6.817521895503352e+17,46,323,7.021739130434782,5,10,32,14
6.817903980844774e+17,54,474,8.777777777777779,5,11,8,46
6.817926672823455e+17,165,1556,9.43030303030303,2,13,13,152
6.818072416646623e+17,29,36,1.2413793103448276,1,2,29,0
6.818703991193838e+17,15,75,5.0,4,7,15,0
6.81984646970779e+17,1,10,10.0,10,10,0,1
6.822526809575808e+17,21,82,3.9047619047619047,2,5,21,0
6.823133133414112e+17,80,689,8.6125,2,11,12,68
6.823547931266217e+17,31,146,4.709677419354839,3,7,31,0
6.823905243073508e+17,30,38,1.2666666666666666,1,2,30,0
6.823920661046929e+17,23,68,2.9565217391304346,2,5,23,0
6.82392239671398e+17,18,19,1.0555555555555556,1,2,18,0
6.825753901465071e+17,28,282,10.071428571428571,5,12,1,27
6.826629985212499e+17,17,33,1.9411764705882353,1,4,17,0
6.829893099860024e+17,93,462,4.967741935483871,2,7,93,0
6.831908571583949e+17,13,121,9.307692307692308,7,11,1,12
6.832484512878353e+17,35,339,9.685714285714285,3,12,1,34
6.832703307091694e+17,41,84,2.048780487804878,1,4,41,0
6.83292876592673e+17,129,885,6.8604651162790695,3,10,86,43
6.833647559984019e+17,39,206,5.282051282051282,3,8,38,1
6.833900080963836e+17,31,265,8.548387096774194,4,11,5,26
6.837145118964054e+17,13,67,5.153846153846154,4,6,13,0
6.837381977167302e+17,1,7,7.0,7,7,1,0
6.837568953936323e+17,137,677,4.9416058394160585,3,7,137,0
6.837589313822716e+17,22,212,9.636363636363637,8,11,0,22
6.83763606583239e+17,131,647,4.938931297709924,2,8,130,1
6.838171421476099e+17,65,148,2.276923076923077,1,4,65,0
6.838752755306597e+17,1,3,3.0,3,3,1,0
6.838969229181096e+17,161,1092,6.782608695652174,2,10,111,50
6.838976525724737e+17,58,567,9.775862068965518,2,12,3,55
6.839288619973679e+17,185,268,1.4486486486486487,1,4,185,0
6.839509366285695e+17,3,21,7.0,6,8,2,1
6.840036827970738e+17,131,1128,8.610687022900763,2,11,19,112
6.840199446628137e+17,288,578,2.0069444444444446,1,5,288,0
6.840302425048055e+17,94,464,4.9361702127659575,2,7,94,0
6.840542872850669e+17,21,151,7.190476190476191,6,9,13,8
6.840780672284271e+17,11,37,3.3636363636363638,2,5,11,0
6.843734571928479e+17,9,19,2.111111111111111,1,5,9,0
6.844707211716904e+17,58,559,9.637931034482758,4,12,4,54
6.844797641522138e+17,67,319,4.7611940298507465,2,7,67,0
6.845126167364192e+17,136,681,5.007352941176471,2,7,136,0
6.845179694869926e+17,4,6,1.5,1,2,4,0
6.84519780313174e+17,1,2,2.0,2,2,1,0
6.845215379736084e+17,3,17,5.666666666666667,5,7,3,0
6.845378939253687e+17,21,208,9.904761904761905,6,11,1,20
6.846164380342601e+17,103,973,9.446601941747574,2,14,8,95
6.847766060238029e+17,102,212,2.0784313725490198,1,4,102,0
6.848450907343022e+17,68,386,5.676470588235294,2,8,61,7
6.851319863194363e+17,66,211,3.196969696969697,1,5,66,0
6.852261391477989e+17,30,56,1.8666666666666667,1,3,30,0
6.852288346357825e+17,114,242,2.1228070175438596,1,5,114,0
6.852311739092013e+17,1,2,2.0,2,2,1,0
6.852366721788285e+17,232,1161,5.004310344827586,2,7,232,0
6.852488570949443e+17,2,4,2.0,1,3,2,0
6.852561874957531e+17,3,30,10.0,10,10,0,3
6.852969418665962e+17,210,1044,4.9714285714285715,2,8,209,1
6.853045560576876e+17,53,261,4.9245283018867925,2,7,53,0
6.853082812470729e+17,69,542,7.855072463768116,2,10,24,45
6.853139848599031e+17,167,856,5.125748502994012,2,7,167,0
6.853172268729254e+17,6,55,9.166666666666666,3,11,1,5
6.85363193327125e+17,12,58,4.833333333333333,4,6,12,0
6.853833814109352e+17,47,90,1.9148936170212767,1,4,47,0
6.853856675187884e+17,5,12,2.4,2,3,5,0
6.853880068737102e+17,33,231,7.0,5,8,24,9
6.853888278400307e+17,33,71,2.1515151515151514,1,5,33,0
6.853892896536932e+17,75,159,2.12,1,4,75,0
6.853915820693075e+17,74,519,7.013513513513513,4,9,47,27
6.85393773306661e+17,98,663,6.76530612244898,2,10,72,26
6.85393851899022e+17,70,461,6.585714285714285,2,9,57,13
6.853939168971149e+17,63,428,6.7936507936507935,2,9,45,18
6.854511199847049e+17,57,405,7.105263157894737,4,9,39,18
6.854532179481708e+17,7,63,9.0,5,11,1,6
6.854563469212595e+17,3,4,1.3333333333333333,1,2,3,0
6.854794054637928e+17,13,122,9.384615384615385,8,10,0,13
6.85486581341109e+17,1,9,9.0,9,9,0,1
6.854904404806611e+17,4,34,8.5,8,9,0,4
6.854932923320739e+17,4,43,10.75,10,12,0,4
6.854968642250552e+17,6,57,9.5,8,11,0,6
6.855146403589343e+17,46,306,6.6521739130434785,2,9,35,11
6.855206824106588e+17,44,299,6.795454545454546,5,9,35,9
6.85905174551827e+17,7,18,2.5714285714285716,1,3,7,0
6.859070937208759e+17,191,397,2.0785340314136125,1,5,191,0
6.859073211401793e+17,1,5,5.0,5,5,1,0
6.859503857002865e+17,24,51,2.125,1,4,24,0
6.859544741779757e+17,34,173,5.088235294117647,3,7,34,0
6.859684525336867e+17,2,6,3.0,3,3,2,0
6.859758258885244e+17,150,1032,6.88,2,9,109,41
6.860113363133926e+17,49,486,9.918367346938776,5,12,2,47
6.860717842061275e+17,169,837,4.952662721893491,2,8,166,3
6.86132385665851e+17,86,575,6.686046511627907,2,9,68,18
6.861709524193793e+17,168,992,5.904761904761905,2,9,154,14
6.862236002976197e+17,59,575,9.745762711864407,3,12,2,57
6.86327363314855e+17,10,32,3.2,2,5,10,0
6.865598183919564e+17,93,462,4.967741935483871,2,8,92,1
6.866723829441007e+17,5,12,2.4,1,4,5,0
6.866808730377906e+17,4,5,1.25,1,2,4,0
6.866945976697667e+17,65,441,6.7846153846153845,3,10,48,17
6.867013933941234e+17,15,43,2.8666666666666667,1,4,15,0
6.867112903232599e+17,2,6,3.0,2,4,2,0
6.867201786271223e+17,9,17,1.8888888888888888,1,3,9,0
6.867406155637243e+17,121,812,6.710743801652892,2,10,87,34
6.869428573596517e+17,90,183,2.033333333333333,1,4,90,0
6.870542516457976e+17,34,97,2.8529411764705883,2,5,34,0
6.873575839649718e+17,61,431,7.065573770491803,5,9,38,23
6.873917003260172e+17,167,1470,8.802395209580839,2,11,15,152
6.875651677139995e+17,9,62,6.888888888888889,6,8,6,3
6.879690914024511e+17,6,21,3.5,1,5,6,0
6.88090386323603e+17,146,1254,8.58904109589041,2,11,19,127
6.881116943034886e+17,3,29,9.666666666666666,9,11,0,3
6.881178106738605e+17,76,365,4.802631578947368,2,7,76,0
6.88122321368901e+17,2,5,2.5,2,3,2,0
6.881630259377047e+17,183,1569,8.573770491803279,2,11,22,161
6.882751259804407e+17,77,758,9.844155844155845,3,12,4,73
6.882918980804672e+17,6,16,2.6666666666666665,1,3,6,0
6.883553504022191e+17,10,41,4.1,2,6,10,0
6.883581322542248e+17,18,61,3.388888888888889,2,5,18,0
6.883607400575502e+17,10,40,4.0,2,5,10,0
6.883628957759149e+17,4,11,2.75,1,6,4,0
6.883724683993053e+17,231,2205,9.545454545454545,2,13,19,212
6.888168855563131e+17,56,493,8.803571428571429,3,12,6,50
6.88833720102323e+17,101,216,2.1386138613861387,1,4,101,0
6.888344259215945e+17,3,5,1.6666666666666667,1,2,3,0
6.888407888411034e+17,46,177,3.847826086956522,2,6,46,0
6.888554361688808e+17,52,496,9.538461538461538,3,12,3,49
6.888631215680676e+17,14,23,1.6428571428571428,1,3,14,0
6.888687755626908e+17,1,2,2.0,2,2,1,0
6.888842308707244e+17,79,241,3.050632911392405,1,6,79,0
6.888964418802214e+17,3,28,9.333333333333334,8,11,0,3
6.889583347659649e+17,61,583,9.557377049180328,2,13,5,56
6.889597706647476e+17,90,189,2.1,1,4,90,0
6.889707260344293e+17,160,613,3.83125,1,7,160,0
6.889811626068364e+17,2,14,7.0,7,7,2,0
6.890021971039889e+17,2,7,3.5,3,4,2,0
6.890068418129303e+17,3,8,2.6666666666666665,2,3,3,0
6.890362110148333e+17,2,3,1.5,1,2,2,0
6.89078338594192e+17,49,261,5.326530612244898,3,8,48,1
6.892609373600673e+17,2,2,1.0,1,1,2,0
6.89469928710488e+17,43,290,6.744186046511628,4,9,33,10
6.894806872934915e+17,5,36,7.2,6,8,3,2
6.895035202269162e+17,34,164,4.823529411764706,2,6,34,0
6.895193400571004e+17,5,11,2.2,1,3,5,0
6.895480114231634e+17,53,466,8.79245283018868,2,11,8,45
6.89577416175096e+17,46,461,10.021739130434783,8,13,0,46
6.895884145767305e+17,3,10,3.3333333333333335,3,4,3,0
6.896128498121736e+17,14,32,2.2857142857142856,1,4,14,0
6.896577741040466e+17,27,190,7.037037037037037,5,8,17,10
6.896684390966664e+17,4,28,7.0,6,8,3,1
6.896690773561656e+17,93,444,4.774193548387097,2,7,93,0
6.896941582946099e+17,4,10,2.5,2,3,4,0
6.89934580222498e+17,73,641,8.780821917808218,2,11,11,62
6.90165234242521e+17,5,15,3.0,2,4,5,0
6.902149726906287e+17,3,9,3.0,2,4,3,0
6.902491065173847e+17,35,182,5.2,3,7,35,0
6.902655254875818e+17,66,140,2.121212121212121,1,4,66,0
6.902838524690369e+17,36,286,7.944444444444445,6,10,13,23
6.903735923372435e+17,2,4,2.0,2,2,2,0
6.904056458316279e+17,2,10,5.0,5,5,2,0
6.904432160557079e+17,27,260,9.62962962962963,6,12,2,25
6.905040871846314e+17,131,256,1.9541984732824427,1,4,131,0
6.905154012836596e+17,8,61,7.625,6,10,5,3
6.906033231041527e+17,28,38,1.3571428571428572,1,3,28,0
6.90633433754869e+17,4,21,5.25,4,6,4,0
6.910091362724369e+17,15,30,2.0,1,4,15,0
6.910325192842191e+17,11,88,8.0,3,10,3,8
6.910366964147099e+17,43,427,9.930232558139535,5,12,1,42
6.910439734107142e+17,15,133,8.866666666666667,7,10,1,14
6.910499560194793e+17,17,149,8.764705882352942,2,12,4,13
6.91058994475072e+17,4,27,6.75,2,10,2,2
6.911075584841398e+17,1,6,6.0,6,6,1,0
6.911367822054652e+17,50,421,8.42,2,10,5,45
6.911464181332865e+17,32,83,2.59375,1,4,32,0
6.912267464265326e+17,37,376,10.162162162162161,8,12,0,37
6.912339830803546e+17,107,543,5.074766355140187,2,8,105,2
6.91259723270029e+17,10,72,7.2,6,8,6,4
6.91384394315268e+17,191,402,2.1047120418848166,1,4,191,0
6.91683686068972e+17,2,7,3.5,3,4,2,0
6.916937557567471e+17,1,2,2.0,2,2,1,0
6.916957097097668e+17,18,79,4.388888888888889,3,6,18,0
6.917116645979936e+17,5,27,5.4,1,8,4,1
6.917283083941137e+17,37,269,7.27027027027027,3,9,19,18
6.917534704238153e+17,17,74,4.352941176470588,3,6,17,0
6.917575896585396e+17,62,129,2.0806451612903225,1,5,62,0
6.917613206171944e+17,36,176,4.888888888888889,2,7,36,0
6.91807557536283e+17,11,26,2.3636363636363638,1,4,11,0
6.918085062823657e+17,75,596,7.946666666666666,3,10,20,55
6.918098742722435e+17,1,2,2.0,2,2,1,0
6.91811040291867e+17,6,7,1.1666666666666667,1,2,6,0
6.918120544844845e+17,5,13,2.6,1,4,5,0
6.918144357155324e+17,2,4,2.0,2,2,2,0
6.918166175949848e+17,2,4,2.0,1,3,2,0
6.918186410315894e+17,6,15,2.5,1,4,6,0
6.91820894180914e+17,41,82,2.0,1,4,41,0
6.918252875506738e+17,17,28,1.6470588235294117,1,4,17,0
6.918273751450625e+17,2,7,3.5,3,4,2,0
6.918296841664232e+17,1,3,3.0,3,3,1,0
6.91831712865344e+17,4,7,1.75,1,3,4,0
6.918358943552634e+17,29,65,2.2413793103448274,1,4,29,0
6.918381832375995e+17,6,13,2.1666666666666665,1,3,6,0
6.918402888487866e+17,2,7,3.5,3,4,2,0
6.918425425089231e+17,3,6,2.0,1,3,3,0
6.918447492077787e+17,5,11,2.2,1,3,5,0
6.918469454784384e+17,1,2,2.0,2,2,1,0
6.918476308229829e+17,42,84,2.0,1,5,42,0
6.91849130284037e+17,1,2,2.0,2,2,1,0
6.918513415060276e+17,9,18,2.0,1,3,9,0
6.918520257675825e+17,30,148,4.933333333333334,3,7,30,0
6.918828229383529e+17,1,9,9.0,9,9,0,1
6.919493982255813e+17,111,886,7.981981981981982,2,10,33,78
6.919711841916934e+17,76,159,2.0921052631578947,1,5,76,0
6.919800166684987e+17,5,43,8.6,2,11,1,4
6.919988020885466e+17,14,58,4.142857142857143,2,6,14,0
6.920741265960101e+17,9,49,5.444444444444445,4,6,9,0
6.924985150645348e+17,1,1,1.0,1,1,1,0
6.925377918806307e+17,9,85,9.444444444444445,8,12,0,9
6.926299399220905e+17,92,875,9.51086956521739,2,12,7,85
6.927120082475683e+17,25,29,1.16,1,2,25,0
6.927154552461673e+17,57,293,5.140350877192983,2,7,57,0
6.927911210397805e+17,4,11,2.75,2,3,4,0
6.931146162796252e+17,14,93,6.642857142857143,3,9,11,3
6.931610594601423e+17,67,666,9.940298507462687,5,12,2,65
6.933000037289961e+17,5,17,3.4,1,5,5,0
6.933345039034596e+17,47,334,7.1063829787234045,4,9,28,19
6.938756848447849e+17,128,870,6.796875,2,9,93,35
6.939483492266094e+17,137,282,2.0583941605839415,1,5,137,0
6.939552558262813e+17,3,11,3.6666666666666665,3,5,3,0
6.940371750987981e+17,39,290,7.435897435897436,2,11,12,27
6.94189756576925e+17,44,258,5.863636363636363,2,9,41,3
6.941898507641766e+17,41,54,1.3170731707317074,1,3,41,0
6.942600759560264e+17,18,91,5.055555555555555,3,7,18,0
6.946625395970381e+17,2,9,4.5,4,5,2,0
6.946827147622259e+17,60,402,6.7,2,9,42,18
6.946853733155688e+17,57,167,2.9298245614035086,1,5,57,0
6.947165433979593e+17,16,107,6.6875,5,9,12,4
6.948268203788051e+17,51,64,1.2549019607843137,1,3,51,0
6.94879278864111e+17,16,79,4.9375,3,7,16,0
6.948982799796613e+17,117,828,7.076923076923077,5,10,77,40
6.94912143179796e+17,40,89,2.225,1,5,40,0
6.949633734006804e+17,47,313,6.659574468085107,2,9,35,12
6.950074070576257e+17,18,145,8.055555555555555,6,10,4,14
6.953640937929608e+17,2,22,11.0,11,11,0,2
6.954023108153592e+17,106,507,4.783018867924528,2,7,106,0
6.954880397715503e+17,85,582,6.847058823529411,3,10,61,24
6.955987259690346e+17,27,63,2.3333333333333335,1,4,27,0
6.956186829191572e+17,256,342,1.3359375,1,4,256,0
6.959915489367985e+17,17,37,2.176470588235294,1,4,17,0
6.960205504860442e+17,9,20,2.2222222222222223,2,3,9,0
6.960695735048317e+17,27,55,2.037037037037037,1,5,27,0
6.961106331719032e+17,10,14,1.4,1,3,10,0
6.961184068986938e+17,6,34,5.666666666666667,5,6,6,0
6.961238807260653e+17,1,3,3.0,3,3,1,0
6.961313006057929e+17,15,87,5.8,4,8,14,1
6.961335870226172e+17,8,16,2.0,1,3,8,0
6.961336451632015e+17,1,1,1.0,1,1,1,0
6.961434723619923e+17,22,27,1.2272727272727273,1,3,22,0
6.961581178607162e+17,4,20,5.0,4,6,4,0
6.961635602662021e+17,2,3,1.5,1,2,2,0
6.961651929343543e+17,7,13,1.8571428571428572,1,3,7,0
6.96168807541586e+17,43,59,1.372093023255814,1,3,43,0
6.962023935304026e+17,25,53,2.12,1,4,25,0
6.962136922340896e+17,46,101,2.1956521739130435,1,4,46,0
6.962299658447012e+17,10,43,4.3,3,5,10,0
6.96248954646144e+17,82,322,3.926829268292683,1,6,82,0
6.962589648613038e+17,83,579,6.975903614457831,2,9,50,33
6.96267754624053e+17,4,11,2.75,1,4,4,0
6.962741812943058e+17,14,44,3.142857142857143,2,4,14,0
6.963055881358075e+17,63,316,5.015873015873016,2,7,63,0
6.963294545639443e+17,81,323,3.9876543209876543,1,7,81,0
6.964570911535247e+17,51,499,9.784313725490197,5,12,3,48
6.965295358272609e+17,61,132,2.1639344262295084,1,5,61,0
6.967658941233637e+17,3,5,1.6666666666666667,1,3,3,0
6.967706154367695e+17,9,11,1.2222222222222223,1,2,9,0
6.967838634258422e+17,9,13,1.4444444444444444,1,3,9,0
6.967863968546167e+17,17,23,1.3529411764705883,1,3,17,0
6.967877711242912e+17,5,32,6.4,6,8,4,1
6.967880038412593e+17,1,1,1.0,1,1,1,0
6.968201001394209e+17,8,15,1.875,1,3,8,0
6.968331385943162e+17,22,68,3.090909090909091,1,5,22,0
6.968373048080047e+17,104,310,2.980769230769231,1,5,104,0
6.9683731270784e+17,93,638,6.860215053763441,2,9,64,29
6.968394311057021e+17,30,75,2.5,1,4,30,0
6.968465056814661e+17,125,248,1.984,1,4,125,0
6.968576918007418e+17,5,37,7.4,6,9,3,2
6.968933965265457e+17,5,54,10.8,10,12,0,5
6.968991237299757e+17,7,67,9.571428571428571,9,11,0,7
6.969075648538797e+17,9,39,4.333333333333333,2,6,9,0
6.969260250621435e+17,14,27,1.9285714285714286,1,4,14,0
6.969444415692169e+17,28,187,6.678571428571429,2,9,20,8
6.969470908843206e+17,80,401,5.0125,3,7,80,0
6.969912022410528e+17,86,803,9.337209302325581,2,11,8,78
6.970037651524731e+17,90,799,8.877777777777778,4,12,5,85
6.970065073132114e+17,54,486,9.0,2,12,5,49
6.970546434805389e+17,20,139,6.95,5,9,16,4
6.970629544858243e+17,28,50,1.7857142857142858,1,4,28,0
6.971057009825553e+17,13,53,4.076923076923077,2,6,13,0
6.97243348825954e+17,22,57,2.590909090909091,1,5,22,0
6.975080991374583e+17,146,1290,8.835616438356164,3,11,12,134
6.975179556395354e+17,115,345,3.0,1,6,115,0
6.975954865665887e+17,15,111,7.4,4,9,7,8
6.97673255408341e+17,4,7,1.75,1,2,4,0
6.977031740849893e+17,2,18,9.0,8,10,0,2
6.977079093030879e+17,6,44,7.333333333333333,6,8,3,3
6.977260489129087e+17,72,636,8.833333333333334,4,11,6,66
6.980457915403941e+17,261,1515,5.804597701149425,2,9,249,12
6.98344353802679e+17,56,497,8.875,6,11,5,51
6.984562377439101e+17,77,533,6.922077922077922,3,10,50,27
6.984677373172257e+17,181,893,4.933701657458563,2,8,179,2
6.985068129966388e+17,125,261,2.088,1,5,125,0
6.985114572276274e+17,25,127,5.08,3,7,25,0
6.986020329675039e+17,316,1859,5.882911392405063,2,9,291,25
6.986818899973132e+17,44,419,9.522727272727273,2,12,2,42
6.98899293956803e+17,7,49,7.0,6,8,5,2
6.989032639960541e+17,2,3,1.5,1,2,2,0
6.98970411358444e+17,256,2249,8.78515625,2,12,29,227
6.98983147311163e+17,1,9,9.0,9,9,0,1
6.990126312688379e+17,35,79,2.257142857142857,1,4,35,0
6.990541260572856e+17,128,255,1.9921875,1,5,128,0
6.99057016506049e+17,173,706,4.08092485549133,2,7,173,0
6.99082699216155e+17,20,39,1.95,1,3,20,0
6.990829502606012e+17,21,195,9.285714285714286,3,11,3,18
6.991115691813654e+17,5,12,2.4,1,4,5,0
6.991372175514318e+17,31,43,1.3870967741935485,1,3,31,0
6.991798373346822e+17,73,282,3.863013698630137,2,6,73,0
6.992457914880819e+17,5,35,7.0,6,9,4,1
6.996774876825334e+17,89,194,2.1797752808988764,1,4,89,0
6.998502666561774e+17,39,82,2.1025641025641026,1,4,39,0
6.999373485724876e+17,43,298,6.930232558139535,5,9,31,12
6.99966131078559e+17,2,18,9.0,9,9,0,2
7.000115970051613e+17,1,1,1.0,1,1,1,0
7.00406690982875e+17,11,56,5.090909090909091,2,7,11,0
7.004569720633851e+17,78,174,2.230769230769231,1,5,78,0
7.004649313583556e+17,44,218,4.954545454545454,2,7,44,0
7.004735960100493e+17,1,1,1.0,1,1,1,0
7.004855882600568e+17,3,9,3.0,3,3,3,0
7.005063289288616e+17,1,3,3.0,3,3,1,0
7.005189051931608e+17,5,14,2.8,2,4,5,0
7.005576855496776e+17,115,567,4.930434782608696,2,7,115,0
7.005747803686803e+17,86,191,2.2209302325581395,1,5,86,0
7.006192519790083e+17,16,106,6.625,5,8,14,2
7.006687912799713e+17,63,307,4.873015873015873,2,7,63,0
7.008199502489509e+17,15,105,7.0,4,8,10,5
7.01125773303003e+17,21,46,2.1904761904761907,1,5,21,0
7.011704552651881e+17,8,54,6.75,2,9,3,5
7.011705062664207e+17,15,123,8.2,2,10,2,13
7.01178621073539e+17,10,21,2.1,1,4,10,0
7.011795229447575e+17,11,67,6.090909090909091,5,7,11,0
7.011953872133603e+17,10,57,5.7,5,7,10,0
7.011996668867281e+17,161,1408,8.745341614906833,2,12,17,144
7.012280343332159e+17,81,685,8.45679012345679,2,11,12,69
7.012562683361435e+17,2,6,3.0,3,3,2,0
7.013049133339281e+17,67,531,7.925373134328358,2,11,20,47
7.013229175869034e+17,3,13,4.333333333333333,2,6,3,0
7.01323050306344e+17,132,631,4.78030303030303,2,8,128,4
7.018662031485531e+17,9,86,9.555555555555555,3,12,1,8
7.019018525883593e+17,89,194,2.1797752808988764,1,4,89,0
7.019312830001222e+17,15,147,9.8,5,12,1,14
7.020261953353211e+17,20,39,1.95,1,3,20,0
7.020356598107754e+17,96,758,7.895833333333333,2,10,32,64
7.020703338645741e+17,4,25,6.25,5,7,4,0
7.025093549805004e+17,1,3,3.0,3,3,1,0
7.027521969169905e+17,68,139,2.0441176470588234,1,4,68,0
7.028995312383167e+17,117,920,7.863247863247863,4,10,44,73
7.029167934494885e+17,16,78,4.875,3,6,16,0
7.029368633210232e+17,7,38,5.428571428571429,4,7,7,0
7.030053253666397e+17,18,89,4.944444444444445,2,7,18,0
7.03254850438657e+17,122,592,4.852459016393443,2,7,122,0
7.033087100462518e+17,84,329,3.9166666666666665,2,6,84,0
7.034926278915567e+17,36,179,4.972222222222222,3,9,35,1
7.035336974272047e+17,4,34,8.5,8,10,0,4
7.037418242851941e+17,87,266,3.057471264367816,1,6,87,0
7.03944635050406e+17,68,670,9.852941176470589,4,12,3,65
7.040554681615021e+17,17,75,4.411764705882353,3,7,17,0
7.040661723098136e+17,22,205,9.318181818181818,7,11,1,21
7.040768819426861e+17,13,39,3.0,2,5,13,0
7.040769794806031e+17,26,83,3.1923076923076925,1,5,26,0
7.041004444815598e+17,66,528,8.0,3,10,18,48
7.041444159955556e+17,47,238,5.0638297872340425,2,7,47,0
7.041752255075668e+17,6,11,1.8333333333333333,1,3,6,0
7.0471934952326e+17,140,430,3.0714285714285716,1,5,140,0
7.048357129512835e+17,5,33,6.6,5,8,4,1
7.048538544011817e+17,58,115,1.9827586206896552,1,4,58,0
7.048701210835619e+17,27,127,4.703703703703703,2,7,27,0
7.048773635892872e+17,198,1373,6.934343434343434,2,10,129,69
7.049302311092668e+17,126,386,3.0634920634920637,1,5,126,0
7.050265311298644e+17,8,18,2.25,1,4,8,0
7.050302776622097e+17,2,5,2.5,2,3,2,0
7.05030589121932e+17,2,10,5.0,5,5,2,0
7.050398982686892e+17,230,2010,8.73913043478261,2,12,31,199
7.05055925036109e+17,3,5,1.6666666666666667,1,3,3,0
7.054316899450893e+17,48,293,6.104166666666667,3,8,43,5
7.054591632112147e+17,39,197,5.051282051282051,3,7,39,0
7.054696916099135e+17,11,102,9.272727272727273,5,11,1,10
7.05482816692422e+17,49,142,2.8979591836734695,1,5,49,0
7.054974987413123e+17,59,118,2.0,1,4,59,0
7.055437368133002e+17,126,256,2.0317460317460316,1,5,126,0
7.055670782544338e+17,37,70,1.8918918918918919,1,4,37,0
7.055948039444671e+17,113,577,5.106194690265487,2,7,113,0
7.056057392662e+17,171,1645,9.619883040935672,2,13,11,160
7.056649353155267e+17,1,2,2.0,2,2,1,0
7.056853268914244e+17,14,85,6.071428571428571,4,9,12,2
7.056932581059535e+17,26,163,6.269230769230769,4,8,23,3
7.05700644816825e+17,66,385,5.833333333333333,2,8,63,3
7.057126534043822e+17,27,132,4.888888888888889,2,7,27,0
7.058390476868878e+17,1,8,8.0,8,8,0,1
7.058855143630515e+17,12,70,5.833333333333333,4,7,12,0
7.061740877941545e+17,3,4,1.3333333333333333,1,2,3,0
7.061758666104589e+17,49,331,6.755102040816326,2,9,33,16
7.06257659917904e+17,70,559,7.985714285714286,3,11,20,50
7.06279121019776e+17,97,214,2.2061855670103094,1,4,97,0
7.063248262219009e+17,25,153,6.12,4,8,21,4
7.063593565912055e+17,10,87,8.7,6,10,1,9
7.063651960216588e+17,116,471,4.060344827586207,1,7,116,0
7.063654349778917e+17,1,4,4.0,4,4,1,0
7.066214485180101e+17,21,74,3.5238095238095237,2,6,21,0
7.066488423631622e+17,37,290,7.837837837837838,3,10,12,25
7.068896003070893e+17,23,63,2.739130434782609,1,5,23,0
7.069037528424237e+17,28,85,3.0357142857142856,1,5,28,0
7.069063340450029e+17,62,293,4.725806451612903,3,8,61,1
7.069742544778007e+17,125,476,3.808,1,6,125,0
7.069913774743757e+17,26,35,1.3461538461538463,1,3,26,0
7.069974197754976e+17,10,14,1.4,1,3,10,0
7.070158384180278e+17,239,1409,5.895397489539749,2,9,220,19
7.070362555878568e+17,9,63,7.0,5,9,7,2
7.070438633314999e+17,59,109,1.847457627118644,1,5,59,0
7.070449026884539e+17,2,4,2.0,1,3,2,0
7.070499414074237e+17,1,4,4.0,4,4,1,0
7.070579094382647e+17,58,544,9.379310344827585,3,12,5,53
7.070886746171747e+17,1,2,2.0,2,2,1,0
7.071348476250605e+17,4,29,7.25,6,8,2,2
7.072052217279259e+17,23,30,1.3043478260869565,1,3,23,0
7.072114725803365e+17,84,323,3.8452380952380953,1,6,84,0
7.072514760647185e+17,120,584,4.866666666666666,2,7,120,0
7.072743866955662e+17,140,403,2.8785714285714286,1,6,140,0
7.074404756428928e+17,93,195,2.096774193548387,1,5,93,0
7.076169059234519e+17,87,805,9.25287356321839,2,12,9,78
7.076385316369473e+17,2,2,1.0,1,1,2,0
7.07655070850336e+17,32,65,2.03125,1,3,32,0
7.076796985881574e+17,2,6,3.0,3,3,2,0
7.076927348753298e+17,51,430,8.431372549019608,3,10,12,39
7.078243432401708e+17,142,693,4.880281690140845,2,8,141,1
7.07891936082771e+17,66,583,8.833333333333334,2,12,8,58
7.082935672405988e+17,208,2012,9.673076923076923,2,13,13,195
7.08401091933728e+17,6,13,2.1666666666666665,1,3,6,0
7.08422661400775e+17,59,232,3.9322033898305087,2,6,59,0
7.085881916504801e+17,48,225,4.6875,2,7,48,0
7.086345688887213e+17,44,201,4.568181818181818,3,6,44,0
7.086846191478651e+17,90,258,2.8666666666666667,1,5,90,0
7.088279410951508e+17,46,394,8.565217391304348,2,11,7,39
7.09136069814477e+17,16,113,7.0625,5,9,11,5
7.091362135277905e+17,15,43,2.8666666666666667,1,4,15,0
7.091437757429324e+17,34,131,3.8529411764705883,2,6,34,0
7.091444275974772e+17,36,146,4.055555555555555,1,6,36,0
7.09151433054346e+17,23,70,3.0434782608695654,1,5,23,0
7.091586715601664e+17,12,14,1.1666666666666667,1,2,12,0
7.091615780995707e+17,1,2,2.0,2,2,1,0
7.091704597012241e+17,24,67,2.7916666666666665,1,5,24,0
7.091721198835611e+17,43,60,1.3953488372093024,1,3,43,0
7.091741514492996e+17,21,44,2.0952380952380953,1,4,21,0
7.091915569401709e+17,1,2,2.0,2,2,1,0
7.091918063320558e+17,1,4,4.0,4,4,1,0
7.092347239455532e+17,3,20,6.666666666666667,6,7,3,0
7.092623908376667e+17,14,84,6.0,4,7,14,0
7.092905638857532e+17,16,61,3.8125,2,5,16,0
7.092958263411569e+17,3,18,6.0,5,7,3,0
7.0932713445443e+17,171,248,1.4502923976608186,1,4,171,0
7.094802980302639e+17,21,209,9.952380952380953,5,12,1,20
7.095300379651404e+17,9,18,2.0,1,3,9,0
7.09538749531128e+17,58,223,3.8448275862068964,1,6,58,0
7.097807123839903e+17,4,9,2.25,1,4,4,0
7.098137754900556e+17,3,7,2.3333333333333335,1,4,3,0
7.098536131120979e+17,88,603,6.8522727272727275,4,10,62,26
7.09854924003983e+17,2,4,2.0,2,2,2,0
7.098645539728625e+17,3,24,8.0,6,9,1,2
7.098997511238538e+17,15,27,1.8,1,3,15,0
7.099110171267497e+17,10,80,8.0,5,9,1,9
7.099271799772065e+17,4,15,3.75,3,4,4,0
7.099923060600809e+17,36,169,4.694444444444445,2,7,36,0
7.100505582886022e+17,61,604,9.901639344262295,5,12,3,58
7.10091101046197e+17,4,13,3.25,3,4,4,0
7.101835250841268e+17,22,40,1.8181818181818181,1,3,22,0
7.102438153645947e+17,24,35,1.4583333333333333,1,3,24,0
7.102614943130124e+17,11,72,6.545454545454546,5,8,9,2
7.104790475817005e+17,1,8,8.0,8,8,0,1
7.10492534078508e+17,21,42,2.0,1,4,21,0
7.104957395167341e+17,35,242,6.914285714285715,4,9,24,11
7.105102171745747e+17,39,86,2.2051282051282053,1,4,39,0
7.105155273093693e+17,9,20,2.2222222222222223,1,4,9,0
7.105734816564819e+17,1,2,2.0,2,2,1,0
7.106249334026042e+17,27,240,8.88888888888889,2,11,2,25
7.10639345173643e+17,23,40,1.7391304347826086,1,4,23,0
7.106401196346111e+17,32,161,5.03125,2,8,31,1
7.107623653244436e+17,52,446,8.576923076923077,2,11,7,45
7.10797022346366e+17,53,360,6.7924528301886795,2,9,39,14
7.108212137610345e+17,1,6,6.0,6,6,1,0
7.108228156327972e+17,84,343,4.083333333333333,1,7,84,0
7.108338859359293e+17,189,243,1.2857142857142858,1,4,189,0
7.108512420424742e+17,115,243,2.1130434782608694,1,5,115,0
7.108804921226574e+17,129,1153,8.937984496124031,2,12,9,120
7.109564959458655e+17,15,29,1.9333333333333333,1,4,15,0
7.111769004749005e+17,5,10,2.0,1,3,5,0
7.111969812387555e+17,73,145,1.9863013698630136,1,4,73,0
7.11198927646244e+17,79,165,2.088607594936709,1,4,79,0
7.1130619821447e+17,197,1868,9.48223350253807,2,14,16,181
7.113153760884845e+17,4,39,9.75,9,10,0,4
7.1136827047651e+17,123,618,5.024390243902439,2,8,122,1
7.114167828304271e+17,13,36,2.769230769230769,1,5,13,0
7.114930751125364e+17,35,177,5.057142857142857,3,7,35,0
7.114931218334305e+17,48,295,6.145833333333333,4,8,44,4
7.116343893458204e+17,36,175,4.861111111111111,2,7,36,0
7.11645165852059e+17,157,1061,6.75796178343949,2,10,113,44
7.11969127406979e+17,78,173,2.217948717948718,1,4,78,0
7.119776138162536e+17,92,454,4.934782608695652,2,7,92,0
7.11981005129429e+17,13,24,1.8461538461538463,1,4,13,0
7.119902727174954e+17,6,42,7.0,5,9,3,3
7.120447970807813e+17,93,189,2.032258064516129,1,4,93,0
7.120515932466848e+17,31,155,5.0,3,7,31,0
7.120689552390945e+17,20,118,5.9,2,9,16,4
7.120818605689516e+17,79,242,3.0632911392405062,1,5,79,0
7.121128038151512e+17,1,4,4.0,4,4,1,0
7.121140234822875e+17,55,115,2.090909090909091,1,5,55,0
7.121210561032873e+17,17,76,4.470588235294118,3,6,17,0
7.121443364079197e+17,19,39,2.0526315789473686,1,4,19,0
7.121718204908023e+17,1,1,1.0,1,1,1,0
7.122304444672721e+17,72,648,9.0,3,11,4,68
7.12294710942768e+17,25,61,2.44,1,5,25,0
7.123308309057916e+17,17,83,4.882352941176471,4,6,17,0
7.123503115995429e+17,14,55,3.9285714285714284,2,6,14,0
7.123544671633591e+17,24,46,1.9166666666666667,1,4,24,0
7.123673148119626e+17,174,1650,9.482758620689655,2,12,14,160
7.12386104853558e+17,178,1697,9.53370786516854,2,13,11,167
7.123869374635688e+17,27,104,3.8518518518518516,1,6,27,0
7.123936418441487e+17,14,69,4.928571428571429,4,7,14,0
7.123937875504266e+17,154,1507,9.785714285714286,3,12,4,150
7.127088648883443e+17,18,181,10.055555555555555,9,11,0,18
7.127911212403602e+17,168,1164,6.928571428571429,2,9,114,54
7.127934976232698e+17,8,15,1.875,1,3,8,0
7.128176880196458e+17,62,537,8.661290322580646,2,12,10,52
7.129310495454926e+17,14,38,2.7142857142857144,1,5,14,0
7.129674300159891e+17,18,123,6.833333333333333,2,9,10,8
7.129991240096602e+17,6,18,3.0,1,4,6,0
7.130305295229293e+17,57,120,2.1052631578947367,1,5,57,0
7.130438521225917e+17,27,56,2.074074074074074,1,4,27,0
7.134111419758711e+17,94,471,5.01063829787234,3,7,94,0
7.134837817863978e+17,164,1449,8.835365853658537,2,12,20,144
7.135217533613165e+17,57,129,2.263157894736842,1,5,57,0
7.136234995225318e+17,9,22,2.4444444444444446,1,4,9,0
7.13661144758938e+17,71,140,1.971830985915493,1,4,71,0
7.136643844771347e+17,2,11,5.5,4,7,2,0
7.136873226226701e+17,19,38,2.0,1,4,19,0
7.137155434692493e+17,9,39,4.333333333333333,2,6,9,0
7.137774685175382e+17,76,653,8.592105263157896,2,11,13,63
7.141072333532951e+17,6,14,2.3333333333333335,1,3,6,0
7.14194442792392e+17,62,127,2.0483870967741935,1,4,62,0
7.141997380706911e+17,133,665,5.0,2,7,133,0
7.142054785864035e+17,90,440,4.888888888888889,2,7,90,0
7.142243496885576e+17,17,111,6.529411764705882,3,8,15,2
7.143158134692929e+17,1,4,4.0,4,4,1,0
7.143717933538222e+17,75,434,5.786666666666667,2,8,69,6
7.144548630417219e+17,31,243,7.838709677419355,5,10,13,18
7.144569206905165e+17,116,1002,8.637931034482758,2,11,16,100
7.144650220721407e+17,114,776,6.807017543859649,2,9,83,31
7.144924175532259e+17,46,215,4.673913043478261,2,7,46,0
7.145109285595519e+17,45,446,9.911111111111111,2,12,2,43
7.148254348267269e+17,14,72,5.142857142857143,4,7,14,0
7.148274127547167e+17,157,879,5.598726114649682,2,8,151,6
7.14865258567521e+17,25,51,2.04,1,4,25,0
7.148723527042973e+17,6,37,6.166666666666667,5,7,6,0
7.148739649859941e+17,16,49,3.0625,1,5,16,0
7.149258882823334e+17,9,24,2.6666666666666665,1,4,9,0
7.149356091990057e+17,7,20,2.857142857142857,1,4,7,0
7.150401677507494e+17,73,434,5.945205479452055,2,9,69,4
7.150478693657944e+17,50,338,6.76,3,9,39,11
7.15056498933614e+17,73,427,5.8493150684931505,2,8,71,2
7.150931275589486e+17,2,10,5.0,4,6,2,0
7.151030985761546e+17,155,331,2.1354838709677417,1,5,155,0
7.151041474798013e+17,103,693,6.728155339805825,2,9,77,26
7.151071964424193e+17,118,254,2.152542372881356,1,6,118,0
7.151519119869359e+17,103,892,8.660194174757281,2,11,10,93
7.151555454355933e+17,27,49,1.8148148148148149,1,4,27,0
7.151757809654734e+17,8,21,2.625,1,4,8,0
7.152117510403741e+17,176,1708,9.704545454545455,2,13,11,165
7.152220968249129e+17,2,15,7.5,7,8,1,1
7.15244982658736e+17,14,67,4.785714285714286,3,7,14,0
7.155329614770216e+17,149,305,2.046979865771812,1,4,149,0
7.155737758846277e+17,73,505,6.917808219178082,5,9,53,20
7.155819371425894e+17,26,229,8.807692307692308,8,11,0,26
7.156327596954712e+17,43,88,2.046511627906977,1,5,43,0
7.156468820166492e+17,136,1164,8.558823529411764,2,12,21,115
7.156796129216978e+17,55,393,7.1454545454545455,5,9,38,17
7.157608723644485e+17,99,704,7.111111111111111,4,10,61,38
7.157896651057906e+17,30,209,6.966666666666667,5,9,21,9
7.158995227209089e+17,22,45,2.0454545454545454,1,4,22,0
7.159011826783836e+17,189,932,4.931216931216931,3,8,188,1
7.160016670507356e+17,46,404,8.782608695652174,2,11,6,40
7.160449724407e+17,3,25,8.333333333333334,6,10,1,2
7.163357579278854e+17,9,31,3.4444444444444446,1,6,9,0
7.163517006489491e+17,23,185,8.043478260869565,6,10,6,17
7.163815990216568e+17,85,421,4.952941176470588,2,7,85,0
7.165099889819772e+17,4,32,8.0,7,9,1,3
7.165335572605985e+17,14,80,5.714285714285714,2,7,14,0
7.165440791529375e+17,149,1435,9.630872483221477,2,12,7,142
7.165913949447913e+17,34,51,1.5,1,3,34,0
7.166391701316705e+17,195,972,4.984615384615385,2,8,194,1
7.166775474584355e+17,1,4,4.0,4,4,1,0
7.16680528748638e+17,89,535,6.01123595505618,3,9,79,10
7.167025698449216e+17,160,791,4.94375,2,8,158,2
7.167444075483055e+17,14,78,5.571428571428571,2,9,13,1
7.167517167631154e+17,15,95,6.333333333333333,5,8,14,1
7.168245638702225e+17,1,3,3.0,3,3,1,0
7.170658176178479e+17,52,105,2.019230769230769,1,4,52,0
7.170790815685622e+17,162,1127,6.95679012345679,2,10,113,49
7.171464393202806e+17,88,836,9.5,2,12,9,79
7.171792170250723e+17,57,122,2.1403508771929824,1,5,57,0
7.171923372051613e+17,28,194,6.928571428571429,5,9,22,6
7.172352922802231e+17,5,26,5.2,5,6,5,0
7.179487575482922e+17,66,384,5.818181818181818,4,8,59,7
7.180014882171944e+17,80,313,3.9125,2,6,80,0
7.180300255110726e+17,74,438,5.918918918918919,2,9,71,3
7.180450390941391e+17,195,1336,6.851282051282051,2,10,134,61
7.180455538812237e+17,215,1483,6.897674418604651,2,10,151,64
7.185650203270522e+17,7,69,9.857142857142858,8,12,0,7
7.185943953639937e+17,8,11,1.375,1,2,8,0
7.186956939191397e+17,1,8,8.0,8,8,0,1
7.186965733258162e+17,3,20,6.666666666666667,2,9,1,2
7.187293611941638e+17,10,33,3.3,1,5,10,0
7.192270896950525e+17,21,70,3.3333333333333335,1,5,21,0
7.192286573281754e+17,16,115,7.1875,4,10,9,7
7.192303985369783e+17,10,23,2.3,1,5,10,0
7.192350548833778e+17,18,145,8.055555555555555,6,10,6,12
7.192362908308385e+17,5,40,8.0,6,10,1,4
7.19247527039294e+17,25,197,7.88,7,10,10,15
7.19321704028407e+17,30,219,7.3,5,10,18,12
7.193701651496745e+17,94,650,6.914893617021277,3,9,63,31
7.194030464148599e+17,22,150,6.818181818181818,4,9,15,7
7.194116025502817e+17,45,313,6.955555555555556,3,10,34,11
7.194148129456435e+17,14,109,7.785714285714286,6,9,5,9
7.195103521585844e+17,5,46,9.2,6,11,1,4
7.195268382414235e+17,152,1301,8.55921052631579,2,12,21,131
7.195384002616297e+17,14,45,3.2142857142857144,1,6,14,0
7.195522870356137e+17,13,38,2.923076923076923,2,4,13,0
7.19571618484088e+17,1,2,2.0,2,2,1,0
7.199334397752413e+17,20,38,1.9,1,3,20,0
7.199408620185837e+17,8,67,8.375,2,11,2,6
7.199849175093796e+17,9,24,2.6666666666666665,1,4,9,0
7.199850063621477e+17,189,926,4.8994708994708995,2,9,188,1
7.200192467311611e+17,9,38,4.222222222222222,2,6,9,0
7.20062842720016e+17,15,46,3.066666666666667,1,4,15,0
7.2015380520837e+17,101,893,8.841584158415841,2,11,9,92
7.201605836550752e+17,16,74,4.625,4,7,16,0
7.201911619968923e+17,66,392,5.9393939393939394,2,9,60,6
7.202076573221349e+17,38,110,2.8947368421052633,1,4,38,0
7.202878724270021e+17,22,63,2.8636363636363638,1,5,22,0
7.2034179409333e+17,22,57,2.590909090909091,1,5,22,0
7.203560371736919e+17,108,412,3.814814814814815,2,6,108,0
7.203782506968385e+17,7,66,9.428571428571429,4,12,1,6
7.2039511493021e+17,122,1156,9.475409836065573,2,12,7,115
7.204228280315818e+17,13,20,1.5384615384615385,1,3,13,0
7.205619073762931e+17,165,1466,8.884848484848485,2,12,13,152
7.207654179319809e+17,56,290,5.178571428571429,2,8,55,1
7.20784250649059e+17,11,61,5.545454545454546,5,6,11,0
7.207986543245262e+17,9,60,6.666666666666667,6,7,9,0
7.2089096900306e+17,92,184,2.0,1,4,92,0
7.209595106567005e+17,104,1017,9.778846153846153,3,12,6,98
7.213833251835786e+17,1,2,2.0,2,2,1,0
7.214060221173674e+17,8,32,4.0,3,5,8,0
7.214443486975016e+17,55,538,9.781818181818181,2,12,3,52
7.214556783805903e+17,41,271,6.609756097560975,2,9,31,10
7.214763115016724e+17,9,55,6.111111111111111,2,8,6,3
7.214763572219996e+17,13,92,7.076923076923077,4,9,10,3
7.214763927457336e+17,28,222,7.928571428571429,5,10,8,20
7.214764702288526e+17,16,99,6.1875,2,8,12,4
7.214765010787016e+17,49,380,7.755102040816326,2,10,16,33
7.215655859538488e+17,77,367,4.766233766233766,3,7,77,0
7.217502766544346e+17,30,119,3.966666666666667,2,6,30,0
7.22065933084865e+17,39,68,1.7435897435897436,1,3,39,0
7.222355234071538e+17,79,462,5.848101265822785,4,8,75,4
7.222554902037866e+17,1,1,1.0,1,1,1,0
7.223617405859722e+17,105,140,1.3333333333333333,1,4,105,0
7.223630736568695e+17,10,33,3.3,1,5,10,0
7.225473957107439e+17,37,143,3.864864864864865,2,7,37,0
7.227846330917038e+17,8,45,5.625,4,8,7,1
7.228792783467809e+17,5,36,7.2,6,8,2,3
7.230621364879448e+17,10,22,2.2,1,3,10,0
7.230927406548364e+17,26,209,8.038461538461538,7,11,9,17
7.232393257491126e+17,6,47,7.833333333333333,6,9,2,4
7.236190009713065e+17,3,28,9.333333333333334,9,10,0,3
7.236825314542893e+17,142,302,2.1267605633802815,1,4,142,0
7.237244798035607e+17,77,387,5.025974025974026,2,7,77,0
7.238006955039146e+17,3,4,1.3333333333333333,1,2,3,0
7.238073897632287e+17,70,283,4.042857142857143,2,6,70,0
7.238557923677164e+17,24,147,6.125,3,8,22,2
7.238729173015817e+17,45,144,3.2,1,5,45,0
7.239281819519633e+17,59,303,5.135593220338983,2,8,58,1
7.24414025672621e+17,110,230,2.090909090909091,1,5,110,0
7.244199643924017e+17,76,515,6.776315789473684,2,9,57,19
7.244661403338819e+17,13,18,1.3846153846153846,1,3,13,0
7.244673544514525e+17,39,79,2.0256410256410255,1,4,39,0
7.245172745979005e+17,5,35,7.0,4,10,3,2
7.245352096913636e+17,24,109,4.541666666666667,3,6,24,0
7.245729155970013e+17,48,486,10.125,3,12,2,46
7.24591987398605e+17,30,152,5.066666666666666,2,7,30,0
7.246025256933384e+17,17,81,4.764705882352941,3,7,17,0
7.246224595278103e+17,60,412,6.866666666666666,2,9,43,17
7.246242096139831e+17,116,1000,8.620689655172415,2,11,14,102
7.246612490277609e+17,142,294,2.0704225352112675,1,5,142,0
7.251934846326593e+17,56,124,2.2142857142857144,1,4,56,0
7.252182288193457e+17,26,42,1.6153846153846154,1,4,26,0
7.252346311474071e+17,57,120,2.1052631578947367,1,4,57,0
7.252403490237137e+17,51,101,1.9803921568627452,1,4,51,0
7.252605472630035e+17,46,187,4.065217391304348,1,7,46,0
7.252955313873083e+17,40,383,9.575,2,12,2,38
7.253028173737772e+17,33,303,9.181818181818182,3,11,4,29
7.253855041803263e+17,55,216,3.9272727272727272,2,7,55,0
7.253903474042497e+17,22,42,1.9090909090909092,1,4,22,0
7.257208121670532e+17,54,115,2.1296296296296298,1,4,54,0
7.257375848421978e+17,1,2,2.0,2,2,1,0
7.257511584732852e+17,12,52,4.333333333333333,2,6,12,0
7.257756542472754e+17,281,1102,3.921708185053381,1,7,281,0
7.257890041155387e+17,130,1115,8.576923076923077,2,12,23,107
7.257914499906889e+17,35,76,2.1714285714285713,1,4,35,0
7.257921176396726e+17,15,61,4.066666666666666,3,5,15,0
7.257984926594496e+17,10,33,3.3,2,5,10,0
7.258203769665885e+17,59,255,4.322033898305085,2,7,59,0
7.258408008653714e+17,36,346,9.61111111111111,3,12,3,33
7.258981736640969e+17,29,136,4.689655172413793,2,6,29,0
7.259356830661961e+17,73,144,1.9726027397260273,1,5,73,0
7.260348803778821e+17,26,201,7.730769230769231,4,10,9,17
7.26036624942303e+17,44,100,2.272727272727273,1,4,44,0
7.260961369936035e+17,31,43,1.3870967741935485,1,3,31,0
7.261184570119037e+17,4,4,1.0,1,1,4,0
7.264816409274868e+17,30,49,1.6333333333333333,1,3,30,0
7.264887624279923e+17,43,63,1.4651162790697674,1,4,43,0
7.26488838996271e+17,28,160,5.714285714285714,2,8,27,1
7.264940696345414e+17,31,58,1.8709677419354838,1,3,31,0
7.26509769546619e+17,50,79,1.58,1,4,50,0
7.265148872024714e+17,64,390,6.09375,3,8,58,6
7.265216650733978e+17,43,304,7.069767441860465,4,9,27,16
7.265714175577292e+17,22,39,1.7727272727272727,1,4,22,0
7.265857086574788e+17,29,66,2.2758620689655173,1,4,29,0
7.266098020166843e+17,17,115,6.764705882352941,2,9,13,4
7.266780511428366e+17,151,1328,8.794701986754967,2,12,18,133
7.267877687428266e+17,112,782,6.982142857142857,3,9,77,35
7.268045166371261e+17,35,312,8.914285714285715,2,12,4,31
7.268932617731704e+17,79,163,2.0632911392405062,1,5,79,0
7.269154274246737e+17,46,180,3.9130434782608696,2,6,46,0
7.270617975063174e+17,19,171,9.0,2,13,3,16
7.27140442442502e+17,17,145,8.529411764705882,3,11,4,13
7.271950255795462e+17,50,248,4.96,2,7,50,0
7.272316259431462e+17,1,9,9.0,9,9,0,1
7.272580157643483e+17,137,664,4.846715328467154,2,8,136,1
7.272979934264855e+17,68,193,2.838235294117647,1,6,68,0
7.273768583738158e+17,13,31,2.3846153846153846,1,4,13,0
7.273768622381404e+17,5,10,2.0,1,3,5,0
7.273792633391332e+17,1,2,2.0,2,2,1,0
7.273816077634685e+17,10,19,1.9,1,3,10,0
7.27404103456867e+17,119,247,2.0756302521008405,1,4,119,0
7.27418648259663e+17,50,109,2.18,1,4,50,0
7.274259454123729e+17,52,155,2.980769230769231,1,5,52,0
7.279874244299813e+17,144,575,3.9930555555555554,2,7,144,0
7.280049537572772e+17,105,408,3.8857142857142857,2,6,105,0
7.280442335567941e+17,2,9,4.5,3,6,2,0
7.280975965811156e+17,30,61,2.033333333333333,1,4,30,0
7.282261562841439e+17,108,522,4.833333333333333,1,7,108,0
7.282552485059053e+17,2,7,3.5,3,4,2,0
7.283546680050692e+17,1,7,7.0,7,7,1,0
7.289370876039213e+17,177,1187,6.706214689265536,2,9,131,46
7.289525737062072e+17,82,316,3.8536585365853657,2,6,82,0
7.289586781021216e+17,92,208,2.260869565217391,1,5,92,0
7.290949514266198e+17,31,178,5.741935483870968,3,7,31,0
7.294119292367073e+17,172,828,4.813953488372093,2,7,172,0
7.294125018823136e+17,3,7,2.3333333333333335,2,3,3,0
7.294296131985847e+17,44,96,2.1818181818181817,1,5,44,0
7.294763882165701e+17,26,56,2.1538461538461537,1,5,26,0
7.294982502736262e+17,40,77,1.925,1,3,40,0
7.295495223891901e+17,2,2,1.0,1,1,2,0
7.295768586588096e+17,19,29,1.5263157894736843,1,3,19,0
7.296288124389967e+17,178,1537,8.634831460674157,2,12,24,154
7.296453953525779e+17,17,133,7.823529411764706,6,10,7,10
7.296530319264102e+17,17,133,7.823529411764706,4,10,4,13
7.297970431452607e+17,16,22,1.375,1,2,16,0
7.301475843955301e+17,81,407,5.0246913580246915,3,7,81,0
7.3016149625758e+17,1,6,6.0,6,6,1,0
7.302632247896315e+17,51,98,1.9215686274509804,1,4,51,0
7.302871934058861e+17,70,344,4.914285714285715,2,8,69,1
7.303150130923197e+17,73,287,3.9315068493150687,2,7,73,0
7.303167817128184e+17,67,336,5.014925373134329,3,7,67,0
7.303742233827146e+17,2,2,1.0,1,1,2,0
7.3040603403122e+17,119,491,4.126050420168068,1,6,119,0
7.304126330740115e+17,49,111,2.2653061224489797,1,5,49,0
7.304323518188754e+17,76,673,8.855263157894736,3,12,9,67
7.304767091055944e+17,25,108,4.32,2,7,25,0
7.304885888106344e+17,13,50,3.8461538461538463,2,5,13,0
7.308462095805322e+17,86,746,8.674418604651162,2,11,9,77
7.308965751555681e+17,4,7,1.75,1,3,4,0
7.308969138584483e+17,5,12,2.4,2,3,5,0
7.309594038129548e+17,29,198,6.827586206896552,2,8,17,12
7.309927440508125e+17,5,8,1.6,1,3,5,0
7.31096625120839e+17,62,413,6.661290322580645,4,9,49,13
7.311338010465696e+17,32,225,7.03125,5,9,25,7
7.311593243146601e+17,118,238,2.016949152542373,1,4,118,0
7.311932172963127e+17,38,250,6.578947368421052,2,9,28,10
7.312803826653684e+17,148,320,2.1621621621621623,1,5,148,0
7.31565605054289e+17,33,254,7.696969696969697,3,10,11,22
7.315814115914742e+17,52,166,3.1923076923076925,1,6,52,0
7.315911612925421e+17,1,3,3.0,3,3,1,0
7.315925041274796e+17,236,2055,8.707627118644067,3,12,36,200
7.316116746302272e+17,21,37,1.7619047619047619,1,4,21,0
7.316190557003534e+17,4,5,1.25,1,2,4,0
7.316228075240959e+17,6,9,1.5,1,3,6,0
7.316263193429228e+17,23,207,9.0,4,12,5,18
7.316365472284218e+17,56,376,6.714285714285714,3,9,40,16
7.316378900039104e+17,15,106,7.066666666666666,5,9,10,5
7.316614028394166e+17,52,255,4.903846153846154,2,7,52,0
7.316995369966156e+17,73,147,2.0136986301369864,1,4,73,0
7.317189271396705e+17,2,3,1.5,1,2,2,0
7.317266756841362e+17,5,28,5.6,4,7,5,0
7.317669462534565e+17,6,49,8.166666666666666,4,11,1,5
7.317785007085366e+17,4,8,2.0,1,3,4,0
7.318130720529281e+17,2,5,2.5,2,3,2,0
7.318363420685599e+17,14,28,2.0,1,4,14,0
7.318428146700088e+17,14,76,5.428571428571429,4,7,14,0
7.318489489593344e+17,5,10,2.0,1,3,5,0
7.318509721278779e+17,3,25,8.333333333333334,7,10,1,2
7.318568716195779e+17,25,55,2.2,1,5,25,0
7.318789889020161e+17,12,99,8.25,6,10,3,9
7.319035318616214e+17,80,226,2.825,1,5,80,0
7.319337283408744e+17,19,38,2.0,1,4,19,0
7.319901372872549e+17,9,18,2.0,1,3,9,0
7.323423761341358e+17,39,96,2.4615384615384617,1,5,39,0
7.323607825127418e+17,45,309,6.866666666666666,2,9,33,12
7.323740808189829e+17,24,59,2.4583333333333335,1,4,24,0
7.324112293584691e+17,60,417,6.95,4,10,41,19
7.32461949864053e+17,4,32,8.0,6,9,1,3
7.324963739923983e+17,1,1,1.0,1,1,1,0
7.324994310107903e+17,12,23,1.9166666666666667,1,3,12,0
7.325264511343263e+17,104,402,3.8653846153846154,2,6,104,0
7.325507004018694e+17,2,6,3.0,2,4,2,0
7.329027384531442e+17,8,11,1.375,1,3,8,0
7.330282397360653e+17,2,5,2.5,2,3,2,0
7.332033212842765e+17,13,25,1.9230769230769231,1,4,13,0
7.332188331377667e+17,45,234,5.2,2,7,45,0
7.333163637618925e+17,1,9,9.0,9,9,0,1
7.3362907308218e+17,4,23,5.75,3,7,4,0
7.337514197357667e+17,4,7,1.75,1,3,4,0
7.338046108772979e+17,53,205,3.8679245283018866,2,7,53,0
7.33922698888692e+17,27,134,4.962962962962963,3,7,27,0
7.339312550677196e+17,7,20,2.857142857142857,1,5,7,0
7.340990519490304e+17,68,335,4.926470588235294,3,7,68,0
7.341498909668969e+17,110,224,2.036363636363636,1,4,110,0
7.341564586392988e+17,22,126,5.7272727272727275,3,8,21,1
7.344186271945407e+17,16,31,1.9375,1,4,16,0
7.344504926198824e+17,3,10,3.3333333333333335,2,4,3,0
7.344514747630013e+17,20,202,10.1,9,12,0,20
7.344575413755461e+17,1,2,2.0,2,2,1,0
7.344618484999626e+17,57,393,6.894736842105263,5,9,42,15
7.344698609678417e+17,23,55,2.391304347826087,1,5,23,0
7.344888229104886e+17,24,228,9.5,8,11,0,24
7.344927126489413e+17,44,302,6.863636363636363,4,9,32,12
7.345594818742636e+17,32,203,6.34375,3,8,27,5
7.34617503079092e+17,16,127,7.9375,6,10,4,12
7.346326303442285e+17,37,171,4.621621621621622,2,7,37,0
7.346766176609199e+17,22,214,9.727272727272727,8,12,0,22
7.347093484800579e+17,231,2008,8.692640692640692,2,12,29,202
7.348019126652296e+17,21,177,8.428571428571429,6,11,3,18
7.351168745041012e+17,48,65,1.3541666666666667,1,3,48,0
7.351655810798296e+17,2,14,7.0,7,7,2,0
7.351723356037587e+17,1,2,2.0,2,2,1,0
7.351930609519309e+17,26,220,8.461538461538462,2,11,5,21
7.35205469072801e+17,5,11,2.2,2,3,5,0
7.352294412505673e+17,1,1,1.0,1,1,1,0
7.352331044529733e+17,2,4,2.0,2,2,2,0
7.352984825280143e+17,18,144,8.0,3,11,5,13
7.35346065064465e+17,56,239,4.267857142857143,1,7,56,0
7.353607544395096e+17,16,62,3.875,2,5,16,0
7.353919201304727e+17,98,208,2.122448979591837,1,4,98,0
7.354159473948855e+17,62,195,3.1451612903225805,1,6,62,0
7.35418911306488e+17,56,278,4.964285714285714,3,8,55,1
7.355058938397853e+17,17,59,3.4705882352941178,1,6,17,0
7.355640500508815e+17,80,327,4.0875,2,7,80,0
7.355776453320005e+17,75,296,3.9466666666666668,2,7,75,0
7.356344617767297e+17,2,15,7.5,7,8,1,1
7.358988479154068e+17,105,818,7.79047619047619,5,10,40,65
7.35979715877733e+17,31,70,2.2580645161290325,1,4,31,0
7.359801118204704e+17,8,17,2.125,1,4,8,0
7.360572637290339e+17,82,115,1.4024390243902438,1,4,82,0
7.361056163674134e+17,23,106,4.608695652173913,3,6,23,0
7.361218781098964e+17,3,20,6.666666666666667,5,8,2,1
7.361478218993923e+17,152,314,2.0657894736842106,1,5,152,0
7.361846212128942e+17,13,118,9.076923076923077,3,11,2,11
7.361921748449723e+17,58,125,2.1551724137931036,1,4,58,0
7.362235123525585e+17,113,242,2.1415929203539825,1,5,113,0
7.363168340207739e+17,1,4,4.0,4,4,1,0
7.365941224601542e+17,2,4,2.0,1,3,2,0
7.366450966853677e+17,5,8,1.6,1,3,5,0
7.366489217953307e+17,74,503,6.797297297297297,2,10,51,23
7.366610823243388e+17,6,45,7.5,6,8,2,4
7.367402884422188e+17,167,1149,6.880239520958084,2,10,119,48
7.367863899834875e+17,116,588,5.068965517241379,2,8,115,1
7.367906412463923e+17,42,301,7.166666666666667,2,10,24,18
7.36908246244539e+17,2,3,1.5,1,2,2,0
7.373373233814979e+17,4,10,2.5,2,3,4,0
7.373625991822385e+17,12,79,6.583333333333333,6,8,10,2
7.373870451276987e+17,27,141,5.222222222222222,3,7,27,0
7.373965278733878e+17,1,6,6.0,6,6,1,0
7.373987519727612e+17,21,124,5.904761904761905,2,8,19,2
7.37436042383873e+17,140,970,6.928571428571429,2,10,99,41
7.374386429615063e+17,181,566,3.1270718232044197,1,5,181,0
7.374574221731958e+17,159,1346,8.465408805031446,2,11,23,136
7.374759553868037e+17,163,798,4.895705521472393,2,8,159,4
7.374759942425978e+17,212,1052,4.962264150943396,2,8,211,1
7.375034283163628e+17,135,666,4.933333333333334,2,8,134,1
7.376290967652468e+17,2,15,7.5,7,8,1,1
7.376373706687994e+17,70,294,4.2,1,7,70,0
7.376573543454427e+17,4,17,4.25,3,6,4,0
7.376668482112303e+17,135,197,1.4592592592592593,1,4,135,0
7.381512747704936e+17,18,130,7.222222222222222,6,9,10,8
7.382515862544434e+17,141,931,6.602836879432624,2,9,108,33
7.382633452961673e+17,135,411,3.0444444444444443,1,5,135,0
7.383235954426662e+17,12,34,2.8333333333333335,1,4,12,0
7.383366731684238e+17,147,1253,8.523809523809524,2,12,16,131
7.383665093471291e+17,80,789,9.8625,2,12,1,79
7.384404250374149e+17,59,307,5.203389830508475,3,7,59,0
7.390077508754926e+17,77,312,4.0519480519480515,1,8,76,1
7.390502930758071e+17,149,451,3.0268456375838926,1,5,149,0
7.391120069529857e+17,14,44,3.142857142857143,2,5,14,0
7.396148073748032e+17,51,108,2.1176470588235294,1,4,51,0
7.396383721249708e+17,105,238,2.2666666666666666,1,5,105,0
7.396391860169834e+17,6,14,2.3333333333333335,1,4,6,0
7.396672449728122e+17,56,118,2.107142857142857,1,5,56,0
7.396675133633116e+17,6,32,5.333333333333333,3,8,5,1
7.39677328808839e+17,5,20,4.0,2,6,5,0
7.396942980342813e+17,46,383,8.326086956521738,2,11,10,36
7.396966808189105e+17,3,16,5.333333333333333,5,6,3,0
7.397549677172261e+17,3,13,4.333333333333333,4,5,3,0
7.397821543403596e+17,88,769,8.738636363636363,2,12,12,76
7.398265629331136e+17,12,99,8.25,6,10,3,9
7.398361277771706e+17,64,193,3.015625,1,6,64,0
7.398363120382172e+17,46,221,4.804347826086956,3,8,45,1
7.398436747058301e+17,9,31,3.4444444444444446,2,6,9,0
7.39889126438625e+17,18,35,1.9444444444444444,1,3,18,0
7.39894100349429e+17,42,84,2.0,1,4,42,0
7.398969598747619e+17,7,46,6.571428571428571,2,9,5,2
7.40241916574544e+17,41,275,6.7073170731707314,4,9,31,10
7.40260158818958e+17,75,373,4.973333333333334,3,7,75,0
7.405009704708095e+17,26,198,7.615384615384615,4,10,12,14
7.405156698215726e+17,16,49,3.0625,1,5,16,0
7.406006759494492e+17,24,44,1.8333333333333333,1,4,24,0
7.406169900472639e+17,130,1152,8.861538461538462,3,12,14,116
7.409560679109332e+17,14,47,3.357142857142857,1,5,14,0
7.40978927983136e+17,113,1100,9.734513274336283,3,13,9,104
7.40984245779802e+17,4,30,7.5,7,9,3,1
7.410021241870554e+17,4,26,6.5,6,7,4,0
7.410320154441688e+17,21,47,2.238095238095238,1,4,21,0
7.410419644126427e+17,119,453,3.80672268907563,1,6,119,0
7.41052749751924e+17,25,48,1.92,1,4,25,0
7.410528478837386e+17,38,77,2.026315789473684,1,5,38,0
7.41054250693206e+17,21,179,8.523809523809524,5,11,2,19
7.410676973582499e+17,26,211,8.115384615384615,6,10,6,20
7.410896743295917e+17,11,44,4.0,2,6,11,0
7.41117709124637e+17,134,1297,9.67910447761194,2,12,9,125
7.411894098889052e+17,10,17,1.7,1,2,10,0
7.411968673446148e+17,64,132,2.0625,1,4,64,0
7.412062910936422e+17,133,917,6.894736842105263,2,9,87,46
7.412938144734397e+17,38,259,6.815789473684211,3,10,27,11
7.412959301011345e+17,42,204,4.857142857142857,1,8,41,1
7.41305707431462e+17,51,367,7.196078431372549,5,9,35,16
7.41696768837125e+17,12,82,6.833333333333333,4,8,10,2
7.417350033759839e+17,3,4,1.3333333333333333,1,2,3,0
7.417405293268955e+17,5,6,1.2,1,2,5,0
7.417791161761825e+17,82,545,6.646341463414634,2,9,58,24
7.417879845370646e+17,31,235,7.580645161290323,3,10,15,16
7.419091421894725e+17,61,139,2.278688524590164,1,5,61,0
7.420063037960937e+17,21,96,4.571428571428571,2,6,21,0
7.422716419095645e+17,3,27,9.0,8,10,0,3
7.424465801111956e+17,55,213,3.8727272727272726,1,7,55,0
7.42463086470094e+17,53,105,1.9811320754716981,1,4,53,0
7.424668121497544e+17,78,375,4.8076923076923075,3,7,78,0
7.425064419603046e+17,44,93,2.1136363636363638,1,4,44,0
7.425335041067418e+17,104,506,4.865384615384615,2,7,104,0
7.425850278038391e+17,5,8,1.6,1,2,5,0
7.425903187530803e+17,1,1,1.0,1,1,1,0
7.426007889288041e+17,44,303,6.886363636363637,4,9,29,15
7.426476788966076e+17,18,88,4.888888888888889,4,7,18,0
7.428323667159907e+17,2,5,2.5,2,3,2,0
7.430090112803421e+17,8,30,3.75,3,5,8,0
7.430823505113132e+17,107,219,2.046728971962617,1,4,107,0
7.431605938374792e+17,57,335,5.87719298245614,3,8,53,4
7.431842306792797e+17,3,23,7.666666666666667,6,9,1,2
7.433319405454925e+17,43,247,5.744186046511628,2,8,42,1
7.433984940370886e+17,121,574,4.743801652892562,2,7,121,0
7.434853274847363e+17,9,37,4.111111111111111,2,5,9,0
7.435588696066522e+17,6,42,7.0,5,9,4,2
7.439053371442871e+17,123,1210,9.83739837398374,2,12,5,118
7.439253481221012e+17,53,245,4.622641509433962,2,6,53,0
7.439937937425318e+17,1,6,6.0,6,6,1,0
7.439943250412411e+17,6,42,7.0,6,8,4,2
7.440052100807434e+17,50,417,8.34,2,11,9,41
7.440090499299628e+17,29,144,4.9655172413793105,2,7,29,0
7.441058823750564e+17,28,195,6.964285714285714,3,9,16,12
7.441682831916398e+17,158,1222,7.734177215189874,2,10,54,104
7.441881755434006e+17,113,1083,9.584070796460177,3,13,7,106
7.442153489179907e+17,58,117,2.0172413793103448,1,5,58,0
7.442402793342834e+17,31,272,8.774193548387096,5,11,4,27
7.44582588649662e+17,11,25,2.272727272727273,1,4,11,0
7.445837989291544e+17,36,172,4.777777777777778,2,7,36,0
7.446035617623544e+17,58,550,9.482758620689655,3,12,5,53
7.446214208826767e+17,132,651,4.931818181818182,2,8,131,1
7.44656291602745e+17,49,250,5.1020408163265305,3,7,49,0
7.446628830044589e+17,27,73,2.7037037037037037,1,6,27,0
7.446692499320863e+17,77,166,2.155844155844156,1,5,77,0
7.446811730728534e+17,3,8,2.6666666666666665,1,4,3,0
7.446894997090437e+17,129,1255,9.728682170542635,2,12,8,121
7.447250893934688e+17,92,277,3.010869565217391,1,5,92,0
7.447809138097271e+17,68,91,1.338235294117647,1,4,68,0
7.44850341968377e+17,28,239,8.535714285714286,3,12,6,22
7.448616820492508e+17,1,2,2.0,2,2,1,0
7.448655408984456e+17,49,285,5.816326530612245,3,8,46,3
7.449488786738958e+17,69,211,3.0579710144927534,1,6,69,0
7.45014210992666e+17,51,209,4.098039215686274,2,6,51,0
7.452693910696256e+17,46,228,4.956521739130435,2,8,45,1
7.453012840553021e+17,40,91,2.275,1,5,40,0
7.45356639876254e+17,26,52,2.0,1,4,26,0
7.453574307416381e+17,17,116,6.823529411764706,4,9,13,4
7.453581947012058e+17,24,162,6.75,2,9,16,8
7.453600891779791e+17,96,407,4.239583333333333,2,6,96,0
7.453983815820902e+17,113,998,8.831858407079647,2,11,9,104
7.454098285724689e+17,9,36,4.0,2,6,9,0
7.454415127234004e+17,36,306,8.5,3,10,6,30
7.455447665658739e+17,19,37,1.9473684210526316,1,4,19,0
7.456432798391836e+17,10,61,6.1,3,8,6,4
7.460396645944209e+17,84,641,7.630952380952381,2,11,34,50
7.460753576945108e+17,69,519,7.521739130434782,2,10,32,37
7.460817901352264e+17,68,255,3.75,1,6,68,0
7.46081961649177e+17,15,60,4.0,2,5,15,0
7.461387716545765e+17,34,317,9.323529411764707,4,12,3,31
7.461488451840813e+17,6,47,7.833333333333333,6,9,2,4
7.46152039601357e+17,95,648,6.821052631578947,2,10,64,31
7.461704726652215e+17,97,211,2.1752577319587627,1,5,97,0
7.461803911802162e+17,33,68,2.0606060606060606,1,4,33,0
7.463054889009311e+17,45,306,6.8,2,9,31,14
7.463154086973146e+17,12,23,1.9166666666666667,1,3,12,0
7.463257755235021e+17,9,32,3.5555555555555554,2,5,9,0
7.463419367479016e+17,58,131,2.2586206896551726,1,5,58,0
7.463775468984058e+17,41,60,1.4634146341463414,1,4,41,0
7.467304268151242e+17,79,395,5.0,2,7,79,0
7.467599070087241e+17,94,924,9.829787234042554,3,13,3,91
7.467763177276964e+17,6,32,5.333333333333333,5,6,6,0
7.467877409574867e+17,4,18,4.5,3,5,4,0
7.468029977375789e+17,2,14,7.0,6,8,1,1
7.468211274880353e+17,30,152,5.066666666666666,3,8,29,1
7.468288455000095e+17,19,100,5.2631578947368425,3,7,19,0
7.468378857531872e+17,12,61,5.083333333333333,3,7,12,0
7.468413426340109e+17,19,73,3.8421052631578947,2,6,19,0
7.468451886251917e+17,6,26,4.333333333333333,3,5,6,0
7.468537894731724e+17,12,83,6.916666666666667,4,9,8,4
7.468640388241564e+17,13,27,2.076923076923077,1,4,13,0
7.468751604783685e+17,8,26,3.25,2,5,8,0
7.468835780199053e+17,2,12,6.0,5,7,2,0
7.470092365540718e+17,48,328,6.833333333333333,4,8,31,17
7.47012670680388e+17,8,26,3.25,2,6,8,0
7.471515253143855e+17,184,929,5.048913043478261,2,8,182,2
7.474182702250856e+17,9,60,6.666666666666667,2,9,7,2
7.477245139529005e+17,46,180,3.9130434782608696,1,7,46,0
7.482038762760124e+17,23,211,9.173913043478262,7,11,1,22
7.483927399230415e+17,68,460,6.764705882352941,3,10,52,16
7.485703307267438e+17,40,128,3.2,2,5,40,0
7.48584872809754e+17,13,32,2.4615384615384617,1,4,13,0
7.486132771762662e+17,50,499,9.98,5,12,1,49
7.489289203487569e+17,10,102,10.2,8,12,0,10
7.489368944912238e+17,13,120,9.23076923076923,3,12,1,12
7.490564837841677e+17,10,29,2.9,2,4,10,0
7.492798254362292e+17,15,67,4.466666666666667,3,6,15,0
7.493236606984605e+17,87,423,4.862068965517241,2,9,86,1
7.493442073294552e+17,142,716,5.042253521126761,2,7,142,0
7.493772896174638e+17,11,94,8.545454545454545,7,10,1,10
7.496762087360854e+17,5,13,2.6,2,4,5,0
7.497536871098765e+17,8,50,6.25,3,8,6,2
7.497651933210368e+17,87,850,9.770114942528735,3,12,3,84
7.497715826541431e+17,79,775,9.810126582278482,2,13,6,73
7.49831841808803e+17,7,16,2.2857142857142856,1,3,7,0
7.498452669157513e+17,196,575,2.933673469387755,1,6,196,0
7.498480474230422e+17,79,539,6.822784810126582,2,9,56,23
7.498916463398632e+17,107,715,6.682242990654205,2,10,73,34
7.499395338159136e+17,66,336,5.090909090909091,2,7,66,0
7.499443872020076e+17,90,789,8.766666666666667,4,13,16,74
7.50387574298495e+17,20,187,9.35,2,12,1,19
7.505539405562194e+17,20,123,6.15,5,7,20,0
7.506344619318458e+17,30,230,7.666666666666667,2,9,12,18
7.506515084040887e+17,5,13,2.6,2,4,5,0
7.511239973516106e+17,67,137,2.044776119402985,1,5,67,0
7.512188222184558e+17,8,15,1.875,1,4,8,0
7.512995844824443e+17,43,284,6.604651162790698,2,10,37,6
7.513460423447753e+17,50,493,9.86,5,13,2,48
7.513620399162679e+17,2,4,2.0,2,2,2,0
7.51377315474538e+17,41,283,6.902439024390244,2,9,29,12
7.513797246901146e+17,1,2,2.0,2,2,1,0
7.514238883104156e+17,41,291,7.097560975609756,4,9,24,17
7.514320577358181e+17,151,1267,8.390728476821192,2,11,29,122
7.515024134314918e+17,3,14,4.666666666666667,3,7,3,0
7.515246720097491e+17,1,3,3.0,3,3,1,0
7.515520705917348e+17,13,87,6.6923076923076925,5,8,11,2
7.516010806055599e+17,303,2697,8.900990099009901,2,11,24,279
7.517909671774336e+17,12,53,4.416666666666667,3,6,12,0
7.518376549444566e+17,135,515,3.814814814814815,2,7,135,0
7.519605060096067e+17,23,187,8.130434782608695,6,10,8,15
7.519785236401044e+17,7,21,3.0,2,4,7,0
7.520643773544367e+17,1,4,4.0,4,4,1,0
7.52097262161324e+17,1,2,2.0,2,2,1,0
7.521304742199828e+17,4,30,7.5,7,8,2,2
7.525821413246447e+17,88,435,4.943181818181818,2,8,87,1
7.526397596633247e+17,56,548,9.785714285714286,5,12,1,55
7.526622353902268e+17,12,30,2.5,2,3,12,0
7.526811629725212e+17,3,6,2.0,1,3,3,0
7.52691712047628e+17,20,38,1.9,1,3,20,0
7.527185687045208e+17,13,62,4.769230769230769,3,6,13,0
7.5280283398059e+17,6,10,1.6666666666666667,1,3,6,0
7.533068774491457e+17,121,607,5.016528925619835,3,7,121,0
7.53330908755032e+17,22,119,5.409090909090909,4,7,22,0
7.53388245514744e+17,65,197,3.0307692307692307,1,5,65,0
7.534220123077206e+17,46,94,2.0434782608695654,1,4,46,0
7.535225825490591e+17,130,1263,9.715384615384615,2,13,7,123
7.536643870103054e+17,151,1026,6.7947019867549665,2,10,113,38
7.54047118541281e+17,7,34,4.857142857142857,4,6,7,0
7.540554764166286e+17,46,458,9.956521739130435,7,12,2,44
7.542758641717992e+17,70,467,6.671428571428572,2,9,53,17
7.542898435953919e+17,34,334,9.823529411764707,8,12,0,34
7.543193017040326e+17,12,16,1.3333333333333333,1,2,12,0
7.544854468159378e+17,21,167,7.9523809523809526,6,9,6,15
7.547333073494368e+17,38,349,9.18421052631579,4,12,4,34
7.547838491529002e+17,79,541,6.848101265822785,4,11,54,25
7.548343852721158e+17,117,833,7.119658119658119,4,9,72,45
7.548665275865302e+17,125,1087,8.696,2,12,16,109
7.548857076225523e+17,69,140,2.028985507246377,1,4,69,0
7.549128409994386e+17,1,2,2.0,2,2,1,0
7.549414906329524e+17,10,80,8.0,2,10,2,8
7.549655293010956e+17,51,491,9.627450980392156,5,13,3,48
7.550123020861997e+17,76,299,3.9342105263157894,2,6,76,0
7.550876225784038e+17,52,64,1.2307692307692308,1,3,52,0
7.554552394098693e+17,127,884,6.960629921259843,2,10,84,43
7.554818714344088e+17,1,6,6.0,6,6,1,0
7.554920623072827e+17,11,56,5.090909090909091,4,7,11,0
7.554925933039205e+17,86,430,5.0,2,7,86,0
7.555012339089391e+17,1,8,8.0,8,8,0,1
7.555025082038789e+17,61,141,2.3114754098360657,1,5,61,0
7.55503478394418e+17,1,4,4.0,4,4,1,0
7.555368130390351e+17,1,4,4.0,4,4,1,0
7.555791551144114e+17,5,29,5.8,4,8,4,1
7.556038869733725e+17,54,460,8.518518518518519,3,11,6,48
7.556197756899656e+17,35,172,4.914285714285715,3,7,35,0
7.556553592024205e+17,75,281,3.7466666666666666,2,6,75,0
7.556619361311393e+17,30,219,7.3,2,10,15,15
7.55665003333443e+17,2,7,3.5,3,4,2,0
7.558164088464698e+17,85,327,3.847058823529412,1,6,85,0
7.55848607697264e+17,29,271,9.344827586206897,4,12,4,25
7.558622726971469e+17,160,330,2.0625,1,4,160,0
7.559855600319796e+17,91,445,4.8901098901098905,2,7,91,0
7.560971787081868e+17,110,542,4.927272727272728,2,8,109,1
7.5625742318805e+17,22,72,3.272727272727273,2,5,22,0
7.562758164558566e+17,39,114,2.923076923076923,2,5,39,0
7.562878796815986e+17,47,103,2.1914893617021276,1,4,47,0
7.562967338805212e+17,70,490,7.0,2,10,45,25
7.562993213896518e+17,10,29,2.9,2,4,10,0
7.563105574959277e+17,67,138,2.0597014925373136,1,6,67,0
7.563333960605475e+17,8,55,6.875,5,8,5,3
7.563409008640901e+17,74,138,1.864864864864865,1,4,74,0
7.563464651303197e+17,5,17,3.4,2,4,5,0
7.563775339673784e+17,120,484,4.033333333333333,1,7,120,0
7.563970825810487e+17,2,16,8.0,7,9,1,1
7.564245543308751e+17,73,356,4.876712328767123,3,8,72,1
7.564261557964033e+17,10,38,3.8,2,6,10,0
7.56426320909391e+17,3,15,5.0,4,6,3,0
7.565671617594684e+17,3,8,2.6666666666666665,1,4,3,0
7.565997784366086e+17,25,231,9.24,3,12,1,24
7.566344125378984e+17,27,33,1.2222222222222223,1,4,27,0
7.569316962508919e+17,110,230,2.090909090909091,1,5,110,0
7.569329428597801e+17,88,174,1.9772727272727273,1,4,88,0
7.569670092150141e+17,3,23,7.666666666666667,7,8,1,2
7.569674741692781e+17,90,194,2.1555555555555554,1,4,90,0
7.569881653952884e+17,110,421,3.827272727272727,1,6,110,0
7.569969551117894e+17,1,9,9.0,9,9,0,1
7.570166845681358e+17,2,6,3.0,2,4,2,0
7.570192087941004e+17,7,23,3.2857142857142856,2,4,7,0
7.570203894716864e+17,5,15,3.0,1,4,5,0
7.570449137399287e+17,1,3,3.0,3,3,1,0
7.570878570373574e+17,16,54,3.375,2,5,16,0
7.571492115889706e+17,109,955,8.761467889908257,2,12,14,95
7.571502967657046e+17,7,15,2.142857142857143,1,5,7,0
7.571730721278973e+17,76,726,9.552631578947368,3,13,5,71
7.572735374408567e+17,159,780,4.90566037735849,2,8,156,3
7.573710513659366e+17,85,581,6.8352941176470585,3,10,63,22
7.576731331980027e+17,235,931,3.9617021276595743,1,7,235,0
7.577360300966546e+17,9,42,4.666666666666667,4,6,9,0
7.577419319031569e+17,6,46,7.666666666666667,6,8,1,5
7.577901270131726e+17,2,5,2.5,2,3,2,0
7.577951598688677e+17,88,593,6.738636363636363,2,10,61,27
7.578792210566198e+17,11,24,2.1818181818181817,1,3,11,0
7.579181543314776e+17,62,136,2.193548387096774,1,4,62,0
7.579340769186381e+17,115,559,4.860869565217391,2,7,115,0
7.580049524491866e+17,205,1050,5.121951219512195,2,8,204,1
7.581077193444668e+17,86,124,1.441860465116279,1,4,86,0
7.58111570750935e+17,129,1259,9.75968992248062,2,12,6,123
7.584480038177555e+17,1,10,10.0,10,10,0,1
7.584498303001491e+17,5,44,8.8,3,11,1,4
7.584629322332562e+17,12,93,7.75,6,9,4,8
7.584676711276191e+17,3,21,7.0,5,8,1,2
7.58507173183994e+17,1,2,2.0,2,2,1,0
7.585285520336909e+17,35,106,3.0285714285714285,1,5,35,0
7.586493248659368e+17,9,60,6.666666666666667,2,9,5,4
7.586887634999639e+17,55,216,3.9272727272727272,2,6,55,0
7.587202706935137e+17,73,344,4.712328767123288,2,8,72,1
7.587708396630034e+17,13,18,1.3846153846153846,1,2,13,0
7.587733199511662e+17,23,34,1.4782608695652173,1,3,23,0
7.591816718750228e+17,126,255,2.0238095238095237,1,4,126,0
7.592269544042932e+17,17,84,4.9411764705882355,2,7,17,0
7.592373310615004e+17,40,191,4.775,3,7,40,0
7.5924795554229e+17,81,387,4.777777777777778,2,7,81,0
7.592943669281379e+17,4,11,2.75,1,4,4,0
7.593943806066719e+17,2,5,2.5,2,3,2,0
7.594199487724548e+17,3,7,2.3333333333333335,2,3,3,0
7.594657026219218e+17,11,85,7.7272727272727275,6,10,3,8
7.595162543746579e+17,71,654,9.211267605633802,2,12,9,62
7.598099700886911e+17,2,13,6.5,6,7,2,0
7.598445316571332e+17,21,110,5.238095238095238,3,7,21,0
7.599419779062326e+17,57,567,9.947368421052632,3,13,2,55
7.599852899248977e+17,1,2,2.0,2,2,1,0
7.599986508239465e+17,1,4,4.0,4,4,1,0
7.59999668192961e+17,17,139,8.176470588235293,5,11,5,12
7.600038095142931e+17,201,1958,9.74129353233831,3,12,10,191
7.600120883627889e+17,35,227,6.485714285714286,3,9,29,6
7.600165595542354e+17,89,257,2.8876404494382024,1,5,89,0
7.600243051877775e+17,83,248,2.9879518072289155,1,6,83,0
7.600333200593619e+17,11,81,7.363636363636363,5,9,4,7
7.600663343458339e+17,52,150,2.8846153846153846,1,5,52,0
7.600821789169898e+17,56,276,4.928571428571429,3,7,56,0
7.600929024018776e+17,122,473,3.877049180327869,2,7,122,0
7.602378233230644e+17,61,130,2.1311475409836067,1,4,61,0
7.605322253250245e+17,42,399,9.5,2,11,4,38
7.60532884492573e+17,11,76,6.909090909090909,5,8,8,3
7.605465969590061e+17,9,59,6.555555555555555,5,8,8,1
7.605536197040554e+17,50,479,9.58,3,13,4,46
7.605581567132854e+17,50,256,5.12,2,8,49,1
7.605873749729737e+17,37,266,7.1891891891891895,5,9,19,18
7.606342149973917e+17,5,7,1.4,1,2,5,0
7.60671410203649e+17,60,128,2.1333333333333333,1,4,60,0
7.608069447911572e+17,9,50,5.555555555555555,4,7,9,0
7.608358283158525e+17,191,1868,9.780104712041885,2,13,12,179
7.613305949577462e+17,114,584,5.12280701754386,2,7,114,0
7.613554682989536e+17,190,1638,8.621052631578948,2,12,22,168
7.613743264079368e+17,100,512,5.12,3,7,100,0
7.613762831885797e+17,41,86,2.097560975609756,1,4,41,0
7.613933327933107e+17,10,19,1.9,1,4,10,0
7.613992639381134e+17,1,1,1.0,1,1,1,0
7.614218376858181e+17,80,381,4.7625,2,7,80,0
7.61480104970433e+17,13,106,8.153846153846153,6,10,3,10
7.6149486763873e+17,19,91,4.7894736842105265,2,7,19,0
7.615437149706656e+17,3,27,9.0,8,10,0,3
7.615475321551432e+17,39,116,2.9743589743589745,1,5,39,0
7.620264060903373e+17,101,507,5.01980198019802,2,7,101,0
7.620395080435217e+17,78,392,5.0256410256410255,3,7,78,0
7.620518052131232e+17,47,184,3.9148936170212765,2,6,47,0
7.620558318326504e+17,73,368,5.041095890410959,3,8,72,1
7.620615494002241e+17,68,266,3.911764705882353,2,6,68,0
7.620637672911173e+17,81,331,4.08641975308642,2,6,81,0
7.620655652283676e+17,72,274,3.8055555555555554,1,6,72,0
7.620689392229084e+17,39,148,3.7948717948717947,1,6,39,0
7.620708376945825e+17,48,185,3.8541666666666665,2,6,48,0
7.621258633591826e+17,3,5,1.6666666666666667,1,3,3,0
7.621462821760479e+17,3,8,2.6666666666666665,2,4,3,0
7.621515016135366e+17,81,151,1.8641975308641976,1,4,81,0
7.622258426226666e+17,28,61,2.1785714285714284,1,4,28,0
7.622295783282236e+17,27,192,7.111111111111111,5,9,18,9
7.622412538464795e+17,133,927,6.969924812030075,2,9,82,51
7.622512315099181e+17,65,446,6.861538461538461,4,10,47,18
7.622663492555841e+17,88,609,6.920454545454546,2,10,56,32
7.623459899321148e+17,118,593,5.02542372881356,2,7,118,0
7.62747804578245e+17,114,566,4.964912280701754,2,7,114,0
7.627612824549192e+17,107,519,4.850467289719626,2,7,107,0
7.628231631481503e+17,28,167,5.964285714285714,3,8,26,2
7.628275473322431e+17,14,22,1.5714285714285714,1,3,14,0
7.628305250672394e+17,1,3,3.0,3,3,1,0
7.628440509542381e+17,21,109,5.190476190476191,3,7,21,0
7.628601355238726e+17,101,503,4.98019801980198,2,8,100,1
7.628804101745924e+17,69,467,6.768115942028985,4,10,52,17
7.629291970354812e+17,30,154,5.133333333333334,3,7,30,0
7.629298491746164e+17,12,23,1.9166666666666667,1,3,12,0
7.629453984075729e+17,40,351,8.775,6,12,6,34
7.629668668842077e+17,3,20,6.666666666666667,6,7,3,0
7.630012037821324e+17,21,175,8.333333333333334,7,11,7,14
7.630169299368781e+17,76,372,4.894736842105263,2,7,76,0
7.630234289208626e+17,81,165,2.037037037037037,1,4,81,0
7.630448500807455e+17,154,309,2.0064935064935066,1,5,154,0
7.630674701700767e+17,119,821,6.899159663865547,3,9,90,29
7.631999989616882e+17,68,600,8.823529411764707,4,11,7,61
7.635479035392287e+17,35,49,1.4,1,3,35,0
7.635524664850212e+17,48,289,6.020833333333333,4,8,46,2
7.635766683969069e+17,29,177,6.103448275862069,2,9,23,6
7.635795888712404e+17,4,28,7.0,6,8,3,1
7.636042580039224e+17,14,28,2.0,1,3,14,0
7.636448331654593e+17,12,56,4.666666666666667,2,6,12,0
7.637521762934587e+17,18,90,5.0,2,7,18,0
7.642178624223067e+17,47,239,5.085106382978723,2,7,47,0
7.64239109946126e+17,60,187,3.1166666666666667,1,6,60,0
7.642830813019977e+17,45,100,2.2222222222222223,1,4,45,0
7.643330573200082e+17,40,276,6.9,4,9,28,12
7.643385640932255e+17,2,4,2.0,2,2,2,0
7.643776983721377e+17,2,6,3.0,2,4,2,0
7.644219214620067e+17,8,21,2.625,1,5,8,0
7.645206221781556e+17,1,8,8.0,8,8,0,1
7.64531682066173e+17,77,371,4.818181818181818,2,7,77,0
7.646067146173249e+17,30,295,9.833333333333334,5,12,3,27
7.646994453867098e+17,86,171,1.9883720930232558,1,5,86,0
7.650288353308357e+17,19,77,4.052631578947368,2,6,19,0
7.650526189747064e+17,98,199,2.0306122448979593,1,4,98,0
7.650871245987546e+17,92,287,3.119565217391304,1,6,92,0
7.651074921911793e+17,21,56,2.6666666666666665,1,5,21,0
7.651457683440028e+17,5,14,2.8,2,4,5,0
7.651533225742848e+17,88,448,5.090909090909091,2,8,87,1
7.652101607537477e+17,15,36,2.4,1,5,15,0
7.652415829280008e+17,46,80,1.7391304347826086,1,4,46,0
7.655519665598947e+17,65,449,6.907692307692308,3,10,46,19
7.656504867909403e+17,82,565,6.890243902439025,2,9,54,28
7.65746085101012e+17,30,65,2.1666666666666665,1,4,30,0
7.657759299240739e+17,22,40,1.8181818181818181,1,4,22,0
7.657795560069129e+17,15,89,5.933333333333334,4,8,13,2
7.658904250359748e+17,106,414,3.9056603773584904,2,6,106,0
7.65921430211104e+17,61,115,1.8852459016393444,1,4,61,0
7.659518948439434e+17,44,434,9.863636363636363,3,12,2,42
7.65953689149998e+17,147,725,4.931972789115647,2,7,147,0
7.659783475364895e+17,40,147,3.675,2,6,40,0
7.659853676177413e+17,22,67,3.0454545454545454,1,5,22,0
7.659930701219148e+17,12,27,2.25,1,4,12,0
7.660492204653068e+17,4,12,3.0,2,4,4,0
7.662947731347423e+17,44,172,3.909090909090909,2,7,44,0
7.663052469564497e+17,22,216,9.818181818181818,5,12,2,20
7.663479209774017e+17,39,90,2.3076923076923075,1,4,39,0
7.663512462011153e+17,1,4,4.0,4,4,1,0
7.663632340082698e+17,174,690,3.9655172413793105,1,6,174,0
7.664161342056609e+17,1,4,4.0,4,4,1,0
7.664428710512018e+17,66,127,1.9242424242424243,1,4,66,0
7.666069295187652e+17,79,690,8.734177215189874,3,12,10,69
7.666203701198452e+17,124,854,6.887096774193548,3,9,84,40
7.66662694842475e+17,51,107,2.0980392156862746,1,4,51,0
7.667326737679735e+17,16,104,6.5,2,9,10,6
7.667356545634936e+17,53,367,6.9245283018867925,5,9,40,13
7.667479334847075e+17,112,763,6.8125,4,9,83,29
7.667630848481158e+17,5,8,1.6,1,3,5,0
7.668621580516e+17,3,8,2.6666666666666665,2,4,3,0
7.670138848495123e+17,82,706,8.609756097560975,2,11,15,67
7.670811908617363e+17,3,24,8.0,7,9,1,2
7.671375829813792e+17,184,554,3.010869565217391,1,6,184,0
7.671617012029043e+17,169,471,2.78698224852071,1,6,169,0
7.671821473826742e+17,3,7,2.3333333333333335,2,3,3,0
7.672035828685988e+17,14,26,1.8571428571428572,1,3,14,0
7.672063115225784e+17,145,1127,7.772413793103448,2,11,51,94
7.672338127077796e+17,70,593,8.471428571428572,2,11,12,58
7.672384634991837e+17,15,48,3.2,1,4,15,0
7.672442278905526e+17,15,76,5.066666666666666,4,7,15,0
7.672648650811767e+17,13,29,2.230769230769231,1,3,13,0
7.672821023835048e+17,132,887,6.71969696969697,2,9,92,40
7.672842256966164e+17,128,272,2.125,1,5,128,0
7.672867455777157e+17,124,260,2.096774193548387,1,4,124,0
7.672898680427494e+17,140,961,6.864285714285714,2,10,100,40
7.673272259135099e+17,72,155,2.1527777777777777,1,4,72,0
7.673272355684087e+17,93,182,1.956989247311828,1,4,93,0
7.673521763908573e+17,12,60,5.0,3,7,12,0
7.673683586122802e+17,52,263,5.0576923076923075,2,7,52,0
7.673952677549192e+17,11,81,7.363636363636363,4,9,5,6
7.674736589416888e+17,92,133,1.4456521739130435,1,3,92,0
7.674783869338761e+17,7,59,8.428571428571429,7,10,1,6
7.678005570570932e+17,9,11,1.2222222222222223,1,2,9,0
7.678014130007526e+17,15,147,9.8,9,11,0,15
7.678078380855565e+17,116,243,2.0948275862068964,1,4,116,0
7.678547225207896e+17,53,263,4.962264150943396,3,8,52,1
7.680315164121084e+17,30,195,6.5,3,9,23,7
7.681342465520685e+17,69,339,4.913043478260869,3,9,68,1
7.682174546918292e+17,40,87,2.175,1,5,40,0
7.684708470127607e+17,56,474,8.464285714285714,2,12,10,46
7.685122921800559e+17,95,648,6.821052631578947,2,9,64,31
7.686336557857846e+17,36,312,8.666666666666666,2,10,6,30
7.686959197671692e+17,10,55,5.5,4,7,10,0
7.687139182188614e+17,62,319,5.145161290322581,2,9,60,2
7.688528517406643e+17,132,263,1.9924242424242424,1,5,132,0
7.68889971303479e+17,12,60,5.0,3,7,12,0
7.689169189519878e+17,54,261,4.833333333333333,2,8,53,1
7.689253180616416e+17,65,312,4.8,2,7,65,0
7.689343380015715e+17,36,190,5.277777777777778,3,8,35,1
7.689433109029119e+17,5,25,5.0,4,6,5,0
7.689540000799356e+17,15,60,4.0,2,5,15,0
7.689812694121848e+17,15,61,4.066666666666666,3,6,15,0
7.689874474435028e+17,18,85,4.722222222222222,2,6,18,0
7.690199229145111e+17,11,53,4.818181818181818,3,7,11,0
7.690295685579064e+17,26,132,5.076923076923077,3,8,25,1
7.690368813759121e+17,3,17,5.666666666666667,5,7,3,0
7.690482505684581e+17,51,198,3.8823529411764706,1,6,51,0
7.692808911886615e+17,7,23,3.2857142857142856,1,4,7,0
7.693717080469373e+17,163,1290,7.914110429447852,2,11,56,107
7.693816694258674e+17,91,638,7.010989010989011,4,9,64,27
7.694143990593984e+17,107,753,7.037383177570093,4,9,73,34
7.694189412465354e+17,58,459,7.913793103448276,5,10,18,40
7.694315315998435e+17,95,760,8.0,4,11,24,71
7.694371746351955e+17,5,13,2.6,1,4,5,0
7.694533764382275e+17,76,153,2.013157894736842,1,4,76,0
7.69467149854745e+17,19,146,7.684210526315789,6,10,8,11
7.694715215852544e+17,13,38,2.923076923076923,2,5,13,0
7.694911964839564e+17,58,289,4.982758620689655,3,8,56,2
7.695113222640634e+17,65,187,2.876923076923077,1,6,65,0
7.695656682230892e+17,15,69,4.6,2,6,15,0
7.699859672438203e+17,51,93,1.8235294117647058,1,5,51,0
7.700680071898141e+17,23,151,6.565217391304348,5,8,21,2
7.700787947773882e+17,71,342,4.816901408450704,2,7,71,0
7.700841338626222e+17,43,316,7.348837209302325,6,9,25,18
7.701903294543656e+17,95,660,6.947368421052632,3,9,67,28
7.703040905464673e+17,28,142,5.071428571428571,3,6,28,0
7.703866415263756e+17,95,475,5.0,2,7,95,0
7.704798070762577e+17,115,586,5.095652173913043,3,8,114,1
7.707042326332564e+17,9,53,5.888888888888889,4,7,9,0
7.70707924261213e+17,3,10,3.3333333333333335,3,4,3,0
7.707176667479e+17,80,529,6.6125,2,9,66,14
7.707277012967607e+17,39,185,4.743589743589744,3,7,39,0
7.707974919725089e+17,9,21,2.3333333333333335,1,4,9,0
7.707997782797311e+17,30,216,7.2,5,10,18,12
7.708047781744485e+17,130,274,2.1076923076923078,1,6,130,0
7.70807856340797e+17,3,3,1.0,1,1,3,0
7.708333912500897e+17,1,5,5.0,5,5,1,0
7.70909052369326e+17,35,75,2.142857142857143,1,4,35,0
7.709317625091004e+17,73,361,4.945205479452055,3,7,73,0
7.709463843110176e+17,47,135,2.872340425531915,1,5,47,0
7.709479701429934e+17,3,8,2.6666666666666665,2,3,3,0
7.710136035096165e+17,1,7,7.0,7,7,1,0
7.710329499734276e+17,18,89,4.944444444444445,3,7,18,0
7.710332933030776e+17,23,75,3.260869565217391,1,6,23,0
7.711258399396568e+17,9,91,10.11111111111111,9,11,0,9
7.711723576615748e+17,29,208,7.172413793103448,5,10,19,10
7.714042179797614e+17,26,55,2.1153846153846154,1,5,26,0
7.714468650529766e+17,43,301,7.0,5,9,31,12
7.714560463101861e+17,30,244,8.133333333333333,6,11,8,22
7.714981837248493e+17,36,189,5.25,2,7,36,0
7.715516262813964e+17,194,1330,6.855670103092783,2,10,139,55
7.716541295038655e+17,64,608,9.5,5,12,4,60
7.71727161479509e+17,41,168,4.097560975609756,2,6,41,0
7.71764457291095e+17,25,82,3.28,1,5,25,0
7.718009458049542e+17,184,1806,9.815217391304348,2,12,6,178
7.72198655106422e+17,101,497,4.920792079207921,2,7,101,0
7.722214970983578e+17,99,964,9.737373737373737,6,13,3,96
7.722267279554094e+17,73,210,2.8767123287671232,1,5,73,0
7.722689792885693e+17,204,1780,8.72549019607843,2,11,23,181
7.722693588413664e+17,11,76,6.909090909090909,5,8,7,4
7.723097171516808e+17,12,86,7.166666666666667,3,10,8,4
7.723284068942002e+17,1,6,6.0,6,6,1,0
7.723354758024485e+17,20,53,2.65,1,4,20,0
7.723752870809253e+17,44,295,6.704545454545454,2,10,32,12
7.724004062036554e+17,32,230,7.1875,4,9,20,12
7.724198059352532e+17,13,28,2.1538461538461537,1,4,13,0
7.72424802798672e+17,65,147,2.2615384615384615,1,4,65,0
7.724315968636497e+17,162,601,3.7098765432098766,2,6,162,0
7.724410107753787e+17,1,3,3.0,3,3,1,0
7.724480797822899e+17,99,957,9.666666666666666,3,12,6,93
7.72486132628191e+17,159,794,4.9937106918239,2,9,156,3
7.724993569987063e+17,35,178,5.085714285714285,2,8,33,2
7.725129387933755e+17,119,814,6.840336134453781,2,9,86,33
7.725429740393833e+17,19,92,4.842105263157895,4,6,19,0
7.725775933899784e+17,17,57,3.3529411764705883,2,5,17,0
7.728757403288449e+17,8,77,9.625,3,12,1,7
7.728862544696919e+17,14,95,6.785714285714286,6,8,12,2
7.728878687987407e+17,62,298,4.806451612903226,2,8,60,2
7.729187847056404e+17,97,462,4.762886597938144,2,8,96,1
7.7293314224424e+17,53,114,2.150943396226415,1,4,53,0
7.729378898878487e+17,23,168,7.304347826086956,2,10,12,11
7.729622871221171e+17,54,160,2.962962962962963,1,6,54,0
7.730179267645989e+17,136,279,2.051470588235294,1,5,136,0
7.730246339474554e+17,10,53,5.3,4,7,10,0
7.730753295381976e+17,39,72,1.8461538461538463,1,3,39,0
7.730802716948465e+17,1,7,7.0,7,7,1,0
7.731207496044902e+17,4,10,2.5,1,4,4,0
7.731778173372097e+17,2,12,6.0,6,6,2,0
7.732553595640279e+17,61,303,4.967213114754099,2,7,61,0
7.733002416525878e+17,40,236,5.9,3,8,38,2
7.736229558832904e+17,20,76,3.8,1,6,20,0
7.73651022710904e+17,16,132,8.25,3,10,2,14
7.736725911837021e+17,1,2,2.0,2,2,1,0
7.73865397408686e+17,32,315,9.84375,7,12,1,31
7.738875384043996e+17,4,15,3.75,3,4,4,0
7.743534366470948e+17,2,3,1.5,1,2,2,0
7.743622468367297e+17,3,3,1.0,1,1,3,0
7.744713663316055e+17,58,574,9.89655172413793,2,12,2,56
7.745332118663212e+17,39,397,10.179487179487179,7,12,1,38
7.745727411504274e+17,14,47,3.357142857142857,1,5,14,0
7.745877751074913e+17,24,53,2.2083333333333335,1,4,24,0
7.745888455887891e+17,16,70,4.375,3,6,16,0
7.747076095595753e+17,39,197,5.051282051282051,2,8,37,2
7.750354115401048e+17,40,307,7.675,2,10,13,27
7.750831176252116e+17,18,41,2.2777777777777777,1,4,18,0
7.751093861212243e+17,20,61,3.05,1,5,20,0
7.751134463936856e+17,35,245,7.0,5,8,23,12
7.751266039861143e+17,65,252,3.876923076923077,1,6,65,0
7.751391274254364e+17,4,10,2.5,2,4,4,0
7.751437421611677e+17,74,726,9.81081081081081,3,13,1,73
7.751438433363084e+17,30,58,1.9333333333333333,1,4,30,0
7.75213805543686e+17,26,215,8.26923076923077,6,10,5,21
7.752437879239974e+17,3,10,3.3333333333333335,3,4,3,0
7.752438135600287e+17,2,8,4.0,4,4,2,0
7.752519072360914e+17,14,18,1.2857142857142858,1,3,14,0
7.752539840447153e+17,24,204,8.5,6,10,3,21
7.752603643034228e+17,1,2,2.0,2,2,1,0
7.752633175903753e+17,1,3,3.0,3,3,1,0
7.752999655256947e+17,70,212,3.0285714285714285,1,6,70,0
7.753323738275214e+17,52,253,4.865384615384615,2,7,52,0
7.753424434775533e+17,247,1694,6.8582995951417,2,9,182,65
7.753717304181555e+17,2,3,1.5,1,2,2,0
7.753840977116225e+17,3,19,6.333333333333333,6,7,3,0
7.754146434039524e+17,5,10,2.0,1,3,5,0
7.754310564561203e+17,28,118,4.214285714285714,2,5,28,0
7.754749044103008e+17,17,72,4.235294117647059,3,5,17,0
7.754954459068535e+17,2,6,3.0,2,4,2,0
7.755458763845974e+17,8,15,1.875,1,3,8,0
7.756432898352545e+17,4,10,2.5,1,3,4,0
7.757623358965514e+17,54,149,2.759259259259259,1,5,54,0
7.757960501881347e+17,18,35,1.9444444444444444,1,4,18,0
7.758304696866593e+17,12,28,2.3333333333333335,1,4,12,0
7.758455623786583e+17,4,11,2.75,2,4,4,0
7.758504901412206e+17,15,75,5.0,3,7,15,0
7.758785428143844e+17,140,1348,9.628571428571428,2,13,11,129
7.759098627969202e+17,5,28,5.6,4,7,5,0
7.7593006563634e+17,10,82,8.2,7,10,3,7
7.759370800676718e+17,6,19,3.1666666666666665,2,5,6,0
7.759465213152677e+17,6,32,5.333333333333333,2,9,5,1
7.75949783659875e+17,5,15,3.0,3,3,5,0
7.759939391912808e+17,130,652,5.015384615384615,2,7,130,0
7.760309416664275e+17,20,100,5.0,3,7,20,0
7.760466530111777e+17,42,381,9.071428571428571,4,12,3,39
7.760554989854813e+17,19,44,2.3157894736842106,1,4,19,0
7.76080082613172e+17,78,520,6.666666666666667,2,9,62,16
7.760950803380023e+17,57,85,1.4912280701754386,1,3,57,0
7.762006565833494e+17,98,296,3.020408163265306,1,6,98,0
7.763571494031072e+17,47,183,3.893617021276596,2,6,47,0
7.765335003662458e+17,43,293,6.813953488372093,3,9,34,9
7.766068256631346e+17,1,5,5.0,5,5,1,0
7.766132212885334e+17,54,386,7.148148148148148,5,9,36,18
7.766155424800486e+17,1,11,11.0,11,11,0,1
7.766571693035788e+17,2,14,7.0,6,8,1,1
7.766712008393942e+17,1,10,10.0,10,10,0,1
7.766758137244498e+17,2,16,8.0,8,8,0,2
7.766898987613541e+17,1,3,3.0,3,3,1,0
7.767166463183332e+17,1,3,3.0,3,3,1,0
7.768209492188367e+17,17,48,2.823529411764706,1,4,17,0
7.768819630980124e+17,50,193,3.86,2,5,50,0
7.772248202937655e+17,2,4,2.0,2,2,2,0
7.772729661632023e+17,9,40,4.444444444444445,3,6,9,0
7.772752855963027e+17,10,24,2.4,1,4,10,0
7.772772962983478e+17,154,1496,9.714285714285714,3,12,8,146
7.772952969989069e+17,88,598,6.795454545454546,2,9,62,26
7.773211949211265e+17,4,29,7.25,7,8,3,1
7.773298426364543e+17,9,30,3.3333333333333335,2,5,9,0
7.774320929195796e+17,114,771,6.7631578947368425,2,9,85,29
7.774888156016517e+17,7,68,9.714285714285714,8,11,0,7
7.776206048120118e+17,160,325,2.03125,1,4,160,0
7.776350991470408e+17,13,37,2.8461538461538463,1,4,13,0
7.779014552900493e+17,7,11,1.5714285714285714,1,3,7,0
7.77901588199992e+17,43,64,1.4883720930232558,1,4,43,0
7.779017241424896e+17,50,65,1.3,1,3,50,0
7.779022481315848e+17,24,32,1.3333333333333333,1,3,24,0
7.779311791670936e+17,20,81,4.05,2,6,20,0
7.779549531741274e+17,19,99,5.2105263157894735,3,7,19,0
7.779585308188609e+17,1,8,8.0,8,8,0,1
7.779737771317005e+17,4,13,3.25,3,4,4,0
7.779767982049856e+17,1,3,3.0,3,3,1,0
7.780345919651524e+17,109,529,4.853211009174312,2,7,109,0
7.780420034302916e+17,41,276,6.7317073170731705,3,10,30,11
7.780431962537586e+17,124,492,3.967741935483871,2,6,124,0
7.781045745553842e+17,143,291,2.034965034965035,1,4,143,0
7.7815135960017e+17,11,96,8.727272727272727,7,11,1,10
7.781948448140229e+17,16,75,4.6875,3,7,16,0
7.782021587403464e+17,123,614,4.991869918699187,2,7,123,0
7.782312892111588e+17,46,437,9.5,2,12,4,42
7.783599610456613e+17,112,349,3.1160714285714284,1,5,112,0
7.783739674595694e+17,130,271,2.0846153846153848,1,4,130,0
7.78379379004943e+17,141,974,6.907801418439717,2,10,96,45
7.784046993903543e+17,330,3152,9.55151515151515,2,13,22,308
7.78647359605254e+17,48,462,9.625,5,12,2,46
7.786839217569185e+17,24,203,8.458333333333334,5,11,5,19
7.787046889534668e+17,9,20,2.2222222222222223,1,4,9,0
7.78719296644098e+17,3,20,6.666666666666667,6,8,2,1
7.787930521164329e+17,82,166,2.024390243902439,1,5,82,0
7.787933647591226e+17,68,139,2.0441176470588234,1,4,68,0
7.787958507177249e+17,23,169,7.3478260869565215,6,10,15,8
7.788050846061513e+17,61,132,2.1639344262295084,1,4,61,0
7.788126544611764e+17,4,25,6.25,3,8,3,1
7.788165542886053e+17,12,34,2.8333333333333335,2,5,12,0
7.789469482912694e+17,101,710,7.02970297029703,3,9,67,34
7.791839333417295e+17,2,3,1.5,1,2,2,0
7.792175991439493e+17,6,44,7.333333333333333,3,11,2,4
7.79408615575356e+17,1,4,4.0,4,4,1,0
7.794589269184289e+17,94,370,3.9361702127659575,2,6,94,0
7.79497053779065e+17,73,97,1.3287671232876712,1,4,73,0
7.79569081442912e+17,139,562,4.043165467625899,1,7,139,0
7.796480303025254e+17,54,471,8.722222222222221,3,11,7,47
7.79807771522311e+17,1,5,5.0,5,5,1,0
7.798289960316422e+17,96,566,5.895833333333333,3,9,90,6
7.798557040016666e+17,5,46,9.2,8,11,0,5
7.801051830323142e+17,1,9,9.0,9,9,0,1
7.801368146200799e+17,25,232,9.28,2,12,3,22
7.801661229223796e+17,1,2,2.0,2,2,1,0
7.801735280147558e+17,10,33,3.3,2,5,10,0
7.801829186154085e+17,33,236,7.151515151515151,3,9,19,14
7.801990856412049e+17,1,3,3.0,3,3,1,0
7.801995147959163e+17,5,8,1.6,1,3,5,0
7.802220478949728e+17,8,15,1.875,1,3,8,0
7.802289991638364e+17,141,276,1.9574468085106382,1,4,141,0
7.802357161405364e+17,38,179,4.7105263157894735,2,7,38,0
7.802428048755931e+17,55,112,2.036363636363636,1,4,55,0
7.802929102962673e+17,75,368,4.906666666666666,2,8,74,1
7.80321164977923e+17,50,68,1.36,1,4,50,0
7.803250200692346e+17,3,7,2.3333333333333335,2,3,3,0
7.803309227549833e+17,32,277,8.65625,2,12,7,25
7.803599888968732e+17,232,1617,6.969827586206897,2,9,160,72
7.803990391360764e+17,38,151,3.973684210526316,1,6,38,0
7.804225502901371e+17,7,17,2.4285714285714284,2,4,7,0
7.804602349877266e+17,39,109,2.7948717948717947,1,4,39,0
7.804945253386856e+17,60,121,2.0166666666666666,1,5,60,0
7.805075944773622e+17,23,154,6.695652173913044,3,9,16,7
7.805257738321443e+17,20,121,6.05,4,7,20,0
7.808713693653741e+17,2,6,3.0,3,3,2,0
7.809353877655763e+17,1,7,7.0,7,7,1,0
7.809622535646921e+17,43,163,3.7906976744186047,1,6,43,0
7.809671176140873e+17,132,285,2.159090909090909,1,5,132,0
7.809742997320668e+17,21,107,5.095238095238095,3,7,21,0
7.809956175204321e+17,135,284,2.1037037037037036,1,6,135,0
7.810036305116346e+17,1,6,6.0,6,6,1,0
7.810436437647922e+17,10,23,2.3,1,4,10,0
7.810594895375084e+17,14,33,2.357142857142857,1,5,14,0
7.810855428852008e+17,19,88,4.631578947368421,3,7,19,0
7.811003222282176e+17,8,16,2.0,1,3,8,0
7.81130895553955e+17,7,22,3.142857142857143,1,5,7,0
7.811366693079538e+17,80,109,1.3625,1,4,80,0
7.81152615810135e+17,34,232,6.823529411764706,4,9,25,9
7.811639353695076e+17,2,5,2.5,2,3,2,0
7.812071496250423e+17,7,15,2.142857142857143,1,4,7,0
7.812071597573734e+17,1,2,2.0,2,2,1,0
7.812995640200426e+17,88,174,1.9772727272727273,1,5,88,0
7.816756034082742e+17,18,124,6.888888888888889,5,9,11,7
7.817292546277135e+17,9,21,2.3333333333333335,1,3,9,0
7.817424470289807e+17,58,395,6.810344827586207,2,10,40,18
7.817693594073601e+17,122,1192,9.770491803278688,2,13,7,115
7.817741346161705e+17,27,189,7.0,5,8,20,7
7.818030300548552e+17,140,695,4.964285714285714,2,7,140,0
7.818208657424778e+17,2,7,3.5,3,4,2,0
7.818443457181819e+17,60,293,4.883333333333334,2,7,60,0
7.819053144908878e+17,120,607,5.058333333333334,3,7,120,0
7.819152479075608e+17,87,576,6.620689655172414,2,9,71,16
7.819545857353428e+17,54,230,4.2592592592592595,2,6,54,0
7.822948529448273e+17,7,52,7.428571428571429,7,8,4,3
7.823337448199534e+17,7,50,7.142857142857143,6,9,5,2
7.823369918638597e+17,34,92,2.7058823529411766,1,5,34,0
7.82355297987992e+17,112,539,4.8125,3,8,111,1
7.82359220495347e+17,81,778,9.604938271604938,3,12,8,73
7.823924141768579e+17,99,478,4.828282828282828,2,7,99,0
7.823930191131293e+17,5,11,2.2,1,3,5,0
7.824025366054308e+17,12,83,6.916666666666667,6,7,12,0
7.824274462663707e+17,21,179,8.523809523809524,5,10,5,16
7.824634664247295e+17,47,142,3.021276595744681,1,5,47,0
7.825654212745486e+17,7,10,1.4285714285714286,1,3,7,0
7.826263712475165e+17,138,956,6.927536231884058,3,10,95,43
7.826275162590473e+17,40,124,3.1,1,6,40,0
7.826630186356888e+17,153,1503,9.823529411764707,3,13,4,149
7.826696613312856e+17,4,8,2.0,1,3,4,0
7.826837303397088e+17,69,534,7.739130434782608,3,11,29,40
7.827060377960581e+17,10,79,7.9,7,9,5,5
7.830341657932116e+17,9,11,1.2222222222222223,1,2,9,0
7.830996048087768e+17,136,383,2.8161764705882355,1,6,136,0
7.831091858259489e+17,19,144,7.578947368421052,2,9,7,12
7.831231910002103e+17,9,62,6.888888888888889,5,9,7,2
7.831921623119078e+17,13,25,1.9230769230769231,1,4,13,0
7.831922499806094e+17,14,33,2.357142857142857,1,5,14,0
7.831924405443053e+17,21,41,1.9523809523809523,1,4,21,0
7.831927809393184e+17,9,21,2.3333333333333335,1,4,9,0
7.831928876899428e+17,6,13,2.1666666666666665,2,3,6,0
7.83192953923579e+17,11,76,6.909090909090909,5,9,8,3
7.831930228519498e+17,15,111,7.4,6,8,7,8
7.831931451922144e+17,26,57,2.1923076923076925,1,4,26,0
7.831933604579694e+17,10,21,2.1,1,3,10,0
7.831933775839132e+17,8,56,7.0,6,8,5,3
7.834084116072049e+17,2,17,8.5,8,9,0,2
7.83483448960282e+17,23,200,8.695652173913043,7,11,2,21
7.83772070613595e+17,159,1542,9.69811320754717,2,12,10,149
7.837946047958552e+17,154,769,4.9935064935064934,2,8,152,2
7.83813337836112e+17,32,187,5.84375,3,8,31,1
7.838147342741823e+17,2,14,7.0,7,7,2,0
7.838802855401345e+17,2,4,2.0,2,2,2,0
7.839377437564338e+17,18,92,5.111111111111111,2,7,18,0
7.840134431498118e+17,122,272,2.2295081967213113,1,5,122,0
7.840468104366208e+17,6,13,2.1666666666666665,1,4,6,0
7.844552063404763e+17,18,142,7.888888888888889,3,9,4,14
7.845284522204297e+17,6,14,2.3333333333333335,1,4,6,0
7.845596593779789e+17,57,386,6.771929824561403,5,9,44,13
7.845749291124863e+17,35,68,1.9428571428571428,1,3,35,0
7.846999698442355e+17,18,163,9.055555555555555,3,11,3,15
7.847243092219503e+17,41,61,1.4878048780487805,1,3,41,0
7.848184186423619e+17,33,67,2.0303030303030303,1,4,33,0
7.848610526422996e+17,81,713,8.802469135802468,2,12,7,74
7.848628560287114e+17,86,427,4.965116279069767,2,7,86,0
7.852294219442564e+17,14,95,6.785714285714286,5,8,9,5
7.852853907926724e+17,8,15,1.875,1,3,8,0
7.852976493385555e+17,69,661,9.579710144927537,2,12,4,65
7.853012878834717e+17,52,268,5.153846153846154,2,7,52,0
7.853105541203324e+17,61,297,4.868852459016393,2,7,61,0
7.853114247122908e+17,31,243,7.838709677419355,7,10,10,21
7.853148025194627e+17,10,96,9.6,8,13,0,10
7.853305947738271e+17,9,19,2.111111111111111,1,4,9,0
7.853630829656956e+17,13,92,7.076923076923077,5,9,8,5
7.854254905123913e+17,108,811,7.5092592592592595,2,10,43,65
7.85434040881501e+17,42,197,4.690476190476191,2,7,42,0
7.854525573922472e+17,107,216,2.0186915887850465,1,5,107,0
7.854769469252872e+17,14,97,6.928571428571429,3,10,10,4
7.855005555076758e+17,29,65,2.2413793103448274,1,5,29,0
7.855047574391182e+17,115,330,2.869565217391304,1,7,115,0
7.855107226463483e+17,152,304,2.0,1,4,152,0
7.855127904131167e+17,38,193,5.078947368421052,3,8,37,1
7.85548260498956e+17,22,147,6.681818181818182,4,8,18,4
7.855489090450513e+17,34,279,8.205882352941176,4,11,7,27
7.855515160925289e+17,15,33,2.2,1,3,15,0
7.855577875915805e+17,28,268,9.571428571428571,5,12,3,25
7.859564604521216e+17,63,185,2.9365079365079363,1,6,63,0
7.860198053635126e+17,5,16,3.2,2,5,5,0
7.860548308575078e+17,42,126,3.0,1,5,42,0
7.860932105808128e+17,35,236,6.742857142857143,5,9,27,8
7.861031758858666e+17,45,422,9.377777777777778,4,12,4,41
7.861048514126124e+17,34,66,1.9411764705882353,1,4,34,0
7.86106514047119e+17,152,1034,6.802631578947368,2,10,109,43
7.861442113439209e+17,8,42,5.25,3,8,7,1
7.861857174933271e+17,69,206,2.9855072463768115,1,5,69,0
7.862324057366374e+17,97,200,2.0618556701030926,1,4,97,0
7.862719083566447e+17,83,157,1.891566265060241,1,5,83,0
7.862859699349152e+17,74,732,9.891891891891891,3,13,6,68
7.866783964301496e+17,3,21,7.0,6,8,2,1
7.866939413669999e+17,72,158,2.1944444444444446,1,5,72,0
7.867007368275913e+17,94,475,5.053191489361702,2,8,93,1
7.867858823124951e+17,92,922,10.021739130434783,6,12,1,91
7.86791465599982e+17,74,711,9.608108108108109,2,12,5,69
7.86844914869152e+17,90,452,5.022222222222222,2,8,89,1
7.868611835164314e+17,30,256,8.533333333333333,6,10,5,25
7.868622184254538e+17,88,349,3.965909090909091,1,6,88,0
7.868958128663558e+17,23,157,6.826086956521739,2,9,16,7
7.869145156999296e+17,10,79,7.9,6,10,2,8
7.870821596748664e+17,147,1012,6.884353741496598,2,10,103,44
7.871908865178392e+17,132,771,5.840909090909091,2,8,128,4
7.874980514344767e+17,5,20,4.0,3,5,5,0
7.875059982603444e+17,5,33,6.6,6,8,4,1
7.875264721947191e+17,70,339,4.8428571428571425,2,7,70,0
7.87539563149734e+17,139,961,6.913669064748201,3,10,101,38
7.875629284717723e+17,143,292,2.041958041958042,1,5,143,0
7.875730764887437e+17,114,237,2.0789473684210527,1,5,114,0
7.875805960617742e+17,4,9,2.25,1,3,4,0
7.875956650851727e+17,123,1068,8.682926829268293,2,11,21,102
7.876093310633508e+17,9,90,10.0,8,12,0,9
7.87638571871355e+17,100,380,3.8,1,7,100,0
7.876840679528051e+17,154,1486,9.64935064935065,2,13,11,143
7.880587390691498e+17,6,20,3.3333333333333335,2,5,6,0
7.88061048361278e+17,6,17,2.8333333333333335,2,4,6,0
7.880891953729974e+17,5,7,1.4,1,2,5,0
7.881688211226753e+17,7,22,3.142857142857143,2,4,7,0
7.881813772057185e+17,125,850,6.8,2,9,86,39
7.882385698298437e+17,9,67,7.444444444444445,5,9,4,5
7.882989204117989e+17,17,22,1.2941176470588236,1,2,17,0
7.883227537073144e+17,56,392,7.0,4,10,38,18
7.884405268431503e+17,38,189,4.973684210526316,3,7,38,0
7.88819641680571e+17,15,39,2.6,1,6,15,0
7.888812314174295e+17,38,88,2.3157894736842106,1,4,38,0
7.889561197374291e+17,136,1193,8.772058823529411,2,12,16,120
7.890423065059267e+17,28,252,9.0,5,11,1,27
7.891030620804052e+17,92,740,8.043478260869565,5,11,27,65
7.896191945121482e+17,2,4,2.0,2,2,2,0
7.897019507350098e+17,6,59,9.833333333333334,9,12,0,6
7.897586822246643e+17,50,197,3.94,2,6,50,0
7.89872961656095e+17,50,62,1.24,1,3,50,0
7.898765916648521e+17,59,129,2.1864406779661016,1,4,59,0
7.898770589460648e+17,54,327,6.055555555555555,3,9,46,8
7.906055543576009e+17,24,222,9.25,4,12,3,21
7.910228112421372e+17,4,29,7.25,6,8,2,2
7.910463647189307e+17,78,367,4.705128205128205,2,8,77,1
7.910474066482164e+17,5,41,8.2,7,9,1,4
7.910475475315892e+17,20,44,2.2,1,4,20,0
7.910476374858152e+17,24,59,2.4583333333333335,1,4,24,0
7.910585306599721e+17,68,139,2.0441176470588234,1,4,68,0
7.911151471937394e+17,34,82,2.411764705882353,1,4,34,0
7.911593697672374e+17,14,51,3.642857142857143,2,7,14,0
7.911621354495043e+17,6,32,5.333333333333333,4,7,6,0
7.911734335994382e+17,4,9,2.25,1,3,4,0
7.911736018328927e+17,3,7,2.3333333333333335,2,3,3,0
7.911738643790651e+17,6,17,2.8333333333333335,2,4,6,0
7.911738687114301e+17,48,234,4.875,3,8,47,1
7.911826288481705e+17,35,342,9.771428571428572,6,12,1,34
7.9122932107934e+17,4,16,4.0,3,6,4,0
7.912295955597132e+17,14,27,1.9285714285714286,1,4,14,0
7.912298080617725e+17,3,9,3.0,3,3,3,0
7.912300826958241e+17,7,17,2.4285714285714284,1,3,7,0
7.912302825773902e+17,6,14,2.3333333333333335,1,3,6,0
7.912745312481677e+17,20,48,2.4,1,4,20,0
7.912872000037239e+17,1,3,3.0,3,3,1,0
7.913700546333244e+17,123,600,4.878048780487805,2,7,123,0
7.913878237520902e+17,102,688,6.745098039215686,4,9,75,27
7.916547124139098e+17,6,13,2.1666666666666665,1,3,6,0
7.917265033677951e+17,27,183,6.777777777777778,5,9,23,4
7.917437075785811e+17,30,149,4.966666666666667,2,7,30,0
7.917764581206236e+17,135,645,4.777777777777778,2,7,135,0
7.917930650356241e+17,19,128,6.7368421052631575,4,9,16,3
7.918416062885978e+17,62,299,4.82258064516129,1,7,62,0
7.918636938841224e+17,61,124,2.0327868852459017,1,5,61,0
7.918684737073889e+17,5,41,8.2,7,10,1,4
7.918984377572141e+17,60,405,6.75,2,10,45,15
7.919058733610701e+17,32,305,9.53125,7,12,1,31
7.919122154836822e+17,73,224,3.0684931506849313,1,6,73,0
7.919427408913393e+17,4,13,3.25,3,4,4,0
7.919460495120968e+17,27,29,1.0740740740740742,1,2,27,0
7.919643880737e+17,12,87,7.25,6,9,7,5
7.92005594301874e+17,11,99,9.0,2,11,2,9
7.92102604867165e+17,22,29,1.3181818181818181,1,4,22,0
7.924725501899795e+17,64,325,5.078125,3,7,64,0
7.92487083457178e+17,2,5,2.5,2,3,2,0
7.924944957606426e+17,17,40,2.3529411764705883,1,4,17,0
7.924976972739354e+17,2,4,2.0,2,2,2,0
7.925042914842889e+17,2,4,2.0,1,3,2,0
7.925668634058367e+17,82,178,2.1707317073170733,1,4,82,0
7.925754443037833e+17,3,4,1.3333333333333333,1,2,3,0
7.92576187177994e+17,37,249,6.72972972972973,2,10,27,10
7.926016541721708e+17,6,7,1.1666666666666667,1,2,6,0
7.926963429375707e+17,1,3,3.0,3,3,1,0
7.927027085333729e+17,11,32,2.909090909090909,2,4,11,0
7.927213667522092e+17,180,1739,9.661111111111111,2,12,11,169
7.927486099737751e+17,2,17,8.5,8,9,0,2
7.927489620510244e+17,8,61,7.625,6,9,2,6
7.928159767497551e+17,107,305,2.850467289719626,1,6,107,0
7.9284077073465e+17,57,230,4.035087719298246,2,6,57,0
7.928692719715551e+17,59,307,5.203389830508475,3,8,57,2
7.932339586956589e+17,14,24,1.7142857142857142,1,4,14,0
7.932491976162725e+17,9,64,7.111111111111111,2,9,3,6
7.932970140687702e+17,10,48,4.8,3,6,10,0
7.934125052716678e+17,98,475,4.846938775510204,2,8,97,1
7.935747573948995e+17,49,428,8.73469387755102,3,10,2,47
7.936460208826221e+17,40,191,4.775,1,7,40,0
7.94020510514705e+17,88,431,4.8977272727272725,2,7,88,0
7.940345862155539e+17,110,234,2.1272727272727274,1,4,110,0
7.940753968619269e+17,1,8,8.0,8,8,0,1
7.94134106232494e+17,8,34,4.25,3,5,8,0
7.949084495276003e+17,20,164,8.2,5,11,4,16
7.950284400679945e+17,58,232,4.0,2,7,58,0
7.95355958374161e+17,38,332,8.736842105263158,3,11,7,31
7.953575314108919e+17,47,238,5.0638297872340425,2,7,47,0
7.954056937506066e+17,232,327,1.4094827586206897,1,4,232,0
7.954207338676472e+17,68,467,6.867647058823529,5,10,49,19
7.954283356972174e+17,87,433,4.977011494252873,2,7,87,0
7.954283436265376e+17,74,367,4.95945945945946,2,8,73,1
7.954285937945331e+17,47,237,5.042553191489362,2,7,47,0
7.954954737001418e+17,41,196,4.780487804878049,3,6,41,0
7.95597908303172e+17,73,569,7.794520547945205,2,11,24,49
7.956265927544564e+17,30,67,2.2333333333333334,1,5,30,0
7.956862372341313e+17,3,9,3.0,2,4,3,0
7.956925599502136e+17,130,663,5.1,3,7,130,0
7.95693613615535e+17,5,30,6.0,5,7,5,0
7.957447827430911e+17,1,3,3.0,3,3,1,0
7.957563272646706e+17,44,88,2.0,1,4,44,0
7.961020961199437e+17,4,11,2.75,2,3,4,0
7.961326128663292e+17,3,9,3.0,2,4,3,0
7.961484876121329e+17,2,6,3.0,2,4,2,0
7.961505914823633e+17,1,6,6.0,6,6,1,0
7.962132768498898e+17,13,14,1.0769230769230769,1,2,13,0
7.963218154399401e+17,7,26,3.7142857142857144,2,6,7,0
7.963529788202168e+17,42,89,2.119047619047619,1,4,42,0
7.96477728193237e+17,84,731,8.702380952380953,5,11,9,75
7.965218596265171e+17,106,946,8.924528301886792,4,12,9,97
7.967666252107968e+17,15,105,7.0,5,9,11,4
7.968227541105677e+17,1,3,3.0,3,3,1,0
7.969033683230692e+17,1,1,1.0,1,1,1,0
7.96995794408381e+17,2,4,2.0,1,3,2,0
7.970892119606765e+17,23,108,4.695652173913044,2,7,23,0
7.973806312180838e+17,5,16,3.2,2,4,5,0
7.974937104822257e+17,3,6,2.0,1,3,3,0
7.975450768692223e+17,125,168,1.344,1,4,125,0
7.975495458736908e+17,6,12,2.0,1,3,6,0
7.975555530454341e+17,55,206,3.7454545454545456,2,6,55,0
7.975654923687873e+17,4,10,2.5,1,4,4,0
7.976210595262157e+17,28,171,6.107142857142857,3,9,25,3
7.976686036947398e+17,45,224,4.977777777777778,3,7,45,0
7.97689588847445e+17,7,54,7.714285714285714,6,9,3,4
7.977525017700553e+17,61,186,3.0491803278688523,1,5,61,0
7.977694997267496e+17,6,45,7.5,7,8,3,3
7.979259480894711e+17,79,230,2.911392405063291,1,5,79,0
7.979563728073096e+17,1,8,8.0,8,8,0,1
7.98209627776764e+17,156,324,2.076923076923077,1,4,156,0
7.983225687130202e+17,14,48,3.4285714285714284,2,5,14,0
7.98400470014739e+17,7,66,9.428571428571429,7,11,1,6
7.984395709302191e+17,71,211,2.971830985915493,1,6,71,0
7.985166528117064e+17,5,20,4.0,3,5,5,0
7.985451121907732e+17,50,246,4.92,3,7,50,0
7.98550076065301e+17,5,42,8.4,8,10,0,5
7.985823528910282e+17,7,21,3.0,2,5,7,0
7.990184013281573e+17,6,39,6.5,5,8,5,1
7.990190952220809e+17,1,7,7.0,7,7,1,0
7.990962523258986e+17,44,94,2.1363636363636362,1,5,44,0
7.991053354639177e+17,4,34,8.5,8,10,0,4
7.991517992964727e+17,12,53,4.416666666666667,2,6,12,0
7.991989151403227e+17,29,96,3.310344827586207,2,5,29,0
7.992354205766502e+17,17,21,1.2352941176470589,1,3,17,0
7.994863835706643e+17,15,27,1.8,1,3,15,0
7.995077117988525e+17,34,194,5.705882352941177,4,7,34,0
7.997411618501674e+17,15,76,5.066666666666666,3,7,15,0
7.997530726859078e+17,91,646,7.0989010989010985,5,9,63,28
7.997597748090135e+17,2,6,3.0,2,4,2,0
7.997673119183286e+17,93,626,6.731182795698925,2,9,68,25
7.997723618042356e+17,88,602,6.840909090909091,3,9,64,24
7.997840602851665e+17,143,435,3.041958041958042,1,5,143,0
7.997857881425608e+17,23,225,9.782608695652174,5,12,2,21
7.99785835819908e+17,184,1618,8.793478260869565,2,11,19,165
7.997953359956061e+17,4,8,2.0,1,3,4,0
7.998116327935776e+17,70,284,4.057142857142857,2,7,70,0
7.998693366434614e+17,170,1510,8.882352941176471,2,12,18,152
7.999096702556082e+17,182,1739,9.554945054945055,2,13,11,171
8.000110230105875e+17,172,1184,6.883720930232558,2,10,127,45
8.000971079155273e+17,38,55,1.4473684210526316,1,3,38,0
8.005206977454628e+17,121,596,4.925619834710743,2,7,121,0
8.005458471489793e+17,12,105,8.75,7,10,1,11
8.005678784857221e+17,1,4,4.0,4,4,1,0
8.006370188184009e+17,107,419,3.9158878504672896,2,6,107,0
8.006665128174927e+17,108,534,4.944444444444445,2,9,107,1
8.006761626904694e+17,1,2,2.0,2,2,1,0
8.00689763542791e+17,16,141,8.8125,7,11,1,15
8.010854092316389e+17,45,92,2.0444444444444443,1,3,45,0
8.011236680188599e+17,3,8,2.6666666666666665,2,3,3,0
8.011240995542728e+17,1,3,3.0,3,3,1,0
8.011678259208108e+17,54,224,4.148148148148148,2,7,54,0
8.011684182266186e+17,21,48,2.2857142857142856,1,4,21,0
8.011689474312618e+17,1,4,4.0,4,4,1,0
8.012635392658826e+17,1,2,2.0,2,2,1,0
8.012647131717011e+17,47,101,2.148936170212766,1,5,47,0
8.013518066049964e+17,38,145,3.8157894736842106,2,6,38,0
8.01375660545728e+17,17,35,2.0588235294117645,1,4,17,0
8.01390337483597e+17,15,46,3.066666666666667,1,4,15,0
8.013936446958929e+17,69,349,5.057971014492754,3,7,69,0
8.014014513527144e+17,1,9,9.0,9,9,0,1
8.015168454319956e+17,2,10,5.0,5,5,2,0
8.015354162373652e+17,18,34,1.8888888888888888,1,4,18,0
8.017794355850404e+17,72,615,8.541666666666666,2,11,11,61
8.018080080825912e+17,33,328,9.93939393939394,8,12,0,33
8.019388642462319e+17,101,688,6.811881188118812,2,10,70,31
8.019521137047286e+17,105,725,6.904761904761905,3,9,76,29
8.019980976337162e+17,8,25,3.125,1,4,8,0
8.020867130987656e+17,30,125,4.166666666666667,3,6,30,0
8.020892784847144e+17,39,144,3.6923076923076925,2,6,39,0
8.02102955876825e+17,8,54,6.75,5,9,6,2
8.021590083557577e+17,1,4,4.0,4,4,1,0
8.021590992619168e+17,47,231,4.914893617021277,3,7,47,0
8.02199106441401e+17,43,385,8.953488372093023,2,11,4,39
8.02201748513216e+17,2,5,2.5,2,3,2,0
8.022036960559694e+17,109,973,8.926605504587156,4,13,9,100
8.022163530659336e+17,138,1184,8.579710144927537,2,12,26,112
8.022419103233609e+17,7,53,7.571428571428571,6,9,3,4
8.022997969835843e+17,114,239,2.0964912280701755,1,4,114,0
8.02620968126266e+17,11,47,4.2727272727272725,3,6,11,0
8.02636751888321e+17,34,235,6.911764705882353,5,9,25,9
8.027074601362417e+17,118,598,5.067796610169491,2,7,118,0
8.02755307276746e+17,38,364,9.578947368421053,2,12,1,37
8.02825010299759e+17,5,13,2.6,2,4,5,0
8.028944960447328e+17,1,9,9.0,9,9,0,1
8.029141862747402e+17,140,1360,9.714285714285714,4,13,8,132
8.029229207199597e+17,73,687,9.41095890410959,2,12,4,69
8.033445337562513e+17,13,104,8.0,6,10,4,9
8.033631408242651e+17,74,213,2.8783783783783785,1,5,74,0
8.03380875580433e+17,29,196,6.758620689655173,3,8,23,6
8.033932006784486e+17,126,1106,8.777777777777779,2,11,13,113
8.033960357937816e+17,8,61,7.625,7,9,4,4
8.034126275407444e+17,32,210,6.5625,2,8,26,6
8.03413826031844e+17,30,56,1.8666666666666667,1,4,30,0
8.034200856049164e+17,71,141,1.9859154929577465,1,4,71,0
8.03432398616897e+17,25,183,7.32,2,10,12,13
8.034993915125187e+17,75,517,6.8933333333333335,3,9,56,19
8.034996426941668e+17,60,425,7.083333333333333,4,10,42,18
8.034999618938077e+17,175,225,1.2857142857142858,1,3,175,0
8.035438047980147e+17,29,220,7.586206896551724,4,9,14,15
8.035483442663014e+17,156,1511,9.685897435897436,2,13,9,147
8.036238734965859e+17,3,7,2.3333333333333335,1,3,3,0
8.040271257026798e+17,43,291,6.767441860465116,2,9,31,12
8.040987791689124e+17,39,269,6.897435897435898,2,10,28,11
8.042375899481857e+17,17,41,2.411764705882353,1,4,17,0
8.042482529168778e+17,78,390,5.0,3,8,76,2
8.043237448206445e+17,8,74,9.25,6,11,2,6
8.044974673271456e+17,9,58,6.444444444444445,2,9,5,4
8.047613933912673e+17,126,634,5.031746031746032,2,7,126,0
8.048061617425745e+17,110,421,3.827272727272727,1,6,110,0
8.04873412694718e+17,3,12,4.0,3,5,3,0
8.049572965916413e+17,44,218,4.954545454545454,1,7,44,0
8.050437203673765e+17,99,495,5.0,2,7,99,0
8.051447747995142e+17,61,291,4.770491803278689,3,8,60,1
8.051581133126056e+17,51,489,9.588235294117647,5,13,3,48
8.051677347907855e+17,27,256,9.481481481481481,4,12,2,25
8.05205631401512e+17,4,31,7.75,7,8,1,3
8.054411065928863e+17,116,590,5.086206896551724,3,8,114,2
8.055027281282596e+17,13,20,1.5384615384615385,1,3,13,0
8.05530559813075e+17,53,502,9.471698113207546,3,12,3,50
8.055349277591638e+17,118,584,4.9491525423728815,2,8,117,1
8.055447850253437e+17,22,43,1.9545454545454546,1,4,22,0
8.05568178774236e+17,3,8,2.6666666666666665,1,4,3,0
8.055705545949851e+17,12,100,8.333333333333334,6,11,2,10
8.055867165737674e+17,34,226,6.647058823529412,4,9,27,7
8.056220688536146e+17,10,67,6.7,5,8,7,3
8.056307964132329e+17,1,1,1.0,1,1,1,0
8.056840789065106e+17,133,268,2.0150375939849625,1,4,133,0
8.057029406676847e+17,6,52,8.666666666666666,8,10,0,6
8.057076807018373e+17,13,50,3.8461538461538463,2,7,13,0
8.057203944677516e+17,81,390,4.814814814814815,2,8,80,1
8.057473247290949e+17,16,39,2.4375,1,5,16,0
8.057486643428443e+17,3,16,5.333333333333333,5,6,3,0
8.057511781075098e+17,3,11,3.6666666666666665,3,4,3,0
8.058010906429032e+17,5,26,5.2,5,6,5,0
8.058370654213477e+17,1,3,3.0,3,3,1,0
8.059033061338835e+17,1,1,1.0,1,1,1,0
8.059154232091926e+17,33,171,5.181818181818182,3,7,33,0
8.061904186620762e+17,1,4,4.0,4,4,1,0
8.062722851986797e+17,23,119,5.173913043478261,4,7,23,0
8.062755454169417e+17,80,550,6.875,2,9,56,24
8.063083448356468e+17,29,250,8.620689655172415,3,11,5,24
8.06341613515696e+17,44,376,8.545454545454545,2,11,8,36
8.063545313979008e+17,3,24,8.0,7,9,1,2
8.063582415180588e+17,54,104,1.9259259259259258,1,4,54,0
8.063583406021652e+17,12,79,6.583333333333333,5,8,9,3
8.063585214326874e+17,47,92,1.9574468085106382,1,4,47,0
8.063791868939044e+17,92,451,4.9021739130434785,2,7,92,0
8.064631813461304e+17,59,392,6.6440677966101696,4,9,47,12
8.064746118300832e+17,4,31,7.75,6,9,1,3
8.064857451057687e+17,6,40,6.666666666666667,5,8,4,2
8.065056954327517e+17,141,287,2.0354609929078014,1,5,141,0
8.065398780974765e+17,97,197,2.0309278350515463,1,4,97,0
8.065621061801903e+17,122,940,7.704918032786885,2,10,49,73
8.066036682393761e+17,144,991,6.881944444444445,2,9,102,42
8.066231225005798e+17,65,621,9.553846153846154,2,12,5,60
8.066728784463228e+17,20,179,8.95,8,10,0,20
8.067517921748445e+17,158,1068,6.7594936708860756,2,9,115,43
8.069566191529245e+17,54,118,2.185185185185185,1,5,54,0
8.070057304644462e+17,35,241,6.885714285714286,5,9,28,7
8.070217458600997e+17,10,17,1.7,1,4,10,0
8.070468451679945e+17,14,33,2.357142857142857,1,4,14,0
8.070483132830692e+17,4,5,1.25,1,2,4,0
8.070513247750948e+17,55,308,5.6,2,9,50,5
8.070542286099546e+17,68,134,1.9705882352941178,1,4,68,0
8.070960857000796e+17,4,30,7.5,5,9,1,3
8.071445109923009e+17,139,203,1.460431654676259,1,4,139,0
8.071599288046161e+17,151,202,1.3377483443708609,1,3,151,0
8.07159935522713e+17,165,222,1.3454545454545455,1,3,165,0
8.071599429584878e+17,167,249,1.4910179640718564,1,4,167,0
8.071715938687994e+17,145,985,6.793103448275862,2,10,111,34
8.07344314722417e+17,3,16,5.333333333333333,5,6,3,0
8.076770958979821e+17,48,105,2.1875,1,5,48,0
8.077016054106097e+17,65,314,4.8307692307692305,2,7,65,0
8.077345261160652e+17,25,96,3.84,2,7,25,0
8.078396702095799e+17,21,40,1.9047619047619047,1,3,21,0
8.078489896018298e+17,21,140,6.666666666666667,3,8,17,4
8.078519025932675e+17,11,24,2.1818181818181817,1,3,11,0
8.078616926647788e+17,32,216,6.75,4,8,25,7
8.078660755269928e+17,150,322,2.1466666666666665,1,5,150,0
8.078736343634301e+17,5,8,1.6,1,2,5,0
8.079044588642767e+17,25,237,9.48,4,11,3,22
8.079162187279603e+17,67,330,4.925373134328358,2,7,67,0
8.079385458329448e+17,31,216,6.967741935483871,5,9,21,10
8.08001856523574e+17,7,53,7.571428571428571,6,9,3,4
8.080200368728713e+17,6,19,3.1666666666666665,2,4,6,0
8.083511771685247e+17,53,270,5.09433962264151,3,8,52,1
8.08408690380075e+17,21,73,3.4761904761904763,2,5,21,0
8.084162686648559e+17,23,218,9.478260869565217,3,12,2,21
8.084637334487635e+17,115,562,4.886956521739131,2,7,115,0
8.08487922827634e+17,106,542,5.113207547169812,2,8,104,2
8.08497176786304e+17,124,625,5.040322580645161,2,8,122,2
8.085207168628641e+17,17,76,4.470588235294118,2,6,17,0
8.087623057190127e+17,26,135,5.1923076923076925,3,8,25,1
8.091290302252014e+17,112,978,8.732142857142858,3,11,17,95
8.09168687956482e+17,20,41,2.05,1,5,20,0
8.091777812239626e+17,81,397,4.901234567901234,2,7,81,0
8.092134089356575e+17,48,94,1.9583333333333333,1,4,48,0
8.092900256262586e+17,127,632,4.9763779527559056,2,7,127,0
8.092998218253641e+17,166,1598,9.626506024096386,2,12,13,153
8.09410757379151e+17,27,53,1.962962962962963,1,4,27,0
8.098001524569778e+17,58,228,3.9310344827586206,1,6,58,0
8.10032474315874e+17,12,35,2.9166666666666665,2,4,12,0
8.100440319245709e+17,50,72,1.44,1,3,50,0
8.100805798520494e+17,31,157,5.064516129032258,3,7,31,0
8.10097459766237e+17,2,8,4.0,4,4,2,0
8.101183547121473e+17,56,571,10.196428571428571,7,12,1,55
8.101539412847704e+17,93,457,4.913978494623656,2,8,91,2
8.101601352663964e+17,5,7,1.4,1,3,5,0
8.102206034312198e+17,1,6,6.0,6,6,1,0
8.103193056195635e+17,8,30,3.75,2,5,8,0
8.105146929142508e+17,119,1052,8.840336134453782,3,12,12,107
8.106087209015738e+17,17,54,3.176470588235294,2,5,17,0
8.106120732061128e+17,1,1,1.0,1,1,1,0
8.106121215610401e+17,2,4,2.0,1,3,2,0
8.10640535925346e+17,3,8,2.6666666666666665,2,3,3,0
8.106451998882856e+17,86,340,3.953488372093023,1,6,86,0
8.106725931380337e+17,23,165,7.173913043478261,5,9,12,11
8.106914446980507e+17,2,20,10.0,9,11,0,2
8.107363039160352e+17,1,6,6.0,6,6,1,0
8.107457198599619e+17,10,29,2.9,2,5,10,0
8.107460838212268e+17,1,3,3.0,3,3,1,0
8.107579658552013e+17,16,43,2.6875,1,4,16,0
8.107827801253059e+17,13,23,1.7692307692307692,1,3,13,0
8.108023168318158e+17,11,19,1.7272727272727273,1,3,11,0
8.108104028168854e+17,58,123,2.1206896551724137,1,5,58,0
8.108108364864118e+17,73,362,4.958904109589041,2,8,72,1
8.108121158311012e+17,8,16,2.0,1,3,8,0
8.108330195464425e+17,63,119,1.8888888888888888,1,4,63,0
8.109146407034e+17,11,90,8.181818181818182,7,9,2,9
8.112968552743283e+17,1,2,2.0,2,2,1,0
8.113354686627645e+17,13,23,1.7692307692307692,1,3,13,0
8.11337524070405e+17,14,97,6.928571428571429,4,9,10,4
8.113580507935569e+17,13,26,2.0,1,4,13,0
8.113829963134307e+17,55,221,4.0181818181818185,2,7,55,0
8.114313631232497e+17,16,151,9.4375,3,12,1,15
8.114374778469907e+17,1,11,11.0,11,11,0,1
8.114485010682408e+17,2,22,11.0,10,12,0,2
8.114978196113944e+17,121,574,4.743801652892562,2,7,121,0
8.11508274547538e+17,84,410,4.880952380952381,3,7,84,0
8.115150775995593e+17,76,152,2.0,1,5,76,0
8.115226266974295e+17,131,663,5.061068702290076,2,8,129,2
8.115273876198419e+17,101,502,4.97029702970297,2,8,100,1
8.115292958806481e+17,91,453,4.978021978021978,2,7,91,0
8.115944438875786e+17,14,88,6.285714285714286,2,8,11,3
8.116027193138047e+17,27,100,3.7037037037037037,2,6,27,0
8.116328531796145e+17,15,86,5.733333333333333,4,8,14,1
8.116794165380572e+17,18,121,6.722222222222222,6,8,15,3
8.116842470765142e+17,94,925,9.840425531914894,4,12,1,93
8.116964986191214e+17,207,821,3.966183574879227,2,6,207,0
8.117106685674125e+17,7,40,5.714285714285714,4,7,7,0
8.117301730261121e+17,15,100,6.666666666666667,2,9,11,4
8.117472395637105e+17,3,4,1.3333333333333333,1,2,3,0
8.119677700897313e+17,6,54,9.0,8,10,0,6
8.120311359804038e+17,5,11,2.2,1,3,5,0
8.120847990917036e+17,7,18,2.5714285714285716,1,5,7,0
8.121219812096239e+17,24,164,6.833333333333333,3,9,17,7
8.121819333249582e+17,13,29,2.230769230769231,1,4,13,0
8.121962914362678e+17,48,233,4.854166666666667,3,7,48,0
8.12226520348246e+17,169,369,2.1834319526627217,1,5,169,0
8.122305435744273e+17,137,284,2.072992700729927,1,5,137,0
8.122328537586335e+17,114,333,2.9210526315789473,1,6,114,0
8.1223431162503e+17,119,128,1.0756302521008403,1,3,119,0
8.122448552884897e+17,3,11,3.6666666666666665,3,5,3,0
8.122477551366664e+17,71,350,4.929577464788732,2,7,71,0
8.122777778762764e+17,44,78,1.7727272727272727,1,5,44,0
8.122885781637453e+17,36,184,5.111111111111111,2,7,36,0
8.122952329917641e+17,1,1,1.0,1,1,1,0
8.123184359426748e+17,120,248,2.066666666666667,1,5,120,0
8.124001626202045e+17,25,77,3.08,2,5,25,0
8.128740767106847e+17,47,93,1.9787234042553192,1,4,47,0
8.128872509184321e+17,208,1827,8.783653846153847,4,11,22,186
8.129244494416628e+17,52,414,7.961538461538462,5,10,14,38
8.129365363970586e+17,7,11,1.5714285714285714,1,3,7,0
8.129460864380964e+17,112,1042,9.303571428571429,2,14,13,99
8.129627788079021e+17,58,394,6.793103448275862,2,9,41,17
8.130550752856184e+17,21,168,8.0,6,10,6,15
8.130706378423169e+17,96,290,3.0208333333333335,1,6,96,0
8.131245514504447e+17,6,25,4.166666666666667,3,5,6,0
8.131742066469208e+17,34,46,1.3529411764705883,1,3,34,0
8.13496250686063e+17,3,10,3.3333333333333335,3,4,3,0
8.135094320291183e+17,2,8,4.0,4,4,2,0
8.135305681183725e+17,5,29,5.8,4,7,5,0
8.13563380285651e+17,6,7,1.1666666666666667,1,2,6,0
8.135833322950569e+17,43,378,8.790697674418604,4,11,5,38
8.13613829259975e+17,49,345,7.040816326530612,5,9,33,16
8.136180251472581e+17,6,31,5.166666666666667,5,6,6,0
8.136460302518318e+17,81,799,9.864197530864198,4,13,5,76
8.136620876648422e+17,119,1149,9.655462184873949,3,13,6,113
8.137397541109494e+17,24,213,8.875,4,11,1,23
8.138126951149514e+17,6,13,2.1666666666666665,1,3,6,0
8.143128559584073e+17,8,56,7.0,5,8,5,3
8.14366853683681e+17,57,553,9.701754385964913,2,12,3,54
8.14434648311602e+17,124,606,4.887096774193548,3,7,124,0
8.145565792143665e+17,51,116,2.2745098039215685,1,4,51,0
8.145902107854289e+17,101,594,5.881188118811881,2,9,93,8
8.146021182792498e+17,33,273,8.272727272727273,3,11,6,27
8.149130890667739e+17,5,23,4.6,4,5,5,0
8.150076839803186e+17,2,15,7.5,7,8,1,1
8.151495406839254e+17,100,135,1.35,1,4,100,0
8.15168081078242e+17,27,50,1.8518518518518519,1,4,27,0
8.152431283085324e+17,36,282,7.833333333333333,2,10,10,26
8.156134337627602e+17,94,796,8.46808510638298,2,11,11,83
8.156408588140049e+17,3,28,9.333333333333334,9,10,0,3
8.156440804210245e+17,5,37,7.4,6,9,3,2
8.156639773519414e+17,2,19,9.5,9,10,0,2
8.156652576783919e+17,35,233,6.6571428571428575,5,9,29,6
8.156903908935727e+17,60,292,4.866666666666666,3,7,60,0
8.156910538727615e+17,20,53,2.65,1,4,20,0
8.15693988462127e+17,24,121,5.041666666666667,3,7,24,0
8.156957566877757e+17,26,222,8.538461538461538,5,11,4,22
8.157150304420613e+17,91,612,6.725274725274725,2,9,63,28
8.157380692838958e+17,35,358,10.228571428571428,8,13,0,35
8.157493330419731e+17,2,20,10.0,9,11,0,2
8.157525626318964e+17,10,96,9.6,9,11,0,10
8.157549026776609e+17,8,74,9.25,7,10,1,7
8.157562473512347e+17,7,70,10.0,9,11,0,7
8.157587248771711e+17,5,49,9.8,9,10,0,5
8.157616265629661e+17,1,9,9.0,9,9,0,1
8.157649377336195e+17,2,19,9.5,8,11,0,2
8.157690763314995e+17,2,17,8.5,8,9,0,2
8.157701856165212e+17,1,10,10.0,10,10,0,1
8.157718634520566e+17,7,61,8.714285714285714,7,10,1,6
8.157730237671103e+17,7,69,9.857142857142858,9,11,0,7
8.157794410861596e+17,29,74,2.5517241379310347,1,4,29,0
8.157801992571228e+17,2,13,6.5,6,7,2,0
8.15827628809983e+17,1,10,10.0,10,10,0,1
8.158531690277103e+17,12,35,2.9166666666666665,2,6,12,0
8.158807354006687e+17,1,6,6.0,6,6,1,0
8.160394551139603e+17,83,330,3.9759036144578315,2,6,83,0
8.164234936850382e+17,46,269,5.8478260869565215,2,9,43,3
8.164556220302593e+17,13,118,9.076923076923077,5,11,1,12
8.164760465743049e+17,1,9,9.0,9,9,0,1
8.164891023873504e+17,61,305,5.0,3,7,61,0
8.16494099498335e+17,3,5,1.6666666666666667,1,2,3,0
8.165276647957449e+17,48,191,3.9791666666666665,2,6,48,0
8.165395733914003e+17,7,24,3.4285714285714284,2,5,7,0
8.165701405210308e+17,80,160,2.0,1,4,80,0
8.165996811915296e+17,41,95,2.317073170731707,1,5,41,0
8.167064513999107e+17,22,193,8.772727272727273,5,11,4,18
8.167308451926189e+17,46,268,5.826086956521739,2,8,41,5
8.17089564994942e+17,1,8,8.0,8,8,0,1
8.17109220220558e+17,9,53,5.888888888888889,3,7,9,0
8.171680442617645e+17,2,5,2.5,2,3,2,0
8.17168327773268e+17,1,4,4.0,4,4,1,0
8.171768338784289e+17,60,120,2.0,1,5,60,0
8.171924824881266e+17,16,122,7.625,3,9,5,11
8.171994693928867e+17,120,597,4.975,2,8,118,2
8.172398398110217e+17,120,604,5.033333333333333,2,7,120,0
8.172418880251457e+17,157,765,4.872611464968153,2,8,156,1
8.172780551638324e+17,147,728,4.9523809523809526,3,8,146,1
8.172796429649883e+17,1,8,8.0,8,8,0,1
8.172904595583858e+17,120,609,5.075,2,8,119,1
8.173091444986513e+17,15,42,2.8,1,5,15,0
8.173184213684718e+17,21,80,3.8095238095238093,2,6,21,0
8.173752911993041e+17,5,25,5.0,4,6,5,0
8.173849823389289e+17,78,376,4.82051282051282,2,7,78,0
8.174262010310043e+17,20,97,4.85,2,7,20,0
8.174680444692471e+17,5,22,4.4,3,6,5,0
8.174718906000774e+17,81,111,1.3703703703703705,1,3,81,0
8.174783440020261e+17,73,282,3.863013698630137,2,6,73,0
8.175480966545116e+17,34,331,9.735294117647058,5,12,2,32
8.176060832160735e+17,56,271,4.839285714285714,2,7,56,0
8.179148671145047e+17,145,1243,8.572413793103449,2,12,21,124
8.179342128965183e+17,5,27,5.4,4,6,5,0
8.179551951979732e+17,35,78,2.2285714285714286,1,4,35,0
8.179682729620403e+17,6,27,4.5,2,6,6,0
8.180114914150363e+17,54,479,8.87037037037037,3,12,4,50
8.180158219956801e+17,20,43,2.15,1,4,20,0
8.180227076743409e+17,38,111,2.9210526315789473,1,6,38,0
8.180454375994637e+17,88,184,2.090909090909091,1,5,88,0
8.180734505268184e+17,41,197,4.804878048780488,3,7,41,0
8.181353738078756e+17,3,17,5.666666666666667,4,7,3,0
8.181727984980492e+17,50,345,6.9,2,9,36,14
8.18198546624969e+17,90,190,2.111111111111111,1,5,90,0
8.185135679099882e+17,54,373,6.907407407407407,3,10,37,17
8.185896411217723e+17,14,29,2.0714285714285716,1,4,14,0
8.186055861789646e+17,100,211,2.11,1,5,100,0
8.18617858248429e+17,3,8,2.6666666666666665,2,4,3,0
8.186180915038394e+17,4,8,2.0,1,3,4,0
8.188913432430912e+17,25,76,3.04,1,5,25,0
8.189097552870199e+17,6,38,6.333333333333333,6,7,6,0
8.192196513678432e+17,35,289,8.257142857142858,5,11,7,28
8.192869575760086e+17,34,46,1.3529411764705883,1,3,34,0
8.19350652308779e+17,19,132,6.947368421052632,4,9,11,8
8.194376990998106e+17,13,72,5.538461538461538,4,7,13,0
8.194835822971427e+17,25,36,1.44,1,3,25,0
8.194988452482372e+17,10,96,9.6,7,12,1,9
8.195703674853268e+17,19,93,4.894736842105263,3,8,18,1
8.20014999034702e+17,8,76,9.5,3,12,1,7
8.20064797000243e+17,81,172,2.123456790123457,1,4,81,0
8.200684996121631e+17,49,333,6.795918367346939,2,9,32,17
8.200800142647223e+17,88,433,4.920454545454546,2,8,87,1
8.201237788799767e+17,4,20,5.0,4,6,4,0
8.202170808816495e+17,36,81,2.25,1,4,36,0
8.20237410787784e+17,51,494,9.686274509803921,5,12,3,48
8.202628845093188e+17,59,508,8.610169491525424,2,11,6,53
8.207221990627727e+17,35,80,2.2857142857142856,1,5,35,0
8.20748781230861e+17,47,313,6.659574468085107,3,10,35,12
8.20781889229863e+17,35,73,2.085714285714286,1,4,35,0
8.208021990643729e+17,36,320,8.88888888888889,2,12,6,30
8.208353141105715e+17,23,160,6.956521739130435,6,8,18,5
8.208793526308499e+17,57,395,6.9298245614035086,3,9,36,21
8.208810637373759e+17,119,911,7.65546218487395,2,11,50,69
8.208832157718474e+17,15,67,4.466666666666667,3,6,15,0
8.208837085024774e+17,12,29,2.4166666666666665,1,4,12,0
8.20885015218759e+17,204,639,3.1323529411764706,1,6,204,0
8.209064074116312e+17,15,111,7.4,3,9,6,9
8.209124009434888e+17,73,512,7.013698630136986,5,9,50,23
8.209451732440166e+17,20,73,3.65,2,5,20,0
8.210404306335424e+17,130,1136,8.738461538461538,3,12,15,115
8.21093823071095e+17,74,102,1.3783783783783783,1,3,74,0
8.211173186591008e+17,27,52,1.9259259259259258,1,4,27,0
8.214176094156553e+17,7,58,8.285714285714286,7,10,2,5
8.214439568259857e+17,2,5,2.5,2,3,2,0
8.214731957261938e+17,29,275,9.482758620689655,3,12,1,28
8.214735068731071e+17,4,4,1.0,1,1,4,0
8.214970473331122e+17,33,66,2.0,1,4,33,0
8.214971335495251e+17,57,124,2.175438596491228,1,5,57,0
8.215034526957044e+17,8,65,8.125,7,10,2,6
8.215292792052534e+17,1,4,4.0,4,4,1,0
8.215305925017747e+17,63,304,4.825396825396825,2,7,63,0
8.215606132488681e+17,46,139,3.0217391304347827,1,6,46,0
8.215618566882572e+17,78,231,2.9615384615384617,1,5,78,0
8.215977058309078e+17,7,62,8.857142857142858,7,10,1,6
8.216246060343758e+17,6,50,8.333333333333334,7,10,1,5
8.21667346696315e+17,40,87,2.175,1,4,40,0
8.21667691136647e+17,81,535,6.604938271604938,2,9,64,17
8.216718235230874e+17,1,3,3.0,3,3,1,0
8.217291884894184e+17,23,51,2.217391304347826,1,4,23,0
8.217295802796314e+17,26,49,1.8846153846153846,1,4,26,0
8.217608391455443e+17,65,447,6.876923076923077,3,9,43,22
8.217809456856122e+17,71,155,2.183098591549296,1,5,71,0
8.217855770348806e+17,102,807,7.911764705882353,2,11,29,73
8.217861721325906e+17,54,359,6.648148148148148,2,10,42,12
8.217952800700543e+17,63,504,8.0,2,10,17,46
8.217970533667562e+17,59,452,7.661016949152542,3,11,22,37
8.217987835426568e+17,68,149,2.1911764705882355,1,4,68,0
8.218140209156914e+17,80,569,7.1125,2,9,47,33
8.21832813411085e+17,105,906,8.628571428571428,2,11,14,91
8.218402732570144e+17,84,750,8.928571428571429,4,12,6,78
8.218902113167931e+17,25,53,2.12,1,5,25,0
8.22197037499534e+17,3,27,9.0,8,10,0,3
8.222035017718441e+17,4,38,9.5,9,10,0,4
8.22209077342924e+17,4,39,9.75,8,11,0,4
8.222168405690723e+17,3,28,9.333333333333334,8,11,0,3
8.222204289740458e+17,13,134,10.307692307692308,7,12,1,12
8.222226474943336e+17,64,439,6.859375,2,9,43,21
8.22224166578378e+17,1,10,10.0,10,10,0,1
8.222336889335095e+17,52,111,2.1346153846153846,1,5,52,0
8.22247673396372e+17,11,95,8.636363636363637,8,10,0,11
8.222625702242286e+17,160,470,2.9375,1,6,160,0
8.222801902647022e+17,17,38,2.235294117647059,1,5,17,0
8.22287333193718e+17,32,284,8.875,2,12,4,28
8.222983693364159e+17,28,102,3.642857142857143,1,5,28,0
8.223066649807178e+17,31,88,2.838709677419355,1,4,31,0
8.223721922135071e+17,19,67,3.526315789473684,2,5,19,0
8.223823529781734e+17,10,89,8.9,3,11,1,9
8.224202130310828e+17,1,4,4.0,4,4,1,0
8.224212811068018e+17,56,529,9.446428571428571,4,12,4,52
8.224261617449632e+17,33,238,7.212121212121212,2,10,17,16
8.224289715803814e+17,8,11,1.375,1,2,8,0
8.226498915760276e+17,47,371,7.8936170212765955,6,11,16,31
8.22917585272623e+17,18,33,1.8333333333333333,1,4,18,0
8.229439843857155e+17,87,427,4.908045977011494,2,7,87,0
8.230115780592465e+17,5,25,5.0,4,7,5,0
8.230369966576238e+17,23,109,4.739130434782608,3,7,23,0
8.23038722684997e+17,6,13,2.1666666666666665,1,4,6,0
8.230624687452247e+17,55,77,1.4,1,3,55,0
8.231066165866271e+17,71,132,1.8591549295774648,1,4,71,0
8.23169317061848e+17,3,9,3.0,1,4,3,0
8.232541965817297e+17,25,238,9.52,5,12,1,24
8.233403257789969e+17,6,45,7.5,6,9,4,2
8.237015543096397e+17,2,8,4.0,4,4,2,0
8.237480294527471e+17,26,255,9.807692307692308,4,12,2,24
8.237751288755488e+17,1,4,4.0,4,4,1,0
8.238025745086836e+17,85,409,4.811764705882353,3,7,85,0
8.238507458181347e+17,84,407,4.845238095238095,2,8,82,2
8.239023039744691e+17,20,193,9.65,8,12,0,20
8.239306883077853e+17,53,167,3.150943396226415,1,5,53,0
8.239469442619315e+17,31,146,4.709677419354839,2,7,31,0
8.239958645399165e+17,160,776,4.85,2,8,159,1
8.240557335240986e+17,155,772,4.980645161290322,2,8,153,2
8.24267076043737e+17,70,352,5.0285714285714285,3,7,70,0
8.244036249922679e+17,1,2,2.0,2,2,1,0
8.24486258712563e+17,147,1018,6.925170068027211,2,10,103,44
8.245052298608212e+17,147,1448,9.850340136054422,2,12,4,143
8.24505238958053e+17,126,1234,9.793650793650794,2,12,7,119
8.245296007833626e+17,122,842,6.901639344262295,2,10,83,39
8.245879178293073e+17,15,108,7.2,5,9,7,8
8.246407595212573e+17,2,5,2.5,2,3,2,0
8.246925179939988e+17,118,348,2.9491525423728815,1,6,118,0
8.247156584717539e+17,31,96,3.096774193548387,1,5,31,0
8.248044597196353e+17,52,501,9.634615384615385,3,13,4,48
8.251380423528433e+17,99,504,5.090909090909091,3,8,97,2
8.252840721313672e+17,31,165,5.32258064516129,3,8,30,1
8.253188370124582e+17,28,188,6.714285714285714,4,8,23,5
8.253324542714697e+17,7,18,2.5714285714285716,1,4,7,0
8.253452031298514e+17,88,591,6.715909090909091,3,10,67,21
8.254050127978557e+17,113,446,3.9469026548672566,1,6,113,0
8.254078901581068e+17,39,259,6.641025641025641,4,9,33,6
8.254206368868462e+17,7,13,1.8571428571428572,1,3,7,0
8.257672806271244e+17,35,337,9.628571428571428,8,11,0,35
8.258138886602714e+17,32,313,9.78125,4,12,2,30
8.258375241774995e+17,18,38,2.111111111111111,1,5,18,0
8.25840113256014e+17,27,180,6.666666666666667,2,9,19,8
8.25876820173795e+17,50,252,5.04,3,7,50,0
8.25881595819678e+17,14,31,2.2142857142857144,1,4,14,0
8.259585570555404e+17,31,133,4.290322580645161,2,6,31,0
8.259984310732719e+17,85,592,6.964705882352941,3,11,56,29
8.260039012338723e+17,77,508,6.597402597402597,2,10,60,17
8.260183062324456e+17,27,276,10.222222222222221,6,13,1,26
8.260306262849233e+17,116,572,4.931034482758621,2,7,116,0
8.260537630519818e+17,50,73,1.46,1,4,50,0
8.26064770411127e+17,50,349,6.98,4,9,31,19
8.261039151400294e+17,2,3,1.5,1,2,2,0
8.261705920335269e+17,2,8,4.0,2,6,2,0
8.262052408676261e+17,1,2,2.0,2,2,1,0
8.2622827704549e+17,11,35,3.1818181818181817,2,4,11,0
8.265220130379322e+17,17,55,3.235294117647059,1,4,17,0
8.265283050128658e+17,76,367,4.828947368421052,2,8,75,1
8.2652898293963e+17,105,926,8.81904761904762,2,11,6,99
8.265594428867232e+17,61,123,2.0163934426229506,1,4,61,0
8.26565373615404e+17,3,5,1.6666666666666667,1,3,3,0
8.265683654915969e+17,19,51,2.6842105263157894,1,5,19,0
8.265864650474113e+17,55,379,6.890909090909091,3,9,41,14
8.265873402481092e+17,86,347,4.034883720930233,2,7,86,0
8.266896112435094e+17,7,32,4.571428571428571,3,6,7,0
8.267156901634093e+17,96,767,7.989583333333333,2,12,26,70
8.267356468685693e+17,11,46,4.181818181818182,3,6,11,0
8.267620970927855e+17,2,4,2.0,2,2,2,0
8.267759953811313e+17,1,1,1.0,1,1,1,0
8.268051353644684e+17,110,760,6.909090909090909,2,9,73,37
8.26866856115917e+17,19,131,6.894736842105263,5,9,13,6
8.269722330981139e+17,94,376,4.0,2,6,94,0
8.272695322553638e+17,65,154,2.3692307692307693,1,5,65,0
8.272857568647721e+17,86,191,2.2209302325581395,1,4,86,0
8.273297279439027e+17,17,97,5.705882352941177,2,7,17,0
8.274065673145645e+17,16,82,5.125,3,6,16,0
8.274435786834714e+17,119,1168,9.815126050420169,2,13,6,113
8.27452686637231e+17,46,224,4.869565217391305,3,7,46,0
8.274770943604357e+17,4,6,1.5,1,2,4,0
8.275410946749755e+17,12,60,5.0,2,7,12,0
8.275572758422062e+17,30,211,7.033333333333333,3,10,19,11
8.279229019492102e+17,9,60,6.666666666666667,4,8,8,1
8.279837546425326e+17,26,64,2.4615384615384617,1,5,26,0
8.280099413338569e+17,18,40,2.2222222222222223,1,3,18,0
8.280422465768102e+17,45,329,7.311111111111111,2,10,24,21
8.280514089138627e+17,2,2,1.0,1,1,2,0
8.280632437117983e+17,6,11,1.8333333333333333,1,3,6,0
8.28077289154864e+17,53,513,9.679245283018869,2,13,3,50
8.281550664019508e+17,15,88,5.866666666666666,5,8,14,1
8.281707099264986e+17,92,645,7.010869565217392,5,9,66,26
8.281863856242774e+17,54,262,4.851851851851852,2,8,53,1
8.282089106190605e+17,2,8,4.0,4,4,2,0
8.282106374609631e+17,77,156,2.0259740259740258,1,4,77,0
8.282265412912739e+17,1,2,2.0,2,2,1,0
8.282322856812483e+17,124,1218,9.82258064516129,3,14,5,119
8.282425295377597e+17,9,60,6.666666666666667,4,9,6,3
8.282449430279288e+17,1,7,7.0,7,7,1,0
8.283065009532069e+17,125,1067,8.536,2,11,18,107
8.283132026399478e+17,106,526,4.962264150943396,2,7,106,0
8.283534716719378e+17,89,183,2.056179775280899,1,5,89,0
8.284473429705386e+17,49,238,4.857142857142857,3,6,49,0
8.286751597642304e+17,7,24,3.4285714285714284,3,5,7,0
8.286930326508434e+17,31,297,9.580645161290322,5,12,4,27
8.287009850720824e+17,22,85,3.8636363636363638,2,5,22,0
8.287016687776069e+17,3,8,2.6666666666666665,2,3,3,0
8.287136125268846e+17,2,7,3.5,3,4,2,0
8.287605131250998e+17,51,260,5.098039215686274,2,7,51,0
8.287680352541992e+17,68,336,4.9411764705882355,3,7,68,0
8.287724232179575e+17,35,309,8.82857142857143,3,11,4,31
8.287751595429696e+17,72,351,4.875,3,8,70,2
8.288398122272792e+17,2,18,9.0,8,10,0,2
8.288724145272904e+17,46,89,1.934782608695652,1,4,46,0
8.28922511876252e+17,1,8,8.0,8,8,0,1
8.291948508927638e+17,36,222,6.166666666666667,4,9,33,3
8.294999834618679e+17,51,155,3.0392156862745097,1,5,51,0
8.295365240595836e+17,64,256,4.0,1,7,64,0
8.297914541696212e+17,2,6,3.0,3,3,2,0
8.302365245586708e+17,18,55,3.0555555555555554,2,5,18,0
8.302369863367636e+17,3,13,4.333333333333333,4,5,3,0
8.302747556473393e+17,9,12,1.3333333333333333,1,2,9,0
8.303999352848792e+17,3,20,6.666666666666667,6,7,3,0
8.305798009670408e+17,2,7,3.5,3,4,2,0
8.306291269556744e+17,22,109,4.954545454545454,3,7,22,0
8.308771297176261e+17,28,82,2.9285714285714284,1,5,28,0
8.309064534852941e+17,7,43,6.142857142857143,2,8,4,3
8.309074301286793e+17,12,15,1.25,1,2,12,0
8.309385971201637e+17,69,280,4.057971014492754,2,7,69,0
8.309415373847238e+17,20,100,5.0,3,7,20,0
8.309587346440244e+17,31,96,3.096774193548387,1,5,31,0
8.310022064450514e+17,35,102,2.914285714285714,2,5,35,0
8.310600491213331e+17,31,65,2.096774193548387,1,4,31,0
8.310605657621263e+17,18,154,8.555555555555555,3,10,2,16
8.310636272757676e+17,72,161,2.236111111111111,1,5,72,0
8.310670317253512e+17,52,118,2.269230769230769,1,5,52,0
8.310945266368943e+17,21,106,5.0476190476190474,3,8,20,1
8.311033443245856e+17,6,23,3.8333333333333335,2,5,6,0
8.311117048075113e+17,3,7,2.3333333333333335,2,3,3,0
8.311237511884591e+17,126,612,4.857142857142857,2,7,126,0
8.311443449870936e+17,111,556,5.009009009009009,2,8,110,1
8.311482366547992e+17,14,62,4.428571428571429,3,6,14,0
8.312593146808419e+17,3,22,7.333333333333333,6,9,2,1
8.312895101477866e+17,146,1145,7.842465753424658,4,11,53,93
8.312947204722659e+17,9,53,5.888888888888889,4,8,7,2
8.314817592196892e+17,2,20,10.0,10,10,0,2
8.315131777837879e+17,2,13,6.5,4,9,1,1
8.316227606757635e+17,10,16,1.6,1,3,10,0
8.316233545605605e+17,59,564,9.559322033898304,2,12,4,55
8.31635451613633e+17,17,50,2.9411764705882355,2,5,17,0
8.316450296697563e+17,46,101,2.1956521739130435,1,4,46,0
8.316591400973798e+17,124,953,7.685483870967742,2,10,46,78
8.316612536197948e+17,154,743,4.824675324675325,3,8,153,1
8.316643962539899e+17,2,3,1.5,1,2,2,0
8.316925555972541e+17,14,98,7.0,5,9,9,5
8.316961251847462e+17,9,61,6.777777777777778,5,8,7,2
8.317128799816796e+17,1,4,4.0,4,4,1,0
8.317131479933834e+17,74,707,9.554054054054054,2,12,5,69
8.317212365206824e+17,115,574,4.991304347826087,2,7,115,0
8.31728693478873e+17,1,1,1.0,1,1,1,0
8.318089399425135e+17,24,118,4.916666666666667,3,7,24,0
8.318445758859786e+17,2,5,2.5,2,3,2,0
8.318530676818346e+17,79,331,4.189873417721519,2,6,79,0
8.318963076390666e+17,131,663,5.061068702290076,2,8,129,2
8.319189884973425e+17,29,51,1.7586206896551724,1,4,29,0
8.319300066629284e+17,68,464,6.823529411764706,4,10,50,18
8.320139812059192e+17,131,180,1.3740458015267176,1,4,131,0
8.320270528355314e+17,19,81,4.2631578947368425,2,6,19,0
8.323339602983857e+17,36,81,2.25,1,4,36,0
8.323428028927781e+17,62,610,9.838709677419354,3,13,7,55
8.323707550155974e+17,31,57,1.8387096774193548,1,4,31,0
8.323772598832549e+17,1,2,2.0,2,2,1,0
8.32423099212717e+17,6,11,1.8333333333333333,1,4,6,0
8.324426420341617e+17,11,22,2.0,1,4,11,0
8.32448724797728e+17,29,107,3.689655172413793,1,6,29,0
8.324877766918193e+17,74,713,9.635135135135135,2,12,5,69
8.325262064944092e+17,43,76,1.7674418604651163,1,4,43,0
8.325483553697413e+17,28,210,7.5,2,9,11,17
8.325548582824216e+17,35,76,2.1714285714285713,1,4,35,0
8.325805380191342e+17,32,259,8.09375,2,12,8,24
8.326315804298141e+17,7,8,1.1428571428571428,1,2,7,0
8.326398289192974e+17,10,33,3.3,1,5,10,0
8.326953111937005e+17,27,98,3.6296296296296298,2,5,27,0
8.326956991845076e+17,36,331,9.194444444444445,2,12,4,32
8.327073393305631e+17,28,52,1.8571428571428572,1,5,28,0
8.327148877330579e+17,6,7,1.1666666666666667,1,2,6,0
8.329717844842584e+17,10,14,1.4,1,3,10,0
8.329799823182949e+17,21,26,1.2380952380952381,1,3,21,0
8.330462623278921e+17,39,377,9.666666666666666,6,12,3,36
8.330546869951293e+17,42,280,6.666666666666667,3,9,32,10
8.330647928448902e+17,2,5,2.5,1,4,2,0
8.330652109517859e+17,1,5,5.0,5,5,1,0
8.33130789051484e+17,1,3,3.0,3,3,1,0
8.331733898804152e+17,39,253,6.487179487179487,4,9,32,7
8.331926398977413e+17,51,255,5.0,3,8,50,1
8.332395527450977e+17,14,30,2.142857142857143,1,5,14,0
8.332420564492897e+17,92,202,2.1956521739130435,1,4,92,0
8.3324605345044e+17,1,2,2.0,2,2,1,0
8.332474897774287e+17,21,128,6.095238095238095,2,9,16,5
8.332576833556005e+17,18,126,7.0,5,8,11,7
8.332667899746893e+17,18,148,8.222222222222221,7,10,3,15
8.332672813075117e+17,9,48,5.333333333333333,3,7,9,0
8.332762821567726e+17,8,64,8.0,5,9,1,7
8.333098539635986e+17,14,73,5.214285714285714,4,7,14,0
8.333219438057399e+17,56,160,2.857142857142857,1,5,56,0
8.333328886952826e+17,4,34,8.5,7,11,1,3
8.333362094217802e+17,156,796,5.102564102564102,2,8,155,1
8.334080198186538e+17,26,48,1.8461538461538463,1,3,26,0
8.336519123431334e+17,163,1134,6.957055214723926,3,9,106,57
8.337878819568667e+17,163,1576,9.668711656441717,2,12,8,155
8.338398931009253e+17,11,71,6.454545454545454,4,8,8,3
8.338472370854702e+17,2,7,3.5,3,4,2,0
8.338682349097316e+17,15,35,2.3333333333333335,1,4,15,0
8.338805886686735e+17,11,44,4.0,2,6,11,0
8.339374753846822e+17,52,93,1.7884615384615385,1,3,52,0
8.339468526085032e+17,48,244,5.083333333333333,2,7,48,0
8.339482997839268e+17,11,60,5.454545454545454,2,8,10,1
8.339923361691482e+17,109,523,4.798165137614679,2,7,109,0
8.34109472006881e+17,36,76,2.111111111111111,1,5,36,0
8.341275704546253e+17,27,56,2.074074074074074,1,4,27,0
8.344075291526982e+17,14,96,6.857142857142857,4,9,9,5
8.344142737111626e+17,95,922,9.705263157894738,2,13,6,89
8.344836310000221e+17,4,28,7.0,7,7,4,0
8.344991156524622e+17,88,609,6.920454545454546,2,9,58,30
8.345131591254725e+17,1,9,9.0,9,9,0,1
8.345993321859782e+17,60,233,3.8833333333333333,1,6,60,0
8.347721544034989e+17,15,86,5.733333333333333,2,8,13,2
8.348069166523276e+17,99,674,6.808080808080808,3,10,68,31
8.348193257524684e+17,98,667,6.8061224489795915,2,10,68,30
8.348226629530286e+17,89,615,6.910112359550562,2,9,63,26
8.348928098495647e+17,75,297,3.96,1,6,75,0
8.349028541191014e+17,1,8,8.0,8,8,0,1
8.350383774411625e+17,46,174,3.782608695652174,1,6,46,0
8.351994264067581e+17,9,63,7.0,5,9,5,4
8.352461669171706e+17,41,282,6.878048780487805,3,9,30,11
8.353119579140545e+17,87,839,9.64367816091954,2,12,5,82
8.35329033726019e+17,5,9,1.8,1,3,5,0
8.354450942952257e+17,53,529,9.981132075471699,8,12,0,53
8.35465691533733e+17,98,501,5.112244897959184,2,8,96,2
8.354711831163864e+17,9,67,7.444444444444445,6,10,6,3
8.354741155602292e+17,32,117,3.65625,2,5,32,0
8.354758856373567e+17,25,47,1.88,1,4,25,0
8.355044241044413e+17,81,326,4.0246913580246915,2,6,81,0
8.35546583475959e+17,21,28,1.3333333333333333,1,3,21,0
8.355886340863466e+17,14,25,1.7857142857142858,1,4,14,0
8.356108537210003e+17,22,34,1.5454545454545454,1,3,22,0
8.356580722233473e+17,98,304,3.1020408163265305,1,5,98,0
8.358886248116517e+17,14,24,1.7142857142857142,1,3,14,0
8.358956864280863e+17,38,53,1.394736842105263,1,3,38,0
8.359205545574673e+17,67,669,9.985074626865671,6,13,3,64
8.3595417866515e+17,3,11,3.6666666666666665,3,4,3,0
8.35964162861362e+17,16,101,6.3125,2,9,11,5
8.359645569606499e+17,24,34,1.4166666666666667,1,3,24,0
8.36000781199935e+17,49,198,4.040816326530612,2,7,49,0
8.360160694355054e+17,80,384,4.8,2,8,78,2
8.36048463129733e+17,77,232,3.012987012987013,1,5,77,0
8.36072571892857e+17,29,193,6.655172413793103,2,8,24,5
8.361165752911736e+17,8,18,2.25,1,4,8,0
8.361262409724513e+17,28,55,1.9642857142857142,1,4,28,0
8.361596719929583e+17,124,615,4.959677419354839,3,8,123,1
8.361598278565704e+17,51,72,1.411764705882353,1,4,51,0
8.361786439767251e+17,16,34,2.125,1,4,16,0
8.361965716423945e+17,7,17,2.4285714285714284,1,4,7,0
8.362342157096484e+17,8,31,3.875,3,5,8,0
8.362345659208815e+17,34,253,7.4411764705882355,2,10,13,21
8.362456277316919e+17,61,422,6.918032786885246,4,9,41,20
8.362894198371101e+17,112,455,4.0625,2,6,112,0
8.363391185330356e+17,70,148,2.1142857142857143,1,5,70,0
8.363489214767201e+17,6,21,3.5,2,4,6,0
8.365651333440559e+17,55,122,2.2181818181818183,1,5,55,0
8.367126451192691e+17,95,920,9.68421052631579,2,13,6,89
8.367153666868631e+17,33,67,2.0303030303030303,1,4,33,0
8.367317033931679e+17,8,18,2.25,1,4,8,0
8.367321177783419e+17,9,77,8.555555555555555,5,10,1,8
8.367539014341965e+17,11,23,2.090909090909091,1,4,11,0
8.36773838801018e+17,4,12,3.0,2,4,4,0
8.367881137516714e+17,16,28,1.75,1,3,16,0
8.367998576454968e+17,16,35,2.1875,1,4,16,0
8.368111762477997e+17,13,52,4.0,2,5,13,0
8.36814995417397e+17,1,2,2.0,2,2,1,0
8.368190649996804e+17,12,79,6.583333333333333,4,8,9,3
8.368853417218673e+17,79,256,3.240506329113924,1,6,79,0
8.369658158890627e+17,188,921,4.898936170212766,2,8,187,1
8.36990518960942e+17,99,967,9.767676767676768,2,14,6,93
8.370189069003391e+17,13,37,2.8461538461538463,1,4,13,0
8.37038639209384e+17,9,13,1.4444444444444444,1,3,9,0
8.370603962291281e+17,80,624,7.8,2,11,28,52
8.370803631000527e+17,45,258,5.733333333333333,2,8,44,1
8.373563731612412e+17,8,23,2.875,2,3,8,0
8.373999218545352e+17,1,2,2.0,2,2,1,0
8.374027750736004e+17,27,56,2.074074074074074,1,4,27,0
8.37435899033867e+17,30,212,7.066666666666666,5,10,19,11
8.37442589969557e+17,24,167,6.958333333333333,5,9,16,8
8.375090449740297e+17,115,1097,9.539130434782608,2,13,8,107
8.375131391495711e+17,23,162,7.043478260869565,4,8,13,10
8.375444763542947e+17,39,382,9.794871794871796,4,12,1,38
8.37558447612959e+17,64,316,4.9375,2,7,64,0
8.376134883566682e+17,8,52,6.5,4,8,7,1
8.376901746555363e+17,122,257,2.1065573770491803,1,4,122,0
8.377303800763756e+17,59,512,8.677966101694915,3,11,6,53
8.377310991584015e+17,3,20,6.666666666666667,4,9,2,1
8.377993263629769e+17,50,75,1.5,1,4,50,0
8.380887485047407e+17,15,115,7.666666666666667,6,9,6,9
8.381446995766272e+17,77,146,1.896103896103896,1,4,77,0
8.381765115803909e+17,23,48,2.0869565217391304,1,3,23,0
8.382086442776298e+17,14,93,6.642857142857143,4,8,12,2
8.382098325123095e+17,30,62,2.066666666666667,1,4,30,0
8.382101250201073e+17,43,83,1.930232558139535,1,3,43,0
8.382216208029587e+17,8,17,2.125,1,3,8,0
8.38235366452792e+17,1,3,3.0,3,3,1,0
8.382506310899181e+17,94,661,7.031914893617022,5,9,65,29
8.382705182171062e+17,53,487,9.18867924528302,7,12,3,50
8.3827621153119e+17,1,2,2.0,2,2,1,0
8.383187679677228e+17,8,16,2.0,1,4,8,0
8.383189245884768e+17,6,13,2.1666666666666665,1,3,6,0
8.384682609042004e+17,64,313,4.890625,2,8,63,1
8.385049724591795e+17,30,82,2.7333333333333334,1,5,30,0
8.387578263915473e+17,13,85,6.538461538461538,3,10,11,2
8.387890485588659e+17,1,5,5.0,5,5,1,0
8.388378285849085e+17,76,148,1.9473684210526316,1,4,76,0
8.388897712553221e+17,15,27,1.8,1,3,15,0
8.388985505847969e+17,65,190,2.923076923076923,1,5,65,0
8.38898730442632e+17,1,1,1.0,1,1,1,0
8.389047183216904e+17,2,9,4.5,4,5,2,0
8.389190554209564e+17,72,710,9.86111111111111,2,12,4,68
8.389239888693108e+17,17,22,1.2941176470588236,1,3,17,0
8.389526765615793e+17,23,155,6.739130434782608,4,9,17,6
8.390166616637183e+17,42,400,9.523809523809524,2,11,3,39
8.390531603879493e+17,28,181,6.464285714285714,5,9,25,3
8.390847509601025e+17,10,96,9.6,3,12,1,9
8.39092028852055e+17,20,124,6.2,2,9,17,3
8.390925906273102e+17,11,16,1.4545454545454546,1,3,11,0
8.391236611550924e+17,2,9,4.5,4,5,2,0
8.391427674195227e+17,15,47,3.1333333333333333,1,6,15,0
8.391437495964361e+17,13,82,6.3076923076923075,2,8,11,2
8.392234720543034e+17,11,13,1.1818181818181819,1,2,11,0
8.392409259931548e+17,10,59,5.9,4,8,9,1
8.393514815414538e+17,2,2,1.0,1,1,2,0
8.39611487928007e+17,66,249,3.772727272727273,1,7,66,0
8.396421864975044e+17,15,20,1.3333333333333333,1,3,15,0
8.396423320579574e+17,24,29,1.2083333333333333,1,2,24,0
8.396722689341097e+17,47,192,4.085106382978723,2,6,47,0
8.39766830800942e+17,16,21,1.3125,1,3,16,0
8.397773186241132e+17,2,4,2.0,2,2,2,0
8.398022415599044e+17,13,106,8.153846153846153,7,10,4,9
8.398052923055525e+17,229,487,2.126637554585153,1,5,229,0
8.398055509418785e+17,15,92,6.133333333333334,5,8,13,2
8.39822577527285e+17,11,15,1.3636363636363635,1,3,11,0
8.398547721111845e+17,61,598,9.80327868852459,3,12,3,58
8.398567848526465e+17,21,190,9.047619047619047,7,11,2,19
8.398811059545303e+17,71,271,3.816901408450704,2,6,71,0
8.399280842251043e+17,1,2,2.0,2,2,1,0
8.400481239388516e+17,52,152,2.923076923076923,1,7,52,0
8.403450534921769e+17,5,13,2.6,2,4,5,0
8.403708728565596e+17,40,83,2.075,1,4,40,0
8.403766726910401e+17,57,126,2.210526315789474,1,4,57,0
8.404874009152372e+17,94,194,2.0638297872340425,1,4,94,0
8.404954950447533e+17,2,7,3.5,3,4,2,0
8.405226154151808e+17,33,323,9.787878787878787,3,13,3,30
8.405432748645802e+17,11,18,1.6363636363636365,1,3,11,0
8.405717217281274e+17,22,158,7.181818181818182,5,10,17,5
8.405917793612191e+17,24,161,6.708333333333333,2,9,19,5
8.406013754781242e+17,10,68,6.8,5,9,7,3
8.406544515745037e+17,79,760,9.620253164556962,3,12,5,74
8.406672349097213e+17,18,85,4.722222222222222,3,7,18,0
8.407154391558106e+17,1,2,2.0,2,2,1,0
8.40972894758694e+17,6,21,3.5,2,5,6,0
8.409856858018317e+17,17,33,1.9411764705882353,1,4,17,0
8.410013506959273e+17,53,519,9.79245283018868,2,12,3,50
8.410575321533033e+17,22,64,2.909090909090909,1,5,22,0
8.410829054933172e+17,176,691,3.9261363636363638,1,6,176,0
8.411364553942664e+17,83,731,8.80722891566265,2,12,6,77
8.411416743488228e+17,50,482,9.64,5,12,5,45
8.411816575873518e+17,7,9,1.2857142857142858,1,2,7,0
8.411936746316924e+17,45,127,2.8222222222222224,1,6,45,0
8.411945024283789e+17,52,96,1.8461538461538463,1,4,52,0
8.411950360020346e+17,52,458,8.807692307692308,3,10,7,45
8.411977105447503e+17,30,252,8.4,4,10,4,26
8.41197990859878e+17,36,333,9.25,7,11,1,35
8.412155737736128e+17,44,220,5.0,3,8,43,1
8.412587404873331e+17,59,412,6.983050847457627,3,10,40,19
8.412634833715132e+17,65,576,8.861538461538462,4,11,5,60
8.412804527354132e+17,2,9,4.5,3,6,2,0
8.412809221131401e+17,3,21,7.0,6,8,2,1
8.412857627834043e+17,10,45,4.5,3,7,10,0
8.413199962249681e+17,8,34,4.25,3,5,8,0
8.413215529027681e+17,20,40,2.0,1,4,20,0
8.413222002465746e+17,21,105,5.0,4,7,21,0
8.4134634709341e+17,1,3,3.0,3,3,1,0
8.413636306731802e+17,72,487,6.763888888888889,2,10,57,15
8.413819809351205e+17,105,511,4.866666666666666,2,8,104,1
8.414817586633427e+17,52,98,1.8846153846153846,1,4,52,0
8.417044667424732e+17,18,140,7.777777777777778,4,10,7,11
8.417283754939887e+17,1,2,2.0,2,2,1,0
8.417284172082423e+17,36,137,3.8055555555555554,2,5,36,0
8.417485212356963e+17,124,393,3.1693548387096775,1,7,124,0
8.417758097202868e+17,12,19,1.5833333333333333,1,3,12,0
8.417758151792796e+17,17,117,6.882352941176471,5,9,13,4
8.417758576985152e+17,24,167,6.958333333333333,3,9,16,8
8.417760093954345e+17,14,95,6.785714285714286,2,9,8,6
8.417760375492068e+17,4,6,1.5,1,3,4,0
8.417760578933298e+17,4,30,7.5,7,9,3,1
8.418229522825106e+17,21,163,7.761904761904762,6,10,7,14
8.418273334856127e+17,39,93,2.3846153846153846,1,5,39,0
8.418679943549889e+17,37,185,5.0,3,8,36,1
8.418713219421806e+17,171,845,4.941520467836257,2,8,169,2
8.418849452068965e+17,4,8,2.0,1,3,4,0
8.419195493297884e+17,7,50,7.142857142857143,5,10,5,2
8.419411517492479e+17,4,29,7.25,7,8,3,1
8.41946129893941e+17,2,15,7.5,7,8,1,1
8.420097227034268e+17,43,173,4.023255813953488,1,7,43,0
8.420115567720932e+17,3,9,3.0,2,4,3,0
8.420233677790582e+17,55,166,3.018181818181818,1,5,55,0
8.420595096235406e+17,2,13,6.5,5,8,1,1
8.42080603916254e+17,80,690,8.625,2,11,10,70
8.421229437565518e+17,9,19,2.111111111111111,1,4,9,0
8.424676004256581e+17,50,296,5.92,4,8,46,4
8.425028642594659e+17,66,319,4.833333333333333,2,7,66,0
8.425071608882985e+17,3,8,2.6666666666666665,1,4,3,0
8.425423659516736e+17,108,1023,9.472222222222221,2,13,8,100
8.425839570639276e+17,58,101,1.7413793103448276,1,4,58,0
8.427036622933088e+17,98,144,1.469387755102041,1,4,98,0
8.427251547375899e+17,21,42,2.0,1,5,21,0
8.427637747378276e+17,50,71,1.42,1,4,50,0
8.428507852019788e+17,133,1142,8.586466165413533,2,12,20,113
8.431527247516223e+17,44,92,2.090909090909091,1,4,44,0
8.431584404228977e+17,64,82,1.28125,1,3,64,0
8.43189043558206e+17,29,63,2.1724137931034484,1,4,29,0
8.432045935636701e+17,32,63,1.96875,1,4,32,0
8.432791949537957e+17,19,93,4.894736842105263,3,7,19,0
8.432830488082468e+17,79,382,4.8354430379746836,2,8,78,1
8.432943123063409e+17,57,439,7.701754385964913,3,11,22,35
8.433429843061176e+17,9,74,8.222222222222221,7,10,2,7
8.433582959517939e+17,18,182,10.11111111111111,8,12,0,18
8.434104982549405e+17,115,238,2.0695652173913044,1,5,115,0
8.435412187588595e+17,32,220,6.875,2,9,23,9
8.4354423942334e+17,86,107,1.244186046511628,1,3,86,0
8.438518870646194e+17,27,138,5.111111111111111,2,7,27,0
8.439191701816664e+17,15,24,1.6,1,3,15,0
8.439294994176251e+17,33,74,2.242424242424242,1,4,33,0
8.439598180307438e+17,77,159,2.064935064935065,1,5,77,0
8.439658859354292e+17,16,44,2.75,2,4,16,0
8.439678734730994e+17,57,169,2.9649122807017543,1,5,57,0
8.439780318129559e+17,5,6,1.2,1,2,5,0
8.439845163731946e+17,47,92,1.9574468085106382,1,4,47,0
8.440003254994469e+17,53,461,8.69811320754717,2,11,4,49
8.440979697786569e+17,82,173,2.1097560975609757,1,4,82,0
8.441221517819855e+17,59,275,4.661016949152542,2,8,58,1
8.442527138435991e+17,234,2049,8.756410256410257,2,12,30,204
8.442964149391493e+17,98,207,2.1122448979591835,1,4,98,0
8.443462362911712e+17,1,2,2.0,2,2,1,0
8.443644850849586e+17,2,11,5.5,5,6,2,0
8.444613363270757e+17,10,44,4.4,3,6,10,0
8.44630414759813e+17,14,73,5.214285714285714,4,6,14,0
8.44708408643822e+17,19,32,1.6842105263157894,1,3,19,0
8.447159540878566e+17,9,58,6.444444444444445,5,8,8,1
8.447377457605576e+17,7,51,7.285714285714286,2,10,2,5
8.448679710829157e+17,3,21,7.0,6,8,2,1
8.449115492787103e+17,79,387,4.89873417721519,3,7,79,0
8.449142075236114e+17,100,394,3.94,2,6,100,0
8.449192938386436e+17,1,3,3.0,3,3,1,0
8.450714494497905e+17,128,981,7.6640625,2,11,55,73
8.451025451285894e+17,11,77,7.0,5,8,7,4
8.453870070429137e+17,4,28,7.0,6,8,3,1
8.454411536368941e+17,13,29,2.230769230769231,1,4,13,0
8.454746801891786e+17,158,761,4.8164556962025316,2,7,158,0
8.45479544230867e+17,23,48,2.0869565217391304,1,3,23,0
8.455631701628077e+17,129,907,7.0310077519379846,2,10,86,43
8.456412854439845e+17,8,85,10.625,10,12,0,8
8.456426935803325e+17,47,225,4.787234042553192,2,7,47,0
8.45647990960733e+17,8,21,2.625,2,4,8,0
8.456619842630627e+17,95,479,5.042105263157895,2,8,94,1
8.456990874024859e+17,31,219,7.064516129032258,3,9,18,13
8.457314263114346e+17,66,135,2.0454545454545454,1,4,66,0
8.460570207402637e+17,1,8,8.0,8,8,0,1
8.46073850501776e+17,11,72,6.545454545454546,6,7,11,0
8.460876026375667e+17,11,107,9.727272727272727,7,11,1,10
8.461014289696788e+17,117,1137,9.717948717948717,2,13,8,109
8.461445783941704e+17,66,318,4.818181818181818,2,7,66,0
8.461575145384863e+17,8,29,3.625,3,5,8,0
8.462160551568666e+17,7,23,3.2857142857142856,1,5,7,0
8.462302448668998e+17,120,1048,8.733333333333333,2,12,19,101
8.46257645135361e+17,34,167,4.911764705882353,2,7,34,0
8.462645975320424e+17,79,394,4.987341772151899,3,7,79,0
8.462668788927438e+17,35,345,9.857142857142858,8,12,0,35
8.462707686977448e+17,64,487,7.609375,4,10,31,33
8.463432920670884e+17,18,57,3.1666666666666665,1,5,18,0
8.464262085495756e+17,113,232,2.0530973451327434,1,5,113,0
8.464386253528147e+17,2,14,7.0,7,7,2,0
8.464484905344539e+17,7,14,2.0,1,3,7,0
8.465234968319994e+17,101,202,2.0,1,4,101,0
8.468189834864502e+17,79,706,8.936708860759493,3,12,12,67
8.4681985302646e+17,105,222,2.1142857142857143,1,5,105,0
8.468327586291496e+17,14,39,2.7857142857142856,2,4,14,0
8.468636092623105e+17,4,30,7.5,7,8,2,2
8.468702359138655e+17,37,75,2.027027027027027,1,4,37,0
8.469105291111324e+17,5,18,3.6,2,4,5,0
8.469397018886559e+17,97,469,4.835051546391752,3,7,97,0
8.469669346776869e+17,2,6,3.0,3,3,2,0
8.469705904668828e+17,74,363,4.905405405405405,2,7,74,0
8.469787104297452e+17,8,57,7.125,5,8,4,4
8.47014729897042e+17,57,564,9.894736842105264,2,12,1,56
8.470361365870522e+17,53,117,2.207547169811321,1,4,53,0
8.470541292392262e+17,31,66,2.129032258064516,1,4,31,0
8.47059065145059e+17,43,85,1.9767441860465116,1,4,43,0
8.470612358077503e+17,3,6,2.0,2,2,3,0
8.470626505915648e+17,25,237,9.48,4,12,1,24
8.470734706971041e+17,12,48,4.0,2,6,12,0
8.470815943403278e+17,57,125,2.192982456140351,1,4,57,0
8.471044189760174e+17,12,25,2.0833333333333335,1,3,12,0
8.471105628273032e+17,33,71,2.1515151515151514,1,4,33,0
8.471298630456726e+17,77,220,2.857142857142857,1,5,77,0
8.471451559043685e+17,157,623,3.968152866242038,2,6,157,0
8.471605820270633e+17,19,89,4.684210526315789,2,6,19,0
8.472192446276247e+17,41,148,3.6097560975609757,2,6,41,0
8.472275010409852e+17,48,191,3.9791666666666665,2,6,48,0
8.475331063051738e+17,66,338,5.121212121212121,2,7,66,0
8.475703821742797e+17,24,220,9.166666666666666,7,11,3,21
8.475839381837638e+17,103,401,3.8932038834951457,2,6,103,0
8.475841813686687e+17,18,91,5.055555555555555,4,8,17,1
8.475889084384152e+17,146,1402,9.602739726027398,2,12,12,134
8.475966662349533e+17,87,450,5.172413793103448,3,8,86,1
8.476116603814193e+17,44,179,4.068181818181818,2,6,44,0
8.47614734230659e+17,11,66,6.0,5,7,11,0
8.476161654471793e+17,14,102,7.285714285714286,3,9,7,7
8.476171713274418e+17,19,151,7.947368421052632,3,11,8,11
8.476194212119756e+17,21,167,7.9523809523809526,6,10,6,15
8.476203858167203e+17,13,85,6.538461538461538,5,8,11,2
8.476222668994068e+17,15,30,2.0,1,4,15,0
8.476226476752333e+17,35,268,7.6571428571428575,5,10,12,23
8.476262351273192e+17,3,7,2.3333333333333335,2,3,3,0
8.476264034990372e+17,54,208,3.8518518518518516,2,6,54,0
8.476320416701423e+17,3,6,2.0,1,3,3,0
8.476362809184051e+17,24,58,2.4166666666666665,1,5,24,0
8.476385281700436e+17,53,104,1.9622641509433962,1,5,53,0
8.476783395492172e+17,4,14,3.5,3,4,4,0
8.476833223245403e+17,25,220,8.8,3,11,2,23
8.477322343769247e+17,15,95,6.333333333333333,4,8,13,2
8.47782669764303e+17,67,197,2.9402985074626864,1,5,67,0
8.477926461481578e+17,70,339,4.8428571428571425,2,6,70,0
8.478207592785958e+17,62,598,9.64516129032258,3,13,5,57
8.478466023772174e+17,12,121,10.083333333333334,8,12,0,12
8.478565128119014e+17,37,251,6.783783783783784,3,9,29,8
8.482230489809247e+17,15,145,9.666666666666666,6,11,1,14
8.482375193768335e+17,3,9,3.0,3,3,3,0
8.482464066997009e+17,2,11,5.5,5,6,2,0
8.48280208438546e+17,82,242,2.951219512195122,1,6,82,0
8.482803126589233e+17,57,381,6.684210526315789,2,9,47,10
8.482816624327613e+17,69,338,4.898550724637682,2,7,69,0
8.48303963034765e+17,15,70,4.666666666666667,2,6,15,0
8.483180625260965e+17,2,3,1.5,1,2,2,0
8.483540372169061e+17,25,104,4.16,2,6,25,0
8.484431766301684e+17,1,2,2.0,2,2,1,0
8.484433525881505e+17,1,5,5.0,5,5,1,0
8.484438477084902e+17,9,26,2.888888888888889,2,4,9,0
8.48456164382083e+17,9,64,7.111111111111111,5,8,5,4
8.484640928689987e+17,24,90,3.75,2,6,24,0
8.484768788056348e+17,95,738,7.768421052631579,2,11,38,57
8.485117250953244e+17,71,660,9.295774647887324,2,12,7,64
8.485123026103758e+17,53,110,2.0754716981132075,1,4,53,0
8.485208816894423e+17,24,235,9.791666666666666,4,12,2,22
8.486000501268998e+17,2,18,9.0,8,10,0,2
8.486416673079316e+17,26,178,6.846153846153846,6,9,22,4
8.489013335456748e+17,4,11,2.75,2,4,4,0
8.490129171183686e+17,140,558,3.9857142857142858,1,7,140,0
8.490400605697341e+17,23,137,5.956521739130435,4,8,22,1
8.490408458825574e+17,3,21,7.0,6,8,2,1
8.490549492158207e+17,136,539,3.963235294117647,1,6,136,0
8.490670453165743e+17,94,636,6.76595744680851,2,9,66,28
8.490696436521044e+17,79,535,6.772151898734177,2,9,57,22
8.490842786706341e+17,22,42,1.9090909090909092,1,4,22,0
8.491079197448221e+17,90,193,2.1444444444444444,1,4,90,0
8.491252632341736e+17,21,195,9.285714285714286,2,12,2,19
8.491313028720773e+17,33,68,2.0606060606060606,1,3,33,0
8.491727875659647e+17,80,161,2.0125,1,4,80,0
8.491807991546652e+17,64,329,5.140625,2,8,63,1
8.49185233981908e+17,77,107,1.3896103896103895,1,4,77,0
8.492042016066826e+17,3,26,8.666666666666666,8,9,0,3
8.492086890690857e+17,65,90,1.3846153846153846,1,3,65,0
8.492356228409889e+17,39,81,2.076923076923077,1,4,39,0
8.492675398497498e+17,9,26,2.888888888888889,2,4,9,0
8.492680061027233e+17,32,162,5.0625,4,7,32,0
8.492977219324403e+17,49,243,4.959183673469388,2,7,49,0
8.494608554336995e+17,10,67,6.7,5,9,8,2
8.496335127689819e+17,48,101,2.1041666666666665,1,4,48,0
8.497010751896882e+17,35,337,9.628571428571428,8,12,0,35
8.497307046451973e+17,68,674,9.911764705882353,4,12,4,64
8.497315607501804e+17,3,14,4.666666666666667,2,7,3,0
8.497459692746756e+17,27,215,7.962962962962963,2,10,6,21
8.497870950570125e+17,43,290,6.744186046511628,4,9,32,11
8.498900402017745e+17,21,108,5.142857142857143,3,7,21,0
8.499949433650144e+17,113,542,4.79646017699115,2,7,113,0
8.499951628937946e+17,3,21,7.0,6,8,2,1
8.499952445691336e+17,32,182,5.6875,4,7,32,0
8.501321993786195e+17,18,75,4.166666666666667,2,6,18,0
8.504799524367598e+17,39,229,5.871794871794871,4,8,38,1
8.504806507047937e+17,67,322,4.8059701492537314,2,7,67,0
8.50539640078467e+17,173,1683,9.728323699421965,3,13,13,160
8.506204623099558e+17,3,13,4.333333333333333,4,5,3,0
8.506312334503776e+17,4,9,2.25,1,3,4,0
8.506822427136692e+17,78,381,4.884615384615385,3,7,78,0
8.506832818232284e+17,7,8,1.1428571428571428,1,2,7,0
8.510871741227526e+17,3,7,2.3333333333333335,2,3,3,0
8.51196406675316e+17,19,38,2.0,1,3,19,0
8.511964968495098e+17,87,812,9.333333333333334,2,12,6,81
8.511988424077298e+17,27,112,4.148148148148148,2,6,27,0
8.512104353427264e+17,10,38,3.8,2,5,10,0
8.512331797887462e+17,6,38,6.333333333333333,2,9,3,3
8.512391864619988e+17,13,40,3.076923076923077,2,5,13,0
8.512402192160358e+17,177,1335,7.5423728813559325,2,10,77,100
8.512602844551675e+17,18,86,4.777777777777778,3,7,18,0
8.512663102095483e+17,40,284,7.1,2,9,25,15
8.512867500827206e+17,1,6,6.0,6,6,1,0
8.512980648285421e+17,7,52,7.428571428571429,5,9,3,4
8.513033315579697e+17,59,137,2.3220338983050848,1,5,59,0
8.513215121211722e+17,6,22,3.6666666666666665,3,5,6,0
8.513291719936616e+17,148,1033,6.97972972972973,2,9,100,48
8.513510988331706e+17,8,18,2.25,1,4,8,0
8.513761619030546e+17,66,331,5.015151515151516,1,7,66,0
8.514303243934815e+17,89,848,9.52808988764045,2,12,6,83
8.514319230649998e+17,32,247,7.71875,3,9,13,19
8.514607958608317e+17,7,46,6.571428571428571,6,7,7,0
8.514636160334511e+17,56,383,6.839285714285714,2,9,42,14
8.514981145913668e+17,152,451,2.9671052631578947,1,6,152,0
8.515097008247699e+17,42,312,7.428571428571429,2,10,19,23
8.515568057714262e+17,56,499,8.910714285714286,3,11,5,51
8.518215668042742e+17,31,43,1.3870967741935485,1,3,31,0
8.518256348188273e+17,2,3,1.5,1,2,2,0
8.518299804392865e+17,6,10,1.6666666666666667,1,3,6,0
8.518325265928008e+17,12,16,1.3333333333333333,1,3,12,0
8.518936439918228e+17,78,771,9.884615384615385,5,12,2,76
8.519190709879904e+17,45,344,7.644444444444445,2,10,16,29
8.519346302602034e+17,3,8,2.6666666666666665,2,3,3,0
8.519581450095469e+17,62,564,9.096774193548388,7,12,2,60
8.52008517941481e+17,17,35,2.0588235294117645,1,4,17,0
8.521367570880608e+17,30,293,9.766666666666667,5,12,1,29
8.521379169723397e+17,58,462,7.9655172413793105,4,10,15,43
8.522266310039297e+17,15,101,6.733333333333333,3,8,12,3
8.522293009805809e+17,1,8,8.0,8,8,0,1
8.522486702956202e+17,4,8,2.0,1,3,4,0
8.522517390133029e+17,14,44,3.142857142857143,1,6,14,0
8.522624074953755e+17,19,125,6.578947368421052,3,9,14,5
8.524637190117475e+17,6,46,7.666666666666667,7,9,3,3
8.526223555500274e+17,7,21,3.0,2,4,7,0
8.526332722699731e+17,1,3,3.0,3,3,1,0
8.526549118150162e+17,4,7,1.75,1,3,4,0
8.527288307786061e+17,22,48,2.1818181818181817,1,3,22,0
8.527464511715896e+17,16,83,5.1875,4,7,16,0
8.528014557636975e+17,8,25,3.125,2,5,8,0
8.528545346343039e+17,3,7,2.3333333333333335,1,4,3,0
8.528599379241431e+17,89,785,8.820224719101123,2,11,8,81
8.528716227165974e+17,170,821,4.829411764705882,2,7,170,0
8.528783091040568e+17,51,194,3.803921568627451,2,7,51,0
8.528898356279592e+17,16,78,4.875,3,6,16,0
8.529951045969084e+17,1,1,1.0,1,1,1,0
8.530172605462481e+17,4,22,5.5,3,7,4,0
8.533205468340278e+17,102,137,1.3431372549019607,1,3,102,0
8.533593717003916e+17,69,270,3.9130434782608696,2,6,69,0
8.533653662764804e+17,11,114,10.363636363636363,7,12,1,10
8.534637358904649e+17,23,199,8.652173913043478,8,11,0,23
8.534662319934775e+17,4,5,1.25,1,2,4,0
8.534875718416874e+17,51,103,2.019607843137255,1,4,51,0
8.534938608784718e+17,4,26,6.5,2,9,2,2
8.535064662600882e+17,62,433,6.983870967741935,2,10,43,19
8.535394516783423e+17,12,81,6.75,5,8,10,2
8.535457445610116e+17,60,532,8.866666666666667,4,11,4,56
8.535783923949491e+17,74,712,9.621621621621621,4,12,6,68
8.535905908829445e+17,23,73,3.1739130434782608,1,5,23,0
8.536376001003471e+17,170,1312,7.7176470588235295,2,10,55,115
8.53739035682361e+17,193,381,1.9740932642487046,1,4,193,0
8.537433686387313e+17,7,32,4.571428571428571,4,5,7,0
8.537467942209815e+17,105,1044,9.942857142857143,5,12,4,101
8.540294468065916e+17,48,94,1.9583333333333333,1,4,48,0
8.540441579623642e+17,124,866,6.983870967741935,2,10,87,37
8.540701089654598e+17,12,30,2.5,1,5,12,0
8.54089021649965e+17,90,260,2.888888888888889,1,5,90,0
8.54109789161085e+17,33,290,8.787878787878787,5,11,4,29
8.541128246986006e+17,9,38,4.222222222222222,3,5,9,0
8.541627448008009e+17,5,35,7.0,5,9,3,2
8.541949275763706e+17,121,261,2.15702479338843,1,5,121,0
8.542415867340631e+17,196,1499,7.6479591836734695,4,10,80,116
8.542504660924995e+17,1,1,1.0,1,1,1,0
8.542832737981733e+17,14,19,1.3571428571428572,1,3,14,0
8.543032805179131e+17,14,52,3.7142857142857144,3,6,14,0
8.547432589986007e+17,2,3,1.5,1,2,2,0
8.548363371192667e+17,7,37,5.285714285714286,3,7,7,0
8.549019436736872e+17,18,32,1.7777777777777777,1,3,18,0
8.549934648399052e+17,17,138,8.117647058823529,6,10,2,15
8.549980091338607e+17,5,39,7.8,4,10,1,4
8.55033361898289e+17,51,240,4.705882352941177,3,6,51,0
8.550490447177206e+17,2,4,2.0,2,2,2,0
8.550742144656018e+17,15,33,2.2,1,4,15,0
8.551267170105825e+17,5,34,6.8,3,9,3,2
8.551519423500762e+17,1,1,1.0,1,1,1,0
8.552120350136332e+17,131,901,6.877862595419847,2,10,94,37
8.554877635890396e+17,187,1643,8.786096256684491,2,12,22,165
8.555535011277103e+17,8,35,4.375,3,6,8,0
8.555668651607295e+17,7,15,2.142857142857143,1,3,7,0
8.556324919157964e+17,93,372,4.0,2,7,93,0
8.55678326359647e+17,28,201,7.178571428571429,5,10,18,10
8.557512768584179e+17,47,95,2.021276595744681,1,4,47,0
8.557838280824922e+17,40,244,6.1,2,8,34,6
8.55799632027286e+17,31,185,5.967741935483871,2,8,29,2
8.558070506139227e+17,10,27,2.7,2,5,10,0
8.558081736565096e+17,9,16,1.7777777777777777,1,3,9,0
8.558198666670391e+17,31,215,6.935483870967742,3,9,20,11
8.558384215234836e+17,1,3,3.0,3,3,1,0
8.558414429392877e+17,3,11,3.6666666666666665,3,4,3,0
8.558740651158355e+17,2,12,6.0,5,7,2,0
8.561616272389524e+17,156,1099,7.044871794871795,3,11,99,57
8.561965639933336e+17,1,1,1.0,1,1,1,0
8.563806506020577e+17,130,269,2.0692307692307694,1,4,130,0
8.56384171126645e+17,6,14,2.3333333333333335,2,3,6,0
8.564221466277356e+17,9,37,4.111111111111111,3,5,9,0
8.564961225439075e+17,2,10,5.0,5,5,2,0
8.564992783248508e+17,26,135,5.1923076923076925,3,8,25,1
8.565085049379694e+17,14,26,1.8571428571428572,1,3,14,0
8.565420889330021e+17,10,93,9.3,3,11,1,9
8.565815362466209e+17,22,84,3.8181818181818183,2,6,22,0
8.565817072624933e+17,64,334,5.21875,3,7,64,0
8.566103515673763e+17,26,133,5.115384615384615,3,7,26,0
8.566280631509185e+17,34,222,6.529411764705882,2,9,26,8
8.569276592272635e+17,95,760,8.0,3,10,29,66
8.569391027858435e+17,32,245,7.65625,5,10,14,18
8.569531952890394e+17,2,5,2.5,2,3,2,0
8.569600944301883e+17,86,179,2.0813953488372094,1,4,86,0
8.569817971599932e+17,2,19,9.5,9,10,0,2
8.569856269990444e+17,99,674,6.808080808080808,2,10,75,24
8.570217225955794e+17,8,83,10.375,8,12,0,8
8.570299123185322e+17,8,61,7.625,3,11,3,5
8.570460073758752e+17,3,12,4.0,3,5,3,0
8.570506604829079e+17,4,20,5.0,4,6,4,0
8.570543049488303e+17,9,85,9.444444444444445,9,10,0,9
8.570570530131405e+17,14,69,4.928571428571429,4,6,14,0
8.570595771962095e+17,17,144,8.470588235294118,2,10,2,15
8.571285176115827e+17,71,498,7.014084507042254,5,9,49,22
8.571303680901107e+17,6,21,3.5,2,5,6,0
8.571445224302442e+17,23,44,1.9130434782608696,1,4,23,0
8.572159088257009e+17,1,5,5.0,5,5,1,0
8.572457144276877e+17,15,117,7.8,5,10,6,9
8.572812991586683e+17,15,106,7.066666666666666,2,10,7,8
8.574744230852924e+17,4,27,6.75,6,8,3,1
8.576700634273475e+17,124,629,5.07258064516129,2,7,124,0
8.576752786815796e+17,60,122,2.033333333333333,1,5,60,0
8.576910080026993e+17,10,34,3.4,2,5,10,0
8.577257449436457e+17,13,27,2.076923076923077,1,3,13,0
8.577360165293955e+17,12,26,2.1666666666666665,1,3,12,0
8.577655471215144e+17,11,94,8.545454545454545,7,10,1,10
8.577768728679731e+17,17,40,2.3529411764705883,1,4,17,0
8.577973048392155e+17,115,436,3.791304347826087,1,7,115,0
8.578021434226467e+17,142,571,4.02112676056338,2,6,142,0
8.578352630207712e+17,5,37,7.4,6,9,3,2
8.578534086051834e+17,61,299,4.901639344262295,2,8,60,1
8.578541752342844e+17,52,263,5.0576923076923075,2,8,51,1
8.578783564123703e+17,4,8,2.0,1,3,4,0
8.57896855823261e+17,79,159,2.0126582278481013,1,4,79,0
8.57908678811988e+17,131,646,4.931297709923665,2,8,128,3
8.579187785245719e+17,70,681,9.728571428571428,3,12,4,66
8.579490974536891e+17,170,1161,6.829411764705882,2,11,118,52
8.579503656321659e+17,26,123,4.730769230769231,2,7,26,0
8.579861537765088e+17,12,30,2.5,1,4,12,0
8.580561324369057e+17,16,65,4.0625,3,7,16,0
8.583205931411484e+17,49,205,4.183673469387755,2,6,49,0
8.583764306765535e+17,20,43,2.15,1,3,20,0
8.584095982773793e+17,52,351,6.75,2,9,38,14
8.584254856804461e+17,9,43,4.777777777777778,2,7,9,0
8.584359734107762e+17,7,14,2.0,1,4,7,0
8.58520749594844e+17,4,12,3.0,2,4,4,0
8.585660876964015e+17,123,1147,9.325203252032521,2,12,11,112
8.58610010981399e+17,24,44,1.8333333333333333,1,3,24,0
8.586289256845513e+17,32,67,2.09375,1,4,32,0
8.586318295323731e+17,99,788,7.959595959595959,5,11,28,71
8.586470428434065e+17,5,9,1.8,1,3,5,0
8.58691234795569e+17,74,376,5.081081081081081,2,8,73,1
8.587036064470656e+17,16,34,2.125,1,4,16,0
8.587139116342601e+17,68,140,2.0588235294117645,1,6,68,0
8.587489405453037e+17,66,331,5.015151515151516,3,8,65,1
8.58751650689394e+17,25,53,2.12,1,4,25,0
8.587807333837057e+17,14,27,1.9285714285714286,1,4,14,0
8.587982489558671e+17,3,7,2.3333333333333335,1,3,3,0
8.590578905532983e+17,58,399,6.879310344827586,3,9,42,16
8.590729876465695e+17,55,219,3.981818181818182,2,7,55,0
8.590734440753821e+17,55,279,5.072727272727272,1,9,52,3
8.591096011677416e+17,6,42,7.0,6,8,5,1
8.591476431387378e+17,22,44,2.0,1,5,22,0
8.591556520597541e+17,145,716,4.937931034482759,2,9,143,2
8.591748760308148e+17,1,3,3.0,3,3,1,0
8.592222983090049e+17,8,50,6.25,4,8,7,1
8.592819800745576e+17,35,179,5.114285714285714,3,7,35,0
8.592883221027247e+17,7,33,4.714285714285714,3,7,7,0
8.592996950715082e+17,9,47,5.222222222222222,2,8,8,1
8.593924487402596e+17,89,841,9.44943820224719,2,13,11,78
8.595112886435004e+17,25,238,9.52,4,11,1,24
8.59512781974675e+17,5,14,2.8,2,4,5,0
8.596081509168026e+17,43,413,9.604651162790697,3,12,5,38
8.598354710907401e+17,47,187,3.978723404255319,2,7,47,0
8.598882021458152e+17,34,328,9.647058823529411,2,12,2,32
8.59907678657422e+17,13,30,2.3076923076923075,1,4,13,0
8.599668732956717e+17,111,229,2.063063063063063,1,5,111,0
8.599837880655506e+17,21,146,6.9523809523809526,5,8,14,7
8.600008319181843e+17,6,44,7.333333333333333,6,8,3,3
8.600031862958528e+17,81,243,3.0,1,5,81,0
8.600766599773176e+17,3,21,7.0,6,8,2,1
8.601143606572803e+17,17,143,8.411764705882353,7,10,4,13
8.601304389701827e+17,122,466,3.819672131147541,1,6,122,0
8.602821526019361e+17,21,48,2.2857142857142856,1,4,21,0
8.60296256902116e+17,1,2,2.0,2,2,1,0
8.602993909982542e+17,80,474,5.925,3,8,75,5
8.603086123163464e+17,4,10,2.5,1,4,4,0
8.605367299745888e+17,123,346,2.813008130081301,1,5,123,0
8.606076962318244e+17,51,331,6.490196078431373,2,8,40,11
8.606089082938943e+17,7,24,3.4285714285714284,1,5,7,0
8.606511500385565e+17,105,502,4.780952380952381,2,7,105,0
8.606571177582184e+17,2,5,2.5,2,3,2,0
8.606597849712308e+17,6,42,7.0,3,9,3,3
8.607053023428407e+17,27,105,3.888888888888889,2,7,27,0
8.607514675190787e+17,16,142,8.875,7,10,2,14
8.607873697289622e+17,14,35,2.5,1,5,14,0
8.607874163744372e+17,12,26,2.1666666666666665,1,3,12,0
8.607874272131954e+17,19,132,6.947368421052632,4,10,12,7
8.607874914525879e+17,27,220,8.148148148148149,6,10,9,18
8.608062781384911e+17,10,25,2.5,1,5,10,0
8.608521240697855e+17,53,533,10.056603773584905,7,12,1,52
8.609022891948398e+17,126,622,4.936507936507937,2,8,125,1
8.609300689121126e+17,17,113,6.647058823529412,3,8,13,4
8.609853428175677e+17,5,29,5.8,5,7,5,0
8.6122841393226e+17,38,77,2.026315789473684,1,4,38,0
8.612334454136438e+17,57,289,5.0701754385964914,3,8,56,1
8.613043200157605e+17,81,335,4.135802469135802,2,6,81,0
8.613486983874944e+17,2,3,1.5,1,2,2,0
8.613681185171707e+17,46,408,8.869565217391305,2,11,5,41
8.613717565159828e+17,54,201,3.7222222222222223,2,6,54,0
8.613719474583295e+17,5,35,7.0,6,8,4,1
8.613794337284179e+17,84,119,1.4166666666666667,1,3,84,0
8.61384733706924e+17,99,137,1.3838383838383839,1,4,99,0
8.614403716657676e+17,11,92,8.363636363636363,2,10,2,9
8.614438387292868e+17,50,498,9.96,5,12,1,49
8.614739355739188e+17,71,669,9.422535211267606,2,13,7,64
8.61532011358773e+17,12,129,10.75,10,13,0,12
8.615725833000877e+17,14,33,2.357142857142857,1,4,14,0
8.61600157068238e+17,58,121,2.086206896551724,1,4,58,0
8.616299892529618e+17,4,12,3.0,2,5,4,0
8.61644902197541e+17,79,389,4.924050632911392,2,8,78,1
8.616544301796278e+17,79,407,5.151898734177215,2,7,79,0
8.616654310832444e+17,45,216,4.8,2,7,45,0
8.617139287757577e+17,19,88,4.631578947368421,2,6,19,0
8.617285183436355e+17,131,271,2.068702290076336,1,5,131,0
8.61981516135257e+17,16,113,7.0625,3,9,9,7
8.619846455707638e+17,20,136,6.8,4,10,13,7
8.619995677125627e+17,46,139,3.0217391304347827,1,6,46,0
8.620091551407265e+17,88,356,4.045454545454546,2,6,88,0
8.620992285135821e+17,4,41,10.25,9,12,0,4
8.62151514102258e+17,25,242,9.68,6,12,2,23
8.621963647074714e+17,4,19,4.75,4,5,4,0
8.622309903637372e+17,14,66,4.714285714285714,4,6,14,0
8.622349179717545e+17,99,474,4.787878787878788,2,8,98,1
8.622469463531437e+17,70,618,8.82857142857143,2,12,7,63
8.622577952121641e+17,74,162,2.189189189189189,1,4,74,0
8.622695583423658e+17,2,5,2.5,2,3,2,0
8.622955193280397e+17,12,99,8.25,6,10,3,9
8.623060682478276e+17,5,35,7.0,4,8,2,3
8.623062990367592e+17,7,24,3.4285714285714284,3,4,7,0
8.623276890771018e+17,15,45,3.0,1,4,15,0
8.623411374392023e+17,7,20,2.857142857142857,2,4,7,0
8.626301547452581e+17,95,208,2.1894736842105265,1,5,95,0
8.627021348398938e+17,96,486,5.0625,2,8,95,1
8.627055982448159e+17,51,263,5.1568627450980395,3,7,51,0
8.627152416598035e+17,129,1266,9.813953488372093,3,13,6,123
8.627231736157614e+17,90,455,5.055555555555555,3,7,90,0
8.627287543240182e+17,76,385,5.065789473684211,2,7,76,0
8.627312999080675e+17,146,303,2.0753424657534247,1,5,146,0
8.627368449764918e+17,108,1061,9.824074074074074,4,12,6,102
8.627528415330529e+17,2,13,6.5,4,9,1,1
8.627776173974237e+17,83,791,9.53012048192771,2,12,10,73
8.627813074325076e+17,6,7,1.1666666666666667,1,2,6,0
8.627824431472641e+17,30,292,9.733333333333333,6,11,3,27
8.628101539264108e+17,5,39,7.8,7,9,2,3
8.628300084445233e+17,1,3,3.0,3,3,1,0
8.628424163323802e+17,10,99,9.9,9,11,0,10
8.628677754505526e+17,49,491,10.020408163265307,7,11,1,48
8.628815653499183e+17,69,95,1.3768115942028984,1,4,69,0
8.628873910669427e+17,4,26,6.5,6,7,4,0
8.629005776271542e+17,68,473,6.955882352941177,4,9,45,23
8.629421824403743e+17,10,73,7.3,6,9,6,4
8.629459876421162e+17,26,178,6.846153846153846,3,8,17,9
8.629858088358874e+17,1,8,8.0,8,8,0,1
8.630375492200628e+17,14,60,4.285714285714286,2,7,14,0
8.630424449996352e+17,5,10,2.0,1,3,5,0
8.631421513917791e+17,34,161,4.735294117647059,2,6,34,0
8.631591887004093e+17,25,188,7.52,3,10,10,15
8.634166901411886e+17,177,373,2.1073446327683616,1,5,177,0
8.634327288471828e+17,14,108,7.714285714285714,6,9,5,9
8.634410082329738e+17,46,265,5.760869565217392,3,8,44,2
8.634688275571098e+17,81,783,9.666666666666666,4,12,4,77
8.634706886357093e+17,4,8,2.0,1,3,4,0
8.634734694942601e+17,4,13,3.25,3,4,4,0
8.634790334899241e+17,80,785,9.8125,3,13,3,77
8.635012182807552e+17,72,345,4.791666666666667,2,7,72,0
8.635203711903684e+17,65,251,3.8615384615384616,2,7,65,0
8.635485663478958e+17,156,1509,9.673076923076923,3,12,12,144
8.6356718889444e+17,117,595,5.085470085470085,2,9,115,2
8.635786315493492e+17,8,33,4.125,2,5,8,0
8.635873563937001e+17,128,492,3.84375,1,6,128,0
8.636095996771434e+17,104,702,6.75,2,9,78,26
8.636206062832329e+17,48,237,4.9375,2,7,48,0
8.636522853488404e+17,3,31,10.333333333333334,9,11,0,3
8.636768202521656e+17,12,38,3.1666666666666665,2,5,12,0
8.637425864818902e+17,157,474,3.0191082802547773,1,6,157,0
8.637453437701057e+17,52,504,9.692307692307692,2,12,4,48
8.638140619098043e+17,43,175,4.069767441860465,2,6,43,0
8.641368846585385e+17,27,182,6.7407407407407405,4,8,21,6
8.642334985310721e+17,12,23,1.9166666666666667,1,3,12,0
8.642485364197032e+17,9,67,7.444444444444445,5,8,3,6
8.642494575164842e+17,16,130,8.125,6,11,4,12
8.642999635212824e+17,62,122,1.967741935483871,1,3,62,0
8.643130224830922e+17,1,8,8.0,8,8,0,1
8.643597689379894e+17,83,184,2.216867469879518,1,5,83,0
8.644265277654181e+17,94,195,2.074468085106383,1,4,94,0
8.645083206308132e+17,18,119,6.611111111111111,2,9,13,5
8.645173438611667e+17,7,55,7.857142857142857,6,9,2,5
8.646765784809007e+17,17,131,7.705882352941177,6,11,8,9
8.649045434139855e+17,41,378,9.21951219512195,2,12,5,36
8.650512966042604e+17,9,81,9.0,8,10,0,9
8.650721338494484e+17,94,192,2.0425531914893615,1,5,94,0
8.650952345633418e+17,85,421,4.952941176470588,2,7,85,0
8.653189590731286e+17,77,386,5.012987012987013,2,7,77,0
8.655703334338173e+17,30,289,9.633333333333333,2,12,2,28
8.655822762147768e+17,29,57,1.9655172413793103,1,4,29,0
8.657677448493586e+17,18,106,5.888888888888889,3,8,17,1
8.658011989596603e+17,26,198,7.615384615384615,3,11,12,14
8.658124845915301e+17,2,7,3.5,3,4,2,0
8.658974354543142e+17,3,5,1.6666666666666667,1,2,3,0
8.659165135750364e+17,6,21,3.5,2,4,6,0
8.659268736514913e+17,38,362,9.526315789473685,2,12,3,35
8.659413982808873e+17,52,222,4.269230769230769,2,7,52,0
8.66157418444286e+17,6,44,7.333333333333333,3,9,2,4
8.663173773930844e+17,57,463,8.12280701754386,6,11,16,41
8.663540631664773e+17,6,11,1.8333333333333333,1,3,6,0
8.663636185554323e+17,5,35,7.0,5,9,4,1
8.663647657210808e+17,27,59,2.185185185185185,1,5,27,0
8.663921341320992e+17,30,256,8.533333333333333,2,11,4,26
8.664166885724724e+17,42,277,6.595238095238095,2,9,29,13
8.664345443894821e+17,90,702,7.8,3,11,31,59
8.664494001001626e+17,7,32,4.571428571428571,3,6,7,0
8.665564218021466e+17,13,17,1.3076923076923077,1,3,13,0
8.665749431330898e+17,20,121,6.05,5,8,18,2
8.665927708013316e+17,52,267,5.134615384615385,2,9,51,1
8.665986865614688e+17,1,5,5.0,5,5,1,0
8.666728793282012e+17,91,617,6.78021978021978,4,10,66,25
8.666935160983514e+17,9,65,7.222222222222222,6,9,5,4
8.667153777888026e+17,1,7,7.0,7,7,1,0
8.667487755032091e+17,57,162,2.8421052631578947,1,5,57,0
8.667709637444836e+17,185,380,2.054054054054054,1,5,185,0
8.66999648673593e+17,5,32,6.4,6,8,4,1
8.670120752202505e+17,19,122,6.421052631578948,3,9,14,5
8.670466857935729e+17,33,308,9.333333333333334,7,11,2,31
8.671288140369228e+17,33,64,1.9393939393939394,1,4,33,0
8.672174106246776e+17,67,636,9.492537313432836,3,12,4,63
8.672275937405527e+17,6,46,7.666666666666667,5,9,2,4
8.672408062289329e+17,18,84,4.666666666666667,2,7,18,0
8.672531258572058e+17,50,206,4.12,2,6,50,0
8.672608524129837e+17,4,25,6.25,2,9,3,1
8.673154759456202e+17,22,179,8.136363636363637,6,10,6,16
8.673200841523325e+17,4,35,8.75,8,10,0,4
8.673285117550833e+17,44,304,6.909090909090909,2,10,30,14
8.67328749692376e+17,20,130,6.5,3,9,15,5
8.67340719553654e+17,119,583,4.899159663865547,2,8,118,1
8.673511518698778e+17,14,67,4.785714285714286,3,6,14,0
8.673713673017644e+17,36,113,3.138888888888889,1,5,36,0
8.674385782778499e+17,2,18,9.0,9,9,0,2
8.674899367944102e+17,2,4,2.0,2,2,2,0
8.677824911557079e+17,30,208,6.933333333333334,5,9,21,9
8.677838024150592e+17,5,22,4.4,3,6,5,0
8.679133832192812e+17,24,218,9.083333333333334,7,11,1,23
8.679201917938012e+17,2,16,8.0,8,8,0,2
8.67977661799998e+17,55,379,6.890909090909091,3,9,38,17
8.680287405441239e+17,6,10,1.6666666666666667,1,3,6,0
8.680335125340172e+17,3,5,1.6666666666666667,1,3,3,0
8.680502850541115e+17,129,187,1.449612403100775,1,4,129,0
8.680615968006171e+17,92,448,4.869565217391305,3,7,92,0
8.680697893527946e+17,10,50,5.0,4,6,10,0
8.681428224891796e+17,6,57,9.5,6,12,1,5
8.68152018237556e+17,81,788,9.728395061728396,3,12,3,78
8.684642104628183e+17,4,12,3.0,2,4,4,0
8.68531576895534e+17,83,420,5.0602409638554215,3,7,83,0
8.685431091071386e+17,45,145,3.2222222222222223,1,6,45,0
8.685442544319334e+17,27,58,2.1481481481481484,1,3,27,0
8.685602174212143e+17,60,245,4.083333333333333,2,6,60,0
8.685662127860535e+17,7,18,2.5714285714285716,2,3,7,0
8.685716344014143e+17,8,20,2.5,1,5,8,0
8.685783640239043e+17,51,111,2.176470588235294,1,4,51,0
8.685790589668776e+17,13,30,2.3076923076923075,1,4,13,0
8.685796281075795e+17,22,46,2.090909090909091,1,4,22,0
8.685801417318259e+17,24,52,2.1666666666666665,1,4,24,0
8.685813596807382e+17,31,62,2.0,1,3,31,0
8.685819095709595e+17,49,108,2.204081632653061,1,5,49,0
8.685824263232225e+17,35,66,1.8857142857142857,1,4,35,0
8.685826822700156e+17,13,91,7.0,2,9,9,4
8.685831937370396e+17,46,96,2.0869565217391304,1,4,46,0
8.685846691545724e+17,42,73,1.7380952380952381,1,4,42,0
8.685853313144499e+17,23,53,2.3043478260869565,1,5,23,0
8.68585784571632e+17,57,116,2.0350877192982457,1,4,57,0
8.685864305149354e+17,10,24,2.4,1,4,10,0
8.685870174245568e+17,53,114,2.150943396226415,1,4,53,0
8.685876213174401e+17,34,66,1.9411764705882353,1,4,34,0
8.685882436870235e+17,26,61,2.3461538461538463,1,4,26,0
8.685889044137082e+17,48,98,2.0416666666666665,1,4,48,0
8.685894981228214e+17,36,80,2.2222222222222223,1,5,36,0
8.685901301858248e+17,51,108,2.1176470588235294,1,5,51,0
8.686657632183182e+17,97,681,7.020618556701031,4,10,66,31
8.686755638746272e+17,11,95,8.636363636363637,7,11,2,9
8.68698113135622e+17,2,15,7.5,7,8,1,1
8.687122425439164e+17,30,287,9.566666666666666,8,13,0,30
8.687237164009051e+17,101,690,6.8316831683168315,2,9,77,24
8.687255208089953e+17,12,24,2.0,1,3,12,0
8.687641625927954e+17,15,110,7.333333333333333,5,9,9,6
8.687655312912191e+17,18,175,9.722222222222221,7,12,1,17
8.687806450469882e+17,61,239,3.918032786885246,2,7,61,0
8.688104596487521e+17,38,82,2.1578947368421053,1,4,38,0
8.688106079804338e+17,57,114,2.0,1,5,57,0
8.68810742206955e+17,43,99,2.302325581395349,1,4,43,0
8.688109646014743e+17,58,111,1.9137931034482758,1,4,58,0
8.688110722802514e+17,40,83,2.075,1,4,40,0
8.688467377904808e+17,127,1100,8.661417322834646,2,11,15,112
8.692368032162707e+17,161,1546,9.602484472049689,3,12,12,149
8.692847769707379e+17,90,195,2.1666666666666665,1,5,90,0
8.692912318685586e+17,14,72,5.142857142857143,4,7,14,0
8.692951633066856e+17,6,25,4.166666666666667,3,5,6,0
8.692983438360465e+17,2,3,1.5,1,2,2,0
8.693148961347203e+17,38,147,3.8684210526315788,2,6,38,0
8.693187678301069e+17,27,211,7.814814814814815,4,11,11,16
8.694215546598917e+17,12,19,1.5833333333333333,1,2,12,0
8.69547740597923e+17,106,828,7.811320754716981,3,10,44,62
8.695642561742629e+17,8,55,6.875,2,10,5,3
8.699780759898346e+17,7,70,10.0,8,11,0,7
8.700139501746253e+17,14,74,5.285714285714286,3,7,14,0
8.700812315197484e+17,15,135,9.0,2,12,1,14
8.700959692865804e+17,77,155,2.012987012987013,1,4,77,0
8.70106877567996e+17,6,44,7.333333333333333,6,9,3,3
8.701171914872854e+17,13,15,1.1538461538461537,1,2,13,0
8.701312188857092e+17,11,15,1.3636363636363635,1,3,11,0
8.701352943567967e+17,19,62,3.263157894736842,2,5,19,0
8.701468607818628e+17,59,568,9.627118644067796,5,12,3,56
8.70215106520985e+17,112,889,7.9375,2,10,36,76
8.70270932231473e+17,4,31,7.75,7,8,1,3
8.707003484202468e+17,88,839,9.534090909090908,2,12,7,81
8.707712068970953e+17,4,13,3.25,3,4,4,0
8.707840407665422e+17,76,309,4.065789473684211,2,7,76,0
8.708126134343557e+17,113,473,4.185840707964601,1,6,113,0
8.709300432339753e+17,143,701,4.9020979020979025,2,7,143,0
8.714694534030506e+17,27,51,1.8888888888888888,1,4,27,0
8.715022411963854e+17,85,123,1.4470588235294117,1,4,85,0
8.716598836303942e+17,26,163,6.269230769230769,3,8,24,2
8.716805266936369e+17,80,465,5.8125,2,8,76,4
8.716881720549248e+17,21,29,1.380952380952381,1,3,21,0
8.716889898905914e+17,77,728,9.454545454545455,2,12,7,70
8.716983969323478e+17,2,5,2.5,2,3,2,0
8.717327980757012e+17,64,251,3.921875,1,6,64,0
8.717524174581934e+17,8,58,7.25,6,8,4,4
8.717626217539391e+17,35,171,4.885714285714286,3,7,35,0
8.717723121757001e+17,7,8,1.1428571428571428,1,2,7,0
8.718099726194107e+17,13,61,4.6923076923076925,2,6,13,0
8.72095178864209e+17,39,110,2.8205128205128207,1,5,39,0
8.7213832617862e+17,16,107,6.6875,5,8,14,2
8.72169624643922e+17,42,347,8.261904761904763,2,11,11,31
8.721808499639145e+17,76,164,2.1578947368421053,1,4,76,0
8.721825850929501e+17,34,106,3.1176470588235294,2,6,34,0
8.721846241029612e+17,89,439,4.932584269662922,2,8,88,1
8.722143908299777e+17,31,267,8.612903225806452,2,11,2,29
8.722284545484748e+17,16,54,3.375,2,5,16,0
8.722342514613009e+17,4,11,2.75,2,3,4,0
8.722405317992093e+17,20,197,9.85,8,11,0,20
8.722446490074412e+17,5,7,1.4,1,3,5,0
8.722538047411168e+17,34,96,2.823529411764706,1,5,34,0
8.72256715144503e+17,164,1140,6.951219512195122,2,9,107,57
8.722630453671707e+17,9,44,4.888888888888889,4,7,9,0
8.722798686181545e+17,117,795,6.794871794871795,2,10,78,39
8.722806673448544e+17,39,257,6.589743589743589,4,8,31,8
8.723018976986266e+17,69,669,9.695652173913043,4,12,5,64
8.723194154124086e+17,15,94,6.266666666666667,3,8,11,4
8.723473608063528e+17,4,8,2.0,1,3,4,0
8.723506075696765e+17,2,7,3.5,3,4,2,0
8.723520413670387e+17,5,10,2.0,1,3,5,0
8.723727814049135e+17,5,11,2.2,2,3,5,0
8.723840793240851e+17,2,3,1.5,1,2,2,0
8.72388569523412e+17,8,19,2.375,1,3,8,0
8.723926229910723e+17,5,22,4.4,3,5,5,0
8.723939019739855e+17,10,18,1.8,1,3,10,0
8.723989601067503e+17,1,1,1.0,1,1,1,0
8.72401136705191e+17,8,15,1.875,1,4,8,0
8.724180878470824e+17,26,176,6.769230769230769,2,9,20,6
8.724308977416603e+17,46,131,2.847826086956522,1,5,46,0
8.724414750326065e+17,30,118,3.933333333333333,2,6,30,0
8.7249894170518e+17,128,627,4.8984375,2,8,127,1
8.725165634638674e+17,11,55,5.0,4,7,11,0
8.725464940572092e+17,13,85,6.538461538461538,4,9,11,2
8.725538166132087e+17,3,23,7.666666666666667,7,8,1,2
8.728067781049617e+17,1,7,7.0,7,7,1,0
8.729075029931361e+17,5,11,2.2,1,4,5,0
8.729093514389866e+17,8,22,2.75,1,4,8,0
8.729112681220364e+17,7,21,3.0,2,4,7,0
8.729295879381906e+17,1,1,1.0,1,1,1,0
8.729451423274629e+17,1,2,2.0,2,2,1,0
8.729493193532244e+17,43,215,5.0,3,7,43,0
8.729512761794478e+17,7,15,2.142857142857143,1,3,7,0
8.729653719458894e+17,2,5,2.5,2,3,2,0
8.729684060113911e+17,3,9,3.0,1,5,3,0
8.729730143339204e+17,4,8,2.0,1,3,4,0
8.729746356423607e+17,102,594,5.823529411764706,3,8,99,3
8.72975029989554e+17,2,6,3.0,2,4,2,0
8.729761243157271e+17,6,17,2.8333333333333335,1,5,6,0
8.729874773802828e+17,3,9,3.0,2,4,3,0
8.729920904875512e+17,65,331,5.092307692307692,3,8,64,1
8.730252331824259e+17,2,15,7.5,6,9,1,1
8.730303873045358e+17,1,4,4.0,4,4,1,0
8.730464369604424e+17,29,60,2.0689655172413794,1,4,29,0
8.730479053739666e+17,2,5,2.5,2,3,2,0
8.730828478559864e+17,96,385,4.010416666666667,1,6,96,0
8.73094490660041e+17,19,149,7.842105263157895,3,10,8,11
8.731027709091692e+17,10,51,5.1,4,6,10,0
8.731105582628116e+17,55,214,3.890909090909091,2,6,55,0
8.731595325258967e+17,110,1089,9.9,5,12,6,104
8.731738405616404e+17,3,6,2.0,1,3,3,0
8.73185501828172e+17,10,17,1.7,1,3,10,0
8.732067182567324e+17,51,482,9.450980392156863,2,12,4,47
8.732080259447677e+17,8,53,6.625,3,8,6,2
8.732615232193937e+17,2,11,5.5,5,6,2,0
8.735808345321347e+17,29,283,9.758620689655173,6,11,1,28
8.735934768399232e+17,64,323,5.046875,3,7,64,0
8.735961094068568e+17,8,21,2.625,2,3,8,0
8.73605448849963e+17,19,58,3.0526315789473686,1,5,19,0
8.736259135989065e+17,1,4,4.0,4,4,1,0
8.736338776788763e+17,28,171,6.107142857142857,5,9,27,1
8.736707687368582e+17,54,481,8.907407407407407,3,11,2,52
8.736782175369569e+17,4,6,1.5,1,3,4,0
8.736929319872806e+17,8,13,1.625,1,2,8,0
8.737055183242516e+17,48,339,7.0625,5,9,32,16
8.737144192488364e+17,82,120,1.4634146341463414,1,5,82,0
8.737304397054342e+17,58,456,7.862068965517241,4,10,21,37
8.7373375884638e+17,176,1685,9.573863636363637,2,12,12,164
8.737511086572192e+17,26,52,2.0,1,4,26,0
8.737647489799773e+17,71,690,9.71830985915493,5,12,2,69
8.737748786627948e+17,24,232,9.666666666666666,5,12,1,23
8.738880876940996e+17,41,119,2.902439024390244,1,5,41,0
8.73899665513591e+17,11,24,2.1818181818181817,1,4,11,0
8.739193087772749e+17,13,49,3.769230769230769,2,5,13,0
8.743170467471228e+17,12,112,9.333333333333334,8,11,0,12
8.743390069500403e+17,1,6,6.0,6,6,1,0
8.743418367861906e+17,72,711,9.875,4,14,4,68
8.743485169589665e+17,1,6,6.0,6,6,1,0
8.743609723855398e+17,60,181,3.0166666666666666,1,5,60,0
8.743743814794734e+17,68,331,4.867647058823529,3,7,68,0
8.744009672019675e+17,15,148,9.866666666666667,8,11,0,15
8.744085109072691e+17,46,314,6.826086956521739,4,9,34,12
8.744177752398134e+17,31,97,3.129032258064516,1,5,31,0
8.744206433627145e+17,41,399,9.731707317073171,2,12,1,40
8.74421826708763e+17,2,16,8.0,8,8,0,2
8.744352857997971e+17,3,10,3.3333333333333335,2,5,3,0
8.74451917973542e+17,75,681,9.08,5,12,6,69
8.744520640705619e+17,52,490,9.423076923076923,2,13,6,46
8.745621519582383e+17,36,53,1.4722222222222223,1,3,36,0
8.745686052319227e+17,53,449,8.471698113207546,2,11,8,45
8.745718541289102e+17,48,153,3.1875,1,6,48,0
8.746498462336768e+17,6,15,2.5,1,4,6,0
8.746952097175337e+17,8,15,1.875,1,4,8,0
8.747194842242377e+17,7,22,3.142857142857143,2,5,7,0
8.749404271580449e+17,17,167,9.823529411764707,8,12,0,17
8.749878011993056e+17,13,18,1.3846153846153846,1,3,13,0
8.750862851387485e+17,2,6,3.0,3,3,2,0
8.752289060217228e+17,41,199,4.853658536585366,3,7,41,0
8.752444448721906e+17,82,783,9.548780487804878,2,12,6,76
8.752553489587272e+17,2,3,1.5,1,2,2,0
8.75270837202376e+17,6,47,7.833333333333333,7,8,1,5
8.752941691510765e+17,1,4,4.0,4,4,1,0
8.753145590664607e+17,32,156,4.875,3,7,32,0
8.758876579331557e+17,75,582,7.76,3,10,26,49
8.759376195942396e+17,19,166,8.736842105263158,7,11,2,17
8.759519602138614e+17,1,7,7.0,7,7,1,0
8.760150439923092e+17,32,68,2.125,1,4,32,0
8.760557203784808e+17,12,35,2.9166666666666665,2,4,12,0
8.760657482795839e+17,50,485,9.7,4,12,2,48
8.76078333921243e+17,31,129,4.161290322580645,2,6,31,0
8.761086620736975e+17,100,596,5.96,2,9,94,6
8.761335047203112e+17,86,270,3.13953488372093,1,6,86,0
8.761362521134652e+17,123,484,3.934959349593496,1,6,123,0
8.761450480965513e+17,22,112,5.090909090909091,3,7,22,0
8.762722091228489e+17,71,362,5.098591549295775,2,7,71,0
8.765079645557581e+17,9,18,2.0,1,3,9,0
8.765306775009416e+17,16,26,1.625,1,3,16,0
8.765320172621916e+17,38,146,3.8421052631578947,2,6,38,0
8.765502886055977e+17,63,438,6.9523809523809526,3,9,42,21
8.765507849527305e+17,72,148,2.0555555555555554,1,4,72,0
8.765542552457911e+17,3,12,4.0,3,5,3,0
8.765569714031892e+17,14,19,1.3571428571428572,1,2,14,0
8.76576275269958e+17,4,25,6.25,5,8,3,1
8.76576421705672e+17,48,146,3.0416666666666665,1,6,48,0
8.765783113426844e+17,107,924,8.63551401869159,4,12,16,91
8.765849850831747e+17,58,123,2.1206896551724137,1,4,58,0
8.76606434693266e+17,49,244,4.979591836734694,2,8,48,1
8.766208396042484e+17,2,3,1.5,1,2,2,0
8.766485851752063e+17,12,83,6.916666666666667,5,8,9,3
8.766625692320285e+17,2,5,2.5,2,3,2,0
8.766759295668924e+17,3,23,7.666666666666667,6,9,1,2
8.767074440920301e+17,7,50,7.142857142857143,2,9,2,5
8.767330199157234e+17,103,1007,9.776699029126213,2,12,7,96
8.767463613657823e+17,43,290,6.744186046511628,3,9,31,12
8.768152788126359e+17,36,234,6.5,2,9,29,7
8.768209791812654e+17,5,18,3.6,2,5,5,0
8.768493295623772e+17,13,38,2.923076923076923,2,4,13,0
8.768825573653672e+17,32,67,2.09375,1,5,32,0
8.769150885607101e+17,3,6,2.0,1,3,3,0
8.772342520154461e+17,2,14,7.0,7,7,2,0
8.772425859127761e+17,47,457,9.72340425531915,3,12,2,45
8.772485889768195e+17,34,301,8.852941176470589,6,11,4,30
8.772652537627572e+17,220,1852,8.418181818181818,2,11,33,187
8.772655845009046e+17,71,482,6.788732394366197,3,10,54,17
8.772921294120956e+17,1,7,7.0,7,7,1,0
8.772924792823684e+17,1,2,2.0,2,2,1,0
8.772943373063734e+17,6,45,7.5,6,10,3,3
8.77301058575637e+17,8,41,5.125,4,7,8,0
8.773343571701194e+17,3,14,4.666666666666667,3,6,3,0
8.773395156548229e+17,9,67,7.444444444444445,6,9,4,5
8.773430812296387e+17,40,119,2.975,1,5,40,0
8.773434033334597e+17,1,4,4.0,4,4,1,0
8.773482035991483e+17,2,10,5.0,5,5,2,0
8.773535859133841e+17,31,73,2.3548387096774195,1,4,31,0
8.773689207992448e+17,1,9,9.0,9,9,0,1
8.773819468983914e+17,6,14,2.3333333333333335,2,3,6,0
8.773826531793609e+17,7,41,5.857142857142857,4,7,7,0
8.773857029237043e+17,8,59,7.375,2,9,3,5
8.774043536210308e+17,1,3,3.0,3,3,1,0
8.774213395902373e+17,11,79,7.181818181818182,2,10,6,5
8.774247084308831e+17,49,388,7.918367346938775,6,11,17,32
8.774643917504421e+17,126,278,2.2063492063492065,1,5,126,0
8.774739912078684e+17,2,6,3.0,2,4,2,0
8.774746186383891e+17,5,30,6.0,4,8,4,1
8.774977203960566e+17,3,8,2.6666666666666665,2,3,3,0
8.776075441104946e+17,3,8,2.6666666666666665,2,4,3,0
8.776130352895267e+17,36,256,7.111111111111111,5,9,22,14
8.780287766506212e+17,10,71,7.1,6,8,8,2
8.780750765500372e+17,15,77,5.133333333333334,3,7,15,0
8.781190748717933e+17,9,59,6.555555555555555,5,9,8,1
8.781238717113916e+17,17,87,5.117647058823529,3,6,17,0
8.781433794464013e+17,102,964,9.450980392156863,3,12,10,92
8.781476537429797e+17,13,16,1.2307692307692308,1,2,13,0
8.781558664189989e+17,26,128,4.923076923076923,3,7,26,0
8.781563537053701e+17,79,401,5.075949367088608,3,7,79,0
8.78190048503525e+17,1,8,8.0,8,8,0,1
8.782002938865687e+17,4,30,7.5,6,9,2,2
8.7821210405551e+17,7,14,2.0,1,3,7,0
8.782314853313636e+17,2,2,1.0,1,1,2,0
8.782324081600767e+17,6,10,1.6666666666666667,1,3,6,0
8.78255644060317e+17,3,9,3.0,3,3,3,0
8.782642957972596e+17,6,19,3.1666666666666665,2,5,6,0
8.782676857297907e+17,1,9,9.0,9,9,0,1
8.782825591091923e+17,14,30,2.142857142857143,1,4,14,0
8.782949261960328e+17,99,200,2.0202020202020203,1,4,99,0
8.783019097079945e+17,16,96,6.0,2,8,13,3
8.786460866818756e+17,17,144,8.470588235294118,2,10,2,15
8.7867412487805e+17,89,446,5.01123595505618,2,7,89,0
8.786836110746592e+17,10,101,10.1,8,12,0,10
8.786880332750931e+17,1,9,9.0,9,9,0,1
8.787556258747764e+17,106,700,6.60377358490566,2,9,74,32
8.787565737067485e+17,9,67,7.444444444444445,5,9,3,6
8.787568874616978e+17,43,92,2.13953488372093,1,4,43,0
8.788031968804978e+17,12,81,6.75,4,9,10,2
8.788039738682478e+17,82,417,5.085365853658536,2,8,81,1
8.788078287071887e+17,3,4,1.3333333333333333,1,2,3,0
8.788134200431557e+17,5,13,2.6,1,4,5,0
8.788229854038382e+17,44,96,2.1818181818181817,1,4,44,0
8.788633477832884e+17,37,363,9.81081081081081,7,12,1,36
8.78993701449532e+17,12,93,7.75,7,9,4,8
8.790285241189848e+17,148,755,5.101351351351352,2,9,147,1
8.790628996833587e+17,136,1326,9.75,2,13,7,129
8.790671004064699e+17,25,46,1.84,1,3,25,0
8.793732908886383e+17,114,467,4.0964912280701755,1,7,114,0
8.794668943320238e+17,7,26,3.7142857142857144,3,5,7,0
8.795060682556129e+17,4,15,3.75,3,5,4,0
8.795145573379715e+17,112,238,2.125,1,5,112,0
8.795483456454184e+17,43,414,9.627906976744185,2,12,2,41
8.795658564679653e+17,1,1,1.0,1,1,1,0
8.7956697555578e+17,26,195,7.5,3,10,12,14
8.795699637431843e+17,7,64,9.142857142857142,3,12,1,6
8.795740080924522e+17,12,122,10.166666666666666,8,11,0,12
8.795866713834559e+17,2,15,7.5,7,8,1,1
8.798020883331194e+17,48,140,2.9166666666666665,1,6,48,0
8.801227850729297e+17,13,102,7.846153846153846,6,9,5,8
8.801284611853089e+17,19,191,10.052631578947368,4,12,1,18
8.801615136003689e+17,18,89,4.944444444444445,2,6,18,0
8.801748117506524e+17,18,169,9.38888888888889,6,11,1,17
8.801971919744452e+17,9,57,6.333333333333333,5,8,8,1
8.802051343390442e+17,6,15,2.5,1,4,6,0
8.802051409360138e+17,10,17,1.7,1,3,10,0
8.802096380160988e+17,23,181,7.869565217391305,2,10,7,16
8.8024180970152e+17,61,423,6.934426229508197,3,9,41,20
8.802605529501183e+17,180,364,2.022222222222222,1,5,180,0
8.802607071298253e+17,77,533,6.922077922077922,4,9,55,22
8.802649811127082e+17,60,407,6.783333333333333,2,9,42,18
8.803065717642372e+17,11,82,7.454545454545454,3,10,5,6
8.803147903447683e+17,6,42,7.0,3,9,3,3
8.803330586798228e+17,25,115,4.6,2,7,25,0
8.803981587759538e+17,16,49,3.0625,1,4,16,0
8.804247501345714e+17,29,89,3.0689655172413794,1,5,29,0
8.80505117438014e+17,21,44,2.0952380952380953,1,3,21,0
8.807951979078074e+17,6,35,5.833333333333333,4,7,6,0
8.808679606719828e+17,15,35,2.3333333333333335,1,4,15,0
8.808717608786067e+17,4,27,6.75,6,7,4,0
8.808735448174843e+17,49,140,2.857142857142857,1,6,49,0
8.808798920815654e+17,10,67,6.7,6,8,8,2
8.808876527812152e+17,10,72,7.2,5,9,6,4
8.808935046565304e+17,2,4,2.0,2,2,2,0
8.809232919093924e+17,83,410,4.9397590361445785,2,7,83,0
8.811132278535136e+17,10,26,2.6,1,5,10,0
8.811143697080728e+17,3,7,2.3333333333333335,2,3,3,0
8.811678106948492e+17,34,244,7.176470588235294,5,9,21,13
8.811904190716347e+17,14,140,10.0,9,11,0,14
8.812165514140394e+17,19,62,3.263157894736842,1,6,19,0
8.812293684248699e+17,24,117,4.875,3,7,24,0
8.812783060303978e+17,53,494,9.320754716981131,2,12,6,47
8.813135479075241e+17,12,68,5.666666666666667,2,8,11,1
8.815215387387058e+17,45,171,3.8,1,6,45,0
8.815462734897807e+17,12,64,5.333333333333333,4,7,12,0
8.815629014190285e+17,10,40,4.0,2,6,10,0
8.815991315324636e+17,39,74,1.8974358974358974,1,4,39,0
8.81606431285668e+17,97,935,9.639175257731958,2,12,6,91
8.816101695035372e+17,57,397,6.964912280701754,5,9,41,16
8.81655562211242e+17,26,173,6.653846153846154,4,9,20,6
8.817479177832204e+17,106,625,5.89622641509434,2,8,100,6
8.81796947187821e+17,19,97,5.105263157894737,3,7,19,0
8.818626471840787e+17,22,91,4.136363636363637,2,6,22,0
8.818822749471076e+17,112,990,8.839285714285714,2,12,12,100
8.819226090598698e+17,172,1623,9.436046511627907,2,14,14,158
8.819596962311004e+17,116,1006,8.672413793103448,2,11,13,103
8.819878428636485e+17,74,368,4.972972972972973,3,7,74,0
8.8227293733819e+17,17,134,7.882352941176471,6,10,6,11
8.822872174089635e+17,8,65,8.125,7,9,1,7
8.824155182731877e+17,22,45,2.0454545454545454,1,4,22,0
8.824577292282303e+17,6,40,6.666666666666667,6,7,6,0
8.824988913863584e+17,5,39,7.8,7,8,1,4
8.825469502307452e+17,8,25,3.125,1,5,8,0
8.825637375971613e+17,23,183,7.956521739130435,6,9,7,16
8.826333399629804e+17,79,527,6.670886075949367,3,8,60,19
8.826495763874931e+17,69,349,5.057971014492754,2,8,66,3
8.826558758096887e+17,6,15,2.5,1,5,6,0
8.82712339056988e+17,5,40,8.0,6,9,1,4
8.827551861896389e+17,31,60,1.935483870967742,1,4,31,0
8.829887295404132e+17,83,399,4.807228915662651,3,8,82,1
8.830381566256545e+17,55,527,9.581818181818182,2,12,3,52
8.830390866244812e+17,8,66,8.25,7,10,3,5
8.830399821363167e+17,1,4,4.0,4,4,1,0
8.830572097799648e+17,120,587,4.891666666666667,2,7,120,0
8.830608406220014e+17,35,49,1.4,1,3,35,0
8.830716143312036e+17,46,87,1.891304347826087,1,4,46,0
8.830726050673e+17,6,40,6.666666666666667,5,8,5,1
8.831088444023348e+17,49,429,8.755102040816327,4,11,6,43
8.831122263479919e+17,11,25,2.272727272727273,1,4,11,0
8.831347161733778e+17,1,3,3.0,3,3,1,0
8.831460556644928e+17,1,7,7.0,7,7,1,0
8.831468056259558e+17,1,11,11.0,11,11,0,1
8.831543221736712e+17,7,54,7.714285714285714,5,9,3,4
8.831771809358332e+17,28,224,8.0,2,10,7,21
8.831883564950781e+17,90,339,3.7666666666666666,2,6,90,0
8.831939199562961e+17,25,46,1.84,1,4,25,0
8.832302492534804e+17,3,22,7.333333333333333,6,8,1,2
8.832369127228145e+17,70,354,5.057142857142857,2,8,69,1
8.83255973989414e+17,26,183,7.038461538461538,5,10,19,7
8.83257777915256e+17,37,119,3.2162162162162162,1,5,37,0
8.832733487264143e+17,3,5,1.6666666666666667,1,2,3,0
8.832948921025687e+17,2,9,4.5,4,5,2,0
8.83322915564524e+17,45,445,9.88888888888889,8,12,0,45
8.833343068369404e+17,1,1,1.0,1,1,1,0
8.833585336566612e+17,10,100,10.0,9,12,0,10
8.833710865772511e+17,9,22,2.4444444444444446,1,4,9,0
8.834306700541367e+17,8,63,7.875,5,10,3,5
8.836153939734092e+17,39,236,6.051282051282051,4,9,34,5
8.837010486884965e+17,3,9,3.0,2,4,3,0
8.837341652098048e+17,4,7,1.75,1,3,4,0
8.83763892713675e+17,1,5,5.0,5,5,1,0
8.837677286962587e+17,23,220,9.565217391304348,8,11,0,23
8.837907104396077e+17,74,354,4.783783783783784,2,7,74,0
8.837929719560581e+17,8,15,1.875,1,3,8,0
8.838025135158555e+17,1,3,3.0,3,3,1,0
8.838025842632348e+17,88,120,1.3636363636363635,1,4,88,0
8.838050390297641e+17,1,6,6.0,6,6,1,0
8.838073567402906e+17,1,4,4.0,4,4,1,0
8.838101650198633e+17,3,11,3.6666666666666665,3,4,3,0
8.838174804587443e+17,1,5,5.0,5,5,1,0
8.838219749610113e+17,3,13,4.333333333333333,4,5,3,0
8.838255137204058e+17,1,6,6.0,6,6,1,0
8.838293144754365e+17,1,5,5.0,5,5,1,0
8.838348300106077e+17,4,22,5.5,5,6,4,0
8.838405989498044e+17,1,3,3.0,3,3,1,0
8.838767352109371e+17,4,7,1.75,1,2,4,0
8.838895738696396e+17,58,219,3.7758620689655173,2,6,58,0
8.839134167459429e+17,8,14,1.75,1,4,8,0
8.839549957947146e+17,48,255,5.3125,3,9,45,3
8.839869339809857e+17,3,16,5.333333333333333,3,7,3,0
8.839870080918726e+17,2,6,3.0,3,3,2,0
8.839924392747535e+17,29,286,9.862068965517242,7,12,1,28
8.840327420047258e+17,16,75,4.6875,3,6,16,0
8.84052359011137e+17,61,604,9.901639344262295,2,13,2,59
8.840984898845007e+17,16,154,9.625,3,14,2,14
8.841166069674382e+17,38,252,6.631578947368421,2,9,29,9
8.84161299601077e+17,91,799,8.780219780219781,4,11,14,77
8.841641585477353e+17,1,7,7.0,7,7,1,0
8.841651201092247e+17,16,106,6.625,5,8,14,2
8.84451520740649e+17,14,37,2.642857142857143,1,4,14,0
8.845070684955497e+17,2,8,4.0,4,4,2,0
8.845332942806913e+17,21,56,2.6666666666666665,1,5,21,0
8.845397581166153e+17,22,38,1.7272727272727273,1,4,22,0
8.845515111297606e+17,132,389,2.946969696969697,1,6,132,0
8.845641884373345e+17,57,88,1.543859649122807,1,4,57,0
8.845807439757897e+17,10,69,6.9,5,8,6,4
8.845818920442844e+17,65,97,1.4923076923076923,1,4,65,0
8.845876453717427e+17,68,92,1.3529411764705883,1,3,68,0
8.845944032183292e+17,48,70,1.4583333333333333,1,3,48,0
8.845971467096356e+17,62,233,3.7580645161290325,1,6,62,0
8.845990695441576e+17,38,48,1.263157894736842,1,3,38,0
8.846196983996507e+17,24,212,8.833333333333334,6,11,2,22
8.846496275796749e+17,27,111,4.111111111111111,3,6,27,0
8.846525872635613e+17,2,13,6.5,6,7,2,0
8.84714475337651e+17,32,318,9.9375,7,12,1,31
8.847168805124052e+17,71,363,5.112676056338028,2,7,71,0
8.847250845348142e+17,27,261,9.666666666666666,2,11,1,26
8.847439029229981e+17,6,43,7.166666666666667,2,9,2,4
8.847673152413852e+17,77,528,6.857142857142857,2,10,58,19
8.847677602826333e+17,90,436,4.844444444444444,2,7,90,0
8.848228587474113e+17,3,16,5.333333333333333,5,6,3,0
8.848783513097412e+17,15,146,9.733333333333333,5,12,1,14
8.849730073396833e+17,39,145,3.717948717948718,2,6,39,0
8.851236794400952e+17,30,206,6.866666666666666,2,9,23,7
8.851918026944646e+17,52,355,6.826923076923077,2,9,36,16
8.851993050468865e+17,8,64,8.0,7,9,2,6
8.85260507496818e+17,6,56,9.333333333333334,8,10,0,6
8.852615721470231e+17,45,183,4.066666666666666,2,6,45,0
8.853523450821367e+17,15,32,2.1333333333333333,1,4,15,0
8.85464587598318e+17,8,27,3.375,1,5,8,0
8.854844975063483e+17,11,30,2.727272727272727,1,5,11,0
8.854882210898636e+17,25,159,6.36,4,9,22,3
8.85524867955949e+17,2,5,2.5,2,3,2,0
8.855325506909751e+17,74,656,8.864864864864865,3,11,8,66
8.856259606088943e+17,13,87,6.6923076923076925,2,10,8,5
8.856367453386912e+17,2,17,8.5,8,9,0,2
8.858998976886497e+17,78,387,4.961538461538462,2,7,78,0
8.859009150686516e+17,27,105,3.888888888888889,2,6,27,0
8.859014431952146e+17,95,901,9.48421052631579,2,12,6,89
8.859235061576111e+17,99,924,9.333333333333334,2,12,9,90
8.85926225617886e+17,8,51,6.375,5,7,8,0
8.859483001157194e+17,4,13,3.25,3,4,4,0
8.860286527310079e+17,41,202,4.926829268292683,2,7,41,0
8.860849394098968e+17,3,24,8.0,6,10,1,2
8.861623548262993e+17,3,9,3.0,3,3,3,0
8.861664260852684e+17,17,107,6.294117647058823,2,9,13,4
8.861932882233491e+17,4,13,3.25,2,5,4,0
8.862115015152745e+17,32,164,5.125,3,7,32,0
8.862187734411534e+17,9,26,2.888888888888889,1,4,9,0
8.862348661110572e+17,3,26,8.666666666666666,8,9,0,3
8.862451231085172e+17,20,101,5.05,3,7,20,0
8.862627481169283e+17,1,11,11.0,11,11,0,1
8.862662298208406e+17,1,10,10.0,10,10,0,1
8.862674648525157e+17,1,10,10.0,10,10,0,1
8.862701544793221e+17,6,28,4.666666666666667,3,6,6,0
8.862748338479328e+17,7,31,4.428571428571429,4,5,7,0
8.86276154703135e+17,1,10,10.0,10,10,0,1
8.862784163617098e+17,3,30,10.0,9,11,0,3
8.86286761856154e+17,2,20,10.0,10,10,0,2
8.862880292512389e+17,1,10,10.0,10,10,0,1
8.864602728776772e+17,11,70,6.363636363636363,2,9,9,2
8.866324210271804e+17,23,202,8.782608695652174,5,11,4,19
8.86639241436739e+17,7,51,7.285714285714286,6,10,6,1
8.866394736388398e+17,2,15,7.5,7,8,1,1
8.866481402184503e+17,5,14,2.8,2,4,5,0
8.866642847838275e+17,2,19,9.5,9,10,0,2
8.866675485881645e+17,2,8,4.0,4,4,2,0
8.86669177739068e+17,32,66,2.0625,1,3,32,0
8.86682235824983e+17,8,55,6.875,6,8,6,2
8.866971873045212e+17,76,158,2.0789473684210527,1,4,76,0
8.867063239474712e+17,2,7,3.5,3,4,2,0
8.867093206990124e+17,82,173,2.1097560975609757,1,4,82,0
8.867450475898458e+17,12,97,8.083333333333334,7,10,5,7
8.86757159386529e+17,84,735,8.75,3,11,10,74
8.867601294103853e+17,16,149,9.3125,2,12,1,15
8.868037569636561e+17,2,6,3.0,3,3,2,0
8.868573646454557e+17,31,277,8.935483870967742,2,11,4,27
8.868873149066739e+17,4,27,6.75,6,7,4,0
8.868952543762697e+17,47,424,9.02127659574468,3,11,2,45
8.869014382274793e+17,11,50,4.545454545454546,3,6,11,0
8.869189928974163e+17,4,29,7.25,7,8,3,1
8.86931747230404e+17,44,208,4.7272727272727275,2,7,44,0
8.869349396102893e+17,65,256,3.9384615384615387,2,7,65,0
8.869952451670486e+17,71,681,9.591549295774648,2,13,3,68
8.870001929439985e+17,19,39,2.0526315789473686,1,5,19,0
8.870219441530615e+17,11,23,2.090909090909091,1,4,11,0
8.871202313988122e+17,47,90,1.9148936170212767,1,4,47,0
8.873037505233818e+17,23,220,9.565217391304348,2,11,2,21
8.873228963730519e+17,43,277,6.441860465116279,2,9,31,12
8.873632186253928e+17,30,98,3.2666666666666666,1,6,30,0
8.873661971970875e+17,20,60,3.0,1,4,20,0
8.873703644528417e+17,5,15,3.0,1,6,5,0
8.873717833370747e+17,13,42,3.230769230769231,2,4,13,0
8.873902821011543e+17,2,4,2.0,2,2,2,0
8.873903263266369e+17,2,8,4.0,3,5,2,0
8.873968989986378e+17,95,469,4.936842105263158,2,9,93,2
8.874009301127707e+17,32,42,1.3125,1,3,32,0
8.874116536053201e+17,72,698,9.694444444444445,2,13,5,67
8.87415265341764e+17,1,1,1.0,1,1,1,0
8.874246197656324e+17,78,525,6.730769230769231,2,9,57,21
8.874599560583625e+17,21,88,4.190476190476191,3,6,21,0
8.874735340285307e+17,110,535,4.863636363636363,2,8,109,1
8.874791030231082e+17,1,3,3.0,3,3,1,0
8.874951646537536e+17,27,131,4.851851851851852,3,7,27,0
8.875170227730337e+17,56,458,8.178571428571429,2,11,12,44
8.875359719463369e+17,68,271,3.985294117647059,1,6,68,0
8.875460580636723e+17,46,409,8.891304347826088,4,11,3,43
8.875566234789583e+17,101,509,5.03960396039604,2,7,101,0
8.875678707501994e+17,3,7,2.3333333333333335,1,3,3,0
8.875755595382811e+17,6,13,2.1666666666666665,1,4,6,0
8.876143946355237e+17,23,161,7.0,2,9,13,10
8.876420693958102e+17,120,471,3.925,2,7,120,0
8.876542882362065e+17,4,5,1.25,1,2,4,0
8.876574719211085e+17,43,204,4.744186046511628,2,7,43,0
8.876790742004932e+17,1,2,2.0,2,2,1,0
8.876995469363078e+17,9,44,4.888888888888889,4,6,9,0
8.877165433935162e+17,32,75,2.34375,1,5,32,0
8.880296391732713e+17,3,13,4.333333333333333,4,5,3,0
8.880407491321187e+17,7,17,2.4285714285714284,1,4,7,0
8.880582330957028e+17,28,59,2.107142857142857,1,5,28,0
8.880740300632883e+17,26,267,10.26923076923077,8,12,0,26
8.880820625286849e+17,3,7,2.3333333333333335,1,3,3,0
8.880858345278779e+17,107,524,4.897196261682243,2,8,106,1
8.880888061037596e+17,4,18,4.5,3,6,4,0
8.88108199507935e+17,101,508,5.02970297029703,2,7,101,0
8.881527684335567e+17,74,381,5.148648648648648,2,7,74,0
8.881575747254098e+17,3,13,4.333333333333333,4,5,3,0
8.881712527394938e+17,7,57,8.142857142857142,6,10,2,5
8.882306975894824e+17,18,109,6.055555555555555,5,7,18,0
8.882496420298906e+17,6,19,3.1666666666666665,2,5,6,0
8.882612482305649e+17,45,355,7.888888888888889,4,10,16,29
8.882854281710322e+17,1,6,6.0,6,6,1,0
8.882970744955242e+17,2,16,8.0,8,8,0,2
8.88310261185322e+17,41,56,1.3658536585365855,1,3,41,0
8.883468750325114e+17,110,327,2.9727272727272727,1,5,110,0
8.883609197757774e+17,6,13,2.1666666666666665,1,4,6,0
8.883645165707128e+17,9,40,4.444444444444445,2,6,9,0
8.883914717821786e+17,149,746,5.006711409395973,2,7,149,0
8.884348634926573e+17,33,166,5.03030303030303,2,8,32,1
8.884356574101061e+17,16,64,4.0,2,6,16,0
8.884564806567501e+17,109,229,2.1009174311926606,1,5,109,0
8.884903773495204e+17,70,133,1.9,1,5,70,0
8.885397566382592e+17,10,16,1.6,1,4,10,0
8.887372161011741e+17,6,18,3.0,1,4,6,0
8.887654775501866e+17,4,10,2.5,1,4,4,0
8.887745622522813e+17,3,6,2.0,2,2,3,0
8.887897514478467e+17,76,290,3.8157894736842106,1,6,76,0
8.888135345887658e+17,53,516,9.735849056603774,2,13,3,50
8.888146587238808e+17,9,28,3.111111111111111,2,4,9,0
8.888301999801606e+17,59,238,4.033898305084746,1,8,58,1
8.888423086556881e+17,8,21,2.625,1,4,8,0
8.88892605247268e+17,3,21,7.0,5,9,2,1
8.88895899118934e+17,4,5,1.25,1,2,4,0
8.889013798208426e+17,1,3,3.0,3,3,1,0
8.889331615976092e+17,3,27,9.0,8,10,0,3
8.889422533699077e+17,9,16,1.7777777777777777,1,3,9,0
8.889589692479272e+17,7,22,3.142857142857143,2,5,7,0
8.889612474108156e+17,10,19,1.9,1,4,10,0
8.889668756567846e+17,3,7,2.3333333333333335,1,4,3,0
8.889690922834511e+17,7,14,2.0,1,4,7,0
8.889936858808718e+17,28,245,8.75,3,11,1,27
8.89003242493267e+17,65,440,6.769230769230769,2,9,49,16
8.891569665542624e+17,66,250,3.787878787878788,2,6,66,0
8.891676161647926e+17,80,164,2.05,1,4,80,0
8.891717499831338e+17,6,62,10.333333333333334,9,12,0,6
8.89179693930987e+17,6,59,9.833333333333334,8,11,0,6
8.891999898624234e+17,1,2,2.0,2,2,1,0
8.89205370275072e+17,14,81,5.785714285714286,5,7,14,0
8.892139198560027e+17,2,2,1.0,1,1,2,0
8.892141282819375e+17,2,2,1.0,1,1,2,0
8.892159432188134e+17,2,3,1.5,1,2,2,0
8.892172647204416e+17,2,3,1.5,1,2,2,0
8.892228381578668e+17,1,3,3.0,3,3,1,0
8.892245977705492e+17,1,3,3.0,3,3,1,0
8.892389974673544e+17,1,4,4.0,4,4,1,0
8.892839717114477e+17,170,1610,9.470588235294118,2,12,14,156
8.893964862273924e+17,52,112,2.1538461538461537,1,5,52,0
8.894848578864941e+17,15,24,1.6,1,3,15,0
8.89488048651148e+17,3,5,1.6666666666666667,1,2,3,0
8.895257882978075e+17,72,293,4.069444444444445,2,6,72,0
8.895887222290378e+17,18,123,6.833333333333333,3,9,13,5
8.895930997786395e+17,55,111,2.018181818181818,1,3,55,0
8.895953361460508e+17,53,509,9.60377358490566,2,12,3,50
8.89596500166715e+17,8,48,6.0,4,8,7,1
8.895983963017699e+17,83,646,7.783132530120482,2,11,26,57
8.896161639025304e+17,34,74,2.176470588235294,1,4,34,0
8.896184478966857e+17,2,3,1.5,1,2,2,0
8.896265465726854e+17,76,163,2.1447368421052633,1,4,76,0
8.896646356921362e+17,4,41,10.25,10,11,0,4
8.896723801120742e+17,14,64,4.571428571428571,3,5,14,0
8.896770549330761e+17,33,65,1.9696969696969697,1,4,33,0
8.896995444007116e+17,49,297,6.061224489795919,4,8,46,3
8.897237229231817e+17,29,59,2.0344827586206895,1,5,29,0
8.897336739062514e+17,6,47,7.833333333333333,7,8,1,5
8.897494744475707e+17,21,44,2.0952380952380953,1,4,21,0
8.897514884962063e+17,11,111,10.090909090909092,7,12,1,10
8.897716939733873e+17,56,387,6.910714285714286,4,9,41,15
8.898264724844872e+17,52,107,2.0576923076923075,1,5,52,0
8.898742326213009e+17,35,169,4.828571428571428,3,8,34,1
8.899949840282499e+17,96,208,2.1666666666666665,1,4,96,0
8.90297406341609e+17,5,14,2.8,2,4,5,0
8.903271036318945e+17,4,29,7.25,6,8,2,2
8.903353620956433e+17,4,19,4.75,4,6,4,0
8.903565686322669e+17,10,54,5.4,5,7,10,0
8.903600151704225e+17,71,348,4.901408450704225,2,8,70,1
8.903727399294719e+17,78,387,4.961538461538462,3,8,77,1
8.905106143488383e+17,17,172,10.117647058823529,9,12,0,17
8.90535552593473e+17,3,10,3.3333333333333335,2,4,3,0
8.905711062367338e+17,47,186,3.9574468085106385,1,6,47,0
8.905716509964385e+17,14,84,6.0,4,7,14,0
8.905912209645146e+17,122,615,5.040983606557377,2,7,122,0
8.90619577203007e+17,116,1007,8.681034482758621,2,11,14,102
8.906543793366509e+17,24,189,7.875,3,11,7,17
8.906634577463497e+17,25,198,7.92,6,10,10,15
8.908062607912205e+17,121,1034,8.545454545454545,2,11,21,100
8.908133039555436e+17,36,302,8.38888888888889,2,11,7,29
8.909429624632608e+17,5,34,6.8,3,9,2,3
8.910099653948003e+17,11,48,4.363636363636363,3,6,11,0
8.91037107824269e+17,3,9,3.0,2,4,3,0
8.91086500444251e+17,46,406,8.826086956521738,3,11,6,40
8.911134141495117e+17,19,100,5.2631578947368425,3,8,18,1
8.911149796274844e+17,5,10,2.0,1,4,5,0
8.911285294721715e+17,35,175,5.0,3,7,35,0
8.912685730118072e+17,15,17,1.1333333333333333,1,2,15,0
8.912953308963328e+17,12,117,9.75,7,12,1,11
8.9133377131457e+17,118,806,6.830508474576271,2,9,78,40
8.913514575451995e+17,26,243,9.346153846153847,2,12,3,23
8.913549683873627e+17,88,607,6.8977272727272725,3,9,64,24
8.913559175607752e+17,8,82,10.25,8,12,0,8
8.913577074827053e+17,18,192,10.666666666666666,8,13,0,18
8.913579038241601e+17,110,770,7.0,2,9,72,38
8.913596510843697e+17,20,205,10.25,8,13,0,20
8.913609291379478e+17,115,236,2.0521739130434784,1,5,115,0
8.91365945069486e+17,142,1234,8.690140845070422,2,11,19,123
8.913998064182703e+17,97,665,6.855670103092783,2,9,66,31
8.915895352321084e+17,64,610,9.53125,2,12,4,60
8.916640469309002e+17,13,37,2.8461538461538463,1,4,13,0
8.917646587096e+17,2,21,10.5,10,11,0,2
8.917853836552175e+17,3,11,3.6666666666666665,3,4,3,0
8.9179071649821e+17,36,75,2.0833333333333335,1,4,36,0
8.918372909691855e+17,3,12,4.0,4,4,3,0
8.918719624647942e+17,58,515,8.879310344827585,3,11,5,53
8.918728932763909e+17,3,27,9.0,8,10,0,3
8.918855409106459e+17,1,1,1.0,1,1,1,0
8.918895519817367e+17,73,700,9.58904109589041,2,13,6,67
8.919009687390554e+17,12,98,8.166666666666666,4,10,3,9
8.919360865110729e+17,17,84,4.9411764705882355,3,8,16,1
8.919377203297111e+17,3,20,6.666666666666667,6,8,2,1
8.919999109629661e+17,14,27,1.9285714285714286,1,3,14,0
8.920009421298506e+17,33,324,9.818181818181818,5,12,2,31
8.920747737744266e+17,107,937,8.757009345794392,3,11,12,95
8.921184730057215e+17,46,99,2.152173913043478,1,5,46,0
8.922443796284028e+17,9,92,10.222222222222221,8,12,0,9
8.924187194757486e+17,44,92,2.090909090909091,1,5,44,0
8.924376736711779e+17,19,145,7.631578947368421,5,9,7,12
8.924626499680374e+17,3,15,5.0,3,7,3,0
8.924918692036389e+17,35,72,2.057142857142857,1,5,35,0
8.924969648970124e+17,86,268,3.116279069767442,1,5,86,0
8.924978413937578e+17,6,8,1.3333333333333333,1,3,6,0
8.925063114239747e+17,5,40,8.0,6,9,1,4
8.925075848343982e+17,4,26,6.5,6,7,4,0
8.925083938011776e+17,24,195,8.125,7,10,4,20
8.92510756808567e+17,1,6,6.0,6,6,1,0
8.925250072252036e+17,1,1,1.0,1,1,1,0
8.925356295567141e+17,90,626,6.955555555555556,3,10,65,25
8.925931256820835e+17,31,307,9.903225806451612,8,12,0,31
8.925980400260966e+17,24,94,3.9166666666666665,1,7,24,0
8.92624056912862e+17,12,94,7.833333333333333,2,10,3,9
8.926468326113915e+17,25,113,4.52,2,6,25,0
8.92660246135971e+17,15,34,2.2666666666666666,1,5,15,0
8.927713662019837e+17,4,28,7.0,4,8,1,3
8.927773865574172e+17,162,479,2.95679012345679,1,6,162,0
8.928149685254442e+17,2,5,2.5,2,3,2,0
8.92822619120555e+17,4,5,1.25,1,2,4,0
8.929081719274985e+17,2,5,2.5,1,4,2,0
8.930837339073644e+17,13,32,2.4615384615384617,1,4,13,0
8.931974502121453e+17,49,97,1.9795918367346939,1,4,49,0
8.931982174153985e+17,2,12,6.0,6,6,2,0
8.932032319553256e+17,106,536,5.056603773584905,2,8,103,3
8.932113909761388e+17,115,892,7.756521739130434,3,11,42,73
8.932269770778821e+17,57,455,7.982456140350878,2,11,18,39
8.932375153321517e+17,30,238,7.933333333333334,6,10,8,22
8.932488301590769e+17,1,6,6.0,6,6,1,0
8.932500019787999e+17,26,250,9.615384615384615,4,12,3,23
8.932723282786758e+17,1,5,5.0,5,5,1,0
8.932763372523128e+17,12,14,1.1666666666666667,1,2,12,0
8.932903380637101e+17,2,13,6.5,5,8,1,1
8.932920684283702e+17,62,437,7.048387096774194,4,10,43,19
8.933387136442153e+17,7,48,6.857142857142857,4,9,5,2
8.933580325811048e+17,56,82,1.4642857142857142,1,3,56,0
8.933645345895698e+17,10,29,2.9,2,5,10,0
8.93369297764415e+17,4,9,2.25,1,3,4,0
8.933739116418444e+17,98,189,1.9285714285714286,1,4,98,0
8.933835152991881e+17,30,276,9.2,2,11,2,28
8.934073778685069e+17,51,476,9.333333333333334,3,13,6,45
8.935028700852896e+17,18,35,1.9444444444444444,1,3,18,0
8.93767307367972e+17,27,57,2.111111111111111,1,3,27,0
8.938687226862383e+17,8,15,1.875,1,3,8,0
8.938771137574337e+17,1,1,1.0,1,1,1,0
8.93883146331178e+17,1,8,8.0,8,8,0,1
8.938915916256456e+17,4,11,2.75,2,4,4,0
8.938994354614307e+17,46,241,5.239130434782608,3,7,46,0
8.939060319554628e+17,1,7,7.0,7,7,1,0
8.9392011166502e+17,9,59,6.555555555555555,4,9,7,2
8.939221097818417e+17,64,123,1.921875,1,4,64,0
8.939313719233915e+17,116,1000,8.620689655172415,2,11,17,99
8.939346690712026e+17,40,153,3.825,2,6,40,0
8.939499665515643e+17,10,23,2.3,1,4,10,0
8.939574360166563e+17,1,8,8.0,8,8,0,1
8.939640832848983e+17,1,7,7.0,7,7,1,0
8.939720318913499e+17,127,253,1.9921259842519685,1,5,127,0
8.939772268925263e+17,1,6,6.0,6,6,1,0
8.939886458051603e+17,2,11,5.5,5,6,2,0
8.939972180218548e+17,1,2,2.0,2,2,1,0
8.940045516016068e+17,4,28,7.0,6,8,2,2
8.940122368364796e+17,106,210,1.9811320754716981,1,6,106,0
8.94021706984736e+17,3,19,6.333333333333333,6,7,3,0
8.940240780737468e+17,94,202,2.148936170212766,1,4,94,0
8.940713044363868e+17,3,25,8.333333333333334,6,10,1,2
8.940716970662555e+17,8,82,10.25,8,12,0,8
8.940718361733102e+17,6,58,9.666666666666666,7,12,1,5
8.940719452784239e+17,13,119,9.153846153846153,2,12,2,11
8.940720580289144e+17,2,21,10.5,10,11,0,2
8.940786600816168e+17,29,146,5.0344827586206895,3,7,29,0
8.940927091736215e+17,1,3,3.0,3,3,1,0
8.941242063454785e+17,32,133,4.15625,2,7,32,0
8.942341848845329e+17,57,563,9.87719298245614,7,13,2,55
8.942670830651296e+17,19,134,7.052631578947368,4,9,12,7
8.942774650828241e+17,146,1381,9.45890410958904,2,13,16,130
8.942952638996716e+17,116,914,7.879310344827586,2,11,38,78
8.9461532340293e+17,1,4,4.0,4,4,1,0
8.946715357782454e+17,19,41,2.1578947368421053,1,4,19,0
8.946721452861981e+17,1,1,1.0,1,1,1,0
8.94676076757083e+17,23,119,5.173913043478261,2,8,22,1
8.946922042669853e+17,4,13,3.25,2,4,4,0
8.946982270991817e+17,4,38,9.5,9,10,0,4
8.947038615120573e+17,110,155,1.4090909090909092,1,4,110,0
8.947188369248461e+17,4,28,7.0,6,8,3,1
8.947405141633576e+17,14,44,3.142857142857143,1,5,14,0
8.947430511045961e+17,40,360,9.0,7,12,2,38
8.947524081949505e+17,28,195,6.964285714285714,2,9,17,11
8.947545299278666e+17,1,4,4.0,4,4,1,0
8.947840008227387e+17,2,3,1.5,1,2,2,0
8.948422050627354e+17,1,10,10.0,10,10,0,1
8.948492762055277e+17,5,16,3.2,2,4,5,0
8.949501837156637e+17,2,15,7.5,7,8,1,1
8.949700444486342e+17,1,10,10.0,10,10,0,1
8.949892591284768e+17,47,331,7.042553191489362,4,9,32,15
8.950097086050578e+17,95,706,7.431578947368421,2,11,44,51
8.951547172854958e+17,55,258,4.6909090909090905,2,7,55,0
8.952293945529286e+17,4,26,6.5,4,9,3,1
8.953125222138506e+17,9,80,8.88888888888889,7,11,1,8
8.953377898640447e+17,5,20,4.0,3,6,5,0
8.953516779938714e+17,49,245,5.0,3,7,49,0
8.953751533696707e+17,39,191,4.897435897435898,3,6,39,0
8.953781417330207e+17,3,14,4.666666666666667,4,5,3,0
8.953812606585862e+17,5,12,2.4,1,3,5,0
8.953953524376786e+17,9,45,5.0,3,7,9,0
8.953975482804776e+17,8,43,5.375,3,7,8,0
8.954002047741399e+17,27,114,4.222222222222222,2,6,27,0
8.955324141746633e+17,45,99,2.2,1,5,45,0
8.956412671896516e+17,11,51,4.636363636363637,3,7,11,0
8.956562887317418e+17,4,7,1.75,1,2,4,0
8.956777621892609e+17,6,15,2.5,1,4,6,0
8.956918716101437e+17,1,3,3.0,3,3,1,0
8.956942208143784e+17,79,393,4.974683544303797,2,7,79,0
8.956989484826196e+17,42,80,1.9047619047619047,1,3,42,0
8.957802178458445e+17,5,15,3.0,1,5,5,0
8.957888521574527e+17,15,120,8.0,5,10,5,10
8.959537806966221e+17,31,291,9.387096774193548,2,12,3,28
8.96091183694937e+17,12,60,5.0,3,7,12,0
8.960923522747406e+17,53,250,4.716981132075472,2,7,53,0
8.961048305600086e+17,44,220,5.0,3,7,44,0
8.961099153508292e+17,60,523,8.716666666666667,5,11,8,52
8.96169109975151e+17,4,5,1.25,1,2,4,0
8.961732259687085e+17,68,673,9.897058823529411,4,12,4,64
8.96186711823343e+17,7,10,1.4285714285714286,1,2,7,0
8.962130061055443e+17,8,55,6.875,5,9,6,2
8.96262090344608e+17,10,73,7.3,4,9,5,5
8.962645121764918e+17,63,595,9.444444444444445,2,12,7,56
8.962803743821851e+17,48,246,5.125,3,7,48,0
8.963041244768275e+17,34,308,9.058823529411764,3,12,5,29
8.963314057694697e+17,25,173,6.92,5,9,18,7
8.963390949675063e+17,11,18,1.6363636363636365,1,4,11,0
8.963607472779566e+17,1,3,3.0,3,3,1,0
8.963772704963816e+17,27,69,2.5555555555555554,1,4,27,0
8.963822225577174e+17,79,752,9.518987341772151,2,12,3,76
8.964141314644273e+17,5,5,1.0,1,1,5,0
8.96418838240178e+17,2,4,2.0,2,2,2,0
8.964220372388681e+17,1,2,2.0,2,2,1,0
8.966602106697135e+17,10,33,3.3,2,5,10,0
8.967684926251741e+17,76,765,10.06578947368421,5,13,1,75
8.967852162641556e+17,112,154,1.375,1,3,112,0
8.968017672820385e+17,8,71,8.875,7,10,1,7
8.968633061101594e+17,76,437,5.75,2,8,73,3
8.968675314935894e+17,73,428,5.863013698630137,3,8,68,5
8.968677071290472e+17,8,64,8.0,7,9,2,6
8.968976554481885e+17,40,117,2.925,2,4,40,0
8.969012126145268e+17,43,422,9.813953488372093,4,12,1,42
8.969859988241924e+17,4,8,2.0,1,3,4,0
8.97083661848699e+17,75,500,6.666666666666667,2,9,51,24
8.970936941448677e+17,35,77,2.2,1,4,35,0
8.971166871910779e+17,116,345,2.9741379310344827,1,5,116,0
8.974365929805236e+17,2,10,5.0,3,7,2,0
8.97503775845749e+17,2,7,3.5,3,4,2,0
8.975181711785155e+17,2,5,2.5,1,4,2,0
8.975284599071411e+17,1,3,3.0,3,3,1,0
8.97531203940355e+17,17,115,6.764705882352941,4,8,11,6
8.975312866718205e+17,9,58,6.444444444444445,6,7,9,0
8.975467663128332e+17,26,204,7.846153846153846,6,10,11,15
8.975469751778181e+17,7,22,3.142857142857143,2,4,7,0
8.975492023064247e+17,15,114,7.6,5,9,6,9
8.975550318285932e+17,65,338,5.2,2,7,65,0
8.97556039903438e+17,2,9,4.5,4,5,2,0
8.975729136881189e+17,5,36,7.2,6,9,4,1
8.976236644897408e+17,36,321,8.916666666666666,2,11,3,33
8.976357405230076e+17,101,495,4.900990099009901,2,8,100,1
8.976399601289295e+17,54,384,7.111111111111111,5,10,34,20
8.976431286306556e+17,39,159,4.076923076923077,2,6,39,0
8.976800523037306e+17,20,100,5.0,3,7,20,0
8.977210493205929e+17,38,77,2.026315789473684,1,4,38,0
8.977554089086844e+17,20,48,2.4,1,5,20,0
8.97776253256364e+17,35,280,8.0,5,10,9,26
8.977804887078383e+17,13,89,6.846153846153846,5,8,10,3
8.977856645341197e+17,7,60,8.571428571428571,5,11,2,5
8.977866067694006e+17,17,136,8.0,5,11,4,13
8.978412922531308e+17,54,371,6.87037037037037,4,9,40,14
8.978805269530039e+17,74,147,1.9864864864864864,1,4,74,0
8.982013368846807e+17,1,8,8.0,8,8,0,1
8.98255972209864e+17,66,123,1.8636363636363635,1,4,66,0
8.982678797229732e+17,3,10,3.3333333333333335,3,4,3,0
8.982911083359474e+17,69,650,9.420289855072463,2,12,6,63
8.983142952943941e+17,4,5,1.25,1,2,4,0
8.98321785680673e+17,1,2,2.0,2,2,1,0
8.98331645299111e+17,63,192,3.0476190476190474,1,6,63,0
8.983395043148202e+17,1,3,3.0,3,3,1,0
8.983538036116904e+17,80,161,2.0125,1,4,80,0
8.983731182579881e+17,2,6,3.0,2,4,2,0
8.9842407950841e+17,97,488,5.030927835051546,3,8,96,1
8.984265205535366e+17,3,10,3.3333333333333335,1,5,3,0
8.984753819653405e+17,209,2002,9.578947368421053,2,13,9,200
8.985508412912856e+17,11,19,1.7272727272727273,1,3,11,0
8.985536747016791e+17,32,100,3.125,1,5,32,0
8.986047067364657e+17,74,715,9.662162162162161,2,12,6,68
8.987542912128687e+17,8,47,5.875,3,8,6,2
8.987987758424566e+17,22,190,8.636363636363637,3,11,2,20
8.989257910169594e+17,4,29,7.25,4,9,1,3
8.989418267849761e+17,20,127,6.35,2,8,16,4
8.99024418797366e+17,2,8,4.0,2,6,2,0
8.990347522466432e+17,5,53,10.6,10,11,0,5
8.990580860301565e+17,83,420,5.0602409638554215,2,7,83,0
8.990645617117027e+17,6,39,6.5,2,9,4,2
8.991843583448951e+17,13,128,9.846153846153847,8,12,0,13
8.992021980329242e+17,61,288,4.721311475409836,3,7,61,0
8.992531837004398e+17,23,95,4.130434782608695,3,7,23,0
8.992618660229836e+17,8,51,6.375,2,8,7,1
8.992786914730907e+17,7,72,10.285714285714286,9,12,0,7
8.992892510136303e+17,99,932,9.414141414141413,2,13,11,88
8.993198470560552e+17,55,434,7.890909090909091,6,9,17,38
8.996583519080964e+17,41,395,9.634146341463415,2,12,3,38
8.996704155080015e+17,2,18,9.0,9,9,0,2
8.997252722843657e+17,2,2,1.0,1,1,2,0
8.997293457751488e+17,35,104,2.9714285714285715,1,4,35,0
8.997361465343584e+17,29,88,3.0344827586206895,1,4,29,0
8.997393445638173e+17,50,255,5.1,3,7,50,0
8.997411086844284e+17,16,112,7.0,6,9,11,5
8.997506902906897e+17,54,359,6.648148148148148,2,9,40,14
8.998274458125775e+17,61,613,10.049180327868852,2,13,3,58
8.998868967272003e+17,2,4,2.0,1,3,2,0
8.999534590038929e+17,13,35,2.6923076923076925,1,5,13,0
8.999882628542143e+17,45,87,1.9333333333333333,1,4,45,0
9.00020774360767e+17,49,431,8.795918367346939,3,12,5,44
9.002801138022684e+17,8,68,8.5,8,9,0,8
9.004748750379429e+17,46,230,5.0,3,7,46,0
9.005062614056707e+17,10,89,8.9,6,11,1,9
9.005121796795873e+17,69,663,9.608695652173912,3,12,5,64
9.005163075320589e+17,38,374,9.842105263157896,3,12,2,36
9.005236252206432e+17,3,3,1.0,1,1,3,0
9.005469092441023e+17,12,113,9.416666666666666,3,12,1,11
9.005971427030554e+17,16,27,1.6875,1,3,16,0
9.006272286596111e+17,5,45,9.0,8,10,0,5
9.00674189740349e+17,25,214,8.56,7,11,5,20
9.006844236522682e+17,3,24,8.0,8,8,0,3
9.006878709754513e+17,89,886,9.955056179775282,2,13,3,86
9.006997375859827e+17,98,491,5.010204081632653,2,8,96,2
9.007026021758028e+17,1,1,1.0,1,1,1,0
9.007045077067414e+17,1,2,2.0,2,2,1,0
9.007110033216506e+17,1,1,1.0,1,1,1,0
9.00733494009346e+17,1,3,3.0,3,3,1,0
9.007643833121969e+17,8,47,5.875,4,8,7,1
9.007886254169647e+17,55,370,6.7272727272727275,4,10,44,11
9.008857326869023e+17,2,12,6.0,5,7,2,0
9.010719996517632e+17,73,356,4.876712328767123,3,7,73,0
9.011843041978569e+17,14,30,2.142857142857143,1,4,14,0
9.012165395112893e+17,28,186,6.642857142857143,2,10,21,7
9.012621101910903e+17,34,77,2.264705882352941,1,4,34,0
9.01292292172276e+17,10,29,2.9,1,5,10,0
9.012988843585682e+17,21,201,9.571428571428571,2,12,2,19
9.013221822577585e+17,1,3,3.0,3,3,1,0
9.01366158408115e+17,21,142,6.761904761904762,3,9,14,7
9.013747838906442e+17,49,428,8.73469387755102,4,11,7,42
9.013917468569524e+17,53,259,4.886792452830188,2,6,53,0
9.013928751009389e+17,24,50,2.0833333333333335,1,4,24,0
9.013939153443319e+17,40,267,6.675,5,9,34,6
9.014027817410812e+17,17,160,9.411764705882353,4,11,2,15
9.014507245646797e+17,32,217,6.78125,2,9,25,7
9.01729974414036e+17,26,202,7.769230769230769,6,10,11,15
9.017443392409928e+17,61,543,8.901639344262295,4,12,6,55
9.017901438102373e+17,1,1,1.0,1,1,1,0
9.018263915001732e+17,31,70,2.2580645161290325,1,4,31,0
9.018647433663654e+17,50,112,2.24,1,5,50,0
9.01864961961289e+17,35,237,6.771428571428571,3,9,25,10
9.0190082241235e+17,11,30,2.727272727272727,1,6,11,0
9.01902428776803e+17,12,24,2.0,1,3,12,0
9.019044283762956e+17,16,50,3.125,2,5,16,0
9.019403257894872e+17,1,2,2.0,2,2,1,0
9.019464861398875e+17,36,64,1.7777777777777777,1,5,36,0
9.019571579392145e+17,11,72,6.545454545454546,2,8,8,3
9.01968832559713e+17,63,308,4.888888888888889,2,7,63,0
9.019848570754065e+17,42,394,9.380952380952381,2,12,4,38
9.019869416468895e+17,76,103,1.355263157894737,1,3,76,0
9.019884657024471e+17,96,202,2.1041666666666665,1,4,96,0
9.019890412230536e+17,26,57,2.1923076923076925,1,4,26,0
9.019896405065181e+17,71,149,2.0985915492957745,1,4,71,0
9.020020512784577e+17,31,303,9.774193548387096,4,11,2,29
9.020696699497426e+17,22,42,1.9090909090909092,1,4,22,0
9.020789784813162e+17,88,449,5.1022727272727275,3,8,87,1
9.020971571317135e+17,8,17,2.125,1,4,8,0
9.021153909091448e+17,108,1025,9.49074074074074,2,11,9,99
9.021238867268033e+17,42,89,2.119047619047619,1,5,42,0
9.021243295837349e+17,45,427,9.488888888888889,4,13,2,43
9.021540338384356e+17,7,54,7.714285714285714,6,9,2,5
9.021603850710527e+17,44,342,7.7727272727272725,4,10,16,28
9.022495054431708e+17,2,12,6.0,6,6,2,0
9.023092435500439e+17,89,865,9.719101123595506,2,13,6,83
9.025503089870042e+17,16,153,9.5625,4,11,1,15
9.02596760574282e+17,1,9,9.0,9,9,0,1
9.026004786658397e+17,29,50,1.7241379310344827,1,4,29,0
9.02608091199368e+17,4,10,2.5,1,4,4,0
9.026226940514472e+17,13,40,3.076923076923077,2,4,13,0
9.026252066415055e+17,48,104,2.1666666666666665,1,4,48,0
9.026259993889888e+17,45,96,2.1333333333333333,1,4,45,0
9.026717791717696e+17,3,5,1.6666666666666667,1,3,3,0
9.026760444320269e+17,19,42,2.210526315789474,1,4,19,0
9.027484595196767e+17,79,771,9.759493670886076,2,13,6,73
9.027708981900876e+17,7,65,9.285714285714286,7,11,1,6
9.027967908428284e+17,10,49,4.9,3,6,10,0
9.028106301532627e+17,108,946,8.75925925925926,2,12,13,95
9.028339780898817e+17,37,247,6.675675675675675,3,9,29,8
9.028571669223692e+17,86,172,2.0,1,4,86,0
9.028659537891212e+17,3,8,2.6666666666666665,2,3,3,0
9.028746827516036e+17,14,62,4.428571428571429,3,6,14,0
9.028830920433055e+17,5,42,8.4,7,9,1,4
9.028844360786757e+17,44,389,8.840909090909092,2,11,6,38
9.028926811194132e+17,38,349,9.18421052631579,2,11,3,35
9.029085629809708e+17,36,148,4.111111111111111,2,6,36,0
9.029233984826166e+17,176,841,4.778409090909091,2,7,176,0
9.030086610474499e+17,50,110,2.2,1,5,50,0
9.0320950517031e+17,14,63,4.5,2,7,14,0
9.032950893410011e+17,71,149,2.0985915492957745,1,5,71,0
9.033403392975652e+17,8,60,7.5,6,10,5,3
9.03340516767471e+17,5,16,3.2,1,5,5,0
9.033505378493923e+17,7,18,2.5714285714285716,1,3,7,0
9.034245938137187e+17,12,39,3.25,2,5,12,0
9.034259906003905e+17,10,31,3.1,2,5,10,0
9.03432668297433e+17,17,171,10.058823529411764,5,13,1,16
9.034352093897713e+17,11,70,6.363636363636363,5,8,9,2
9.034366288950513e+17,16,27,1.6875,1,3,16,0
9.034456075361321e+17,51,101,1.9803921568627452,1,4,51,0
9.034588924008186e+17,10,68,6.8,5,8,8,2
9.034656824036024e+17,3,11,3.6666666666666665,3,5,3,0
9.034734490397464e+17,1,3,3.0,3,3,1,0
9.03473600040211e+17,9,84,9.333333333333334,4,11,1,8
9.034927894402007e+17,1,1,1.0,1,1,1,0
9.035055401300991e+17,1,1,1.0,1,1,1,0
9.035313309600684e+17,7,66,9.428571428571429,8,10,0,7
9.035712613346831e+17,36,263,7.305555555555555,2,9,20,16
9.035966654547803e+17,25,253,10.12,9,11,0,25
9.036858822610565e+17,35,235,6.714285714285714,2,9,24,11
9.036987167653324e+17,34,322,9.470588235294118,4,12,2,32
9.03718585008503e+17,4,24,6.0,5,7,4,0
9.037229703957252e+17,1,2,2.0,2,2,1,0
9.037325546038248e+17,6,30,5.0,4,6,6,0
9.037550168528337e+17,10,65,6.5,5,9,8,2
9.039687018143633e+17,16,141,8.8125,7,10,2,14
9.039771166630243e+17,2,3,1.5,1,2,2,0
9.040044266811036e+17,7,24,3.4285714285714284,3,4,7,0
9.040052877565848e+17,3,8,2.6666666666666665,2,3,3,0
9.040330168511322e+17,83,165,1.9879518072289157,1,5,83,0
9.040813162927718e+17,4,5,1.25,1,2,4,0
9.041028404124849e+17,6,20,3.3333333333333335,1,5,6,0
9.041289735195409e+17,55,387,7.036363636363636,2,10,36,19
9.041951255830591e+17,1,8,8.0,8,8,0,1
9.042070075662482e+17,88,847,9.625,2,12,7,81
9.042121545095949e+17,2,15,7.5,7,8,1,1
9.04218214124751e+17,1,8,8.0,8,8,0,1
9.042349619587025e+17,108,747,6.916666666666667,2,9,70,38
9.042419542272786e+17,4,7,1.75,1,4,4,0
9.042574029432425e+17,1,6,6.0,6,6,1,0
9.042672160930001e+17,104,705,6.778846153846154,2,9,77,27
9.042905014317638e+17,8,35,4.375,3,6,8,0
9.043042515653702e+17,2,4,2.0,2,2,2,0
9.043133323746842e+17,8,68,8.5,5,10,1,7
9.043300929711173e+17,92,717,7.793478260869565,3,10,32,60
9.043693346831756e+17,38,252,6.631578947368421,3,9,30,8
9.04445902506376e+17,85,827,9.729411764705882,4,13,6,79
9.04741617389146e+17,2,5,2.5,2,3,2,0
9.047472441757329e+17,65,644,9.907692307692308,4,12,1,64
9.047920334162746e+17,50,337,6.74,5,9,40,10
9.048019605198406e+17,38,250,6.578947368421052,3,9,30,8
9.048128226121527e+17,36,247,6.861111111111111,2,9,24,12
9.048190437135429e+17,45,312,6.933333333333334,3,9,27,18
9.04819749016138e+17,146,452,3.095890410958904,1,7,146,0
9.048316637398359e+17,51,360,7.0588235294117645,5,9,32,19
9.048543021157774e+17,58,513,8.844827586206897,6,11,4,54
9.048689959130234e+17,1,6,6.0,6,6,1,0
9.04887828805618e+17,27,136,5.037037037037037,4,6,27,0
9.048926952775745e+17,8,41,5.125,4,6,8,0
9.049213323048788e+17,1,5,5.0,5,5,1,0
9.049529419677912e+17,18,177,9.833333333333334,6,12,1,17
9.04957942156733e+17,52,209,4.019230769230769,2,6,52,0
9.050220924748936e+17,44,62,1.4090909090909092,1,3,44,0
9.050297739498516e+17,73,296,4.054794520547945,2,7,73,0
9.050844793981932e+17,27,247,9.148148148148149,3,11,4,23
9.051368019599456e+17,1,1,1.0,1,1,1,0
9.051462609726339e+17,1,1,1.0,1,1,1,0
9.051646665671804e+17,4,30,7.5,7,8,2,2
9.05370524438836e+17,15,30,2.0,1,4,15,0
9.05382072670929e+17,49,339,6.918367346938775,2,9,34,15
9.05442449787274e+17,8,63,7.875,2,10,2,6
9.054790751947319e+17,68,539,7.926470588235294,2,10,20,48
9.055005028627348e+17,33,78,2.3636363636363638,1,6,33,0
9.055809795840324e+17,6,18,3.0,2,4,6,0
9.056006600091805e+17,59,240,4.067796610169491,2,7,59,0
9.056116757245312e+17,5,8,1.6,1,3,5,0
9.05663022314056e+17,11,72,6.545454545454546,5,9,8,3
9.056727995140332e+17,118,577,4.889830508474576,2,7,118,0
9.057056488026021e+17,11,15,1.3636363636363635,1,2,11,0
9.057264716683286e+17,1,4,4.0,4,4,1,0
9.057604408123153e+17,1,2,2.0,2,2,1,0
9.057778090356472e+17,23,160,6.956521739130435,5,9,18,5
9.057970413364951e+17,31,307,9.903225806451612,6,12,1,30
9.058079644386666e+17,2,5,2.5,2,3,2,0
9.058090183553896e+17,24,31,1.2916666666666667,1,3,24,0
9.058535626229832e+17,7,14,2.0,1,3,7,0
9.058601372537605e+17,20,93,4.65,3,7,20,0
9.058736632704584e+17,14,130,9.285714285714286,8,13,0,14
9.061317234716722e+17,64,624,9.75,7,12,2,62
9.062247416300826e+17,18,143,7.944444444444445,7,10,5,13
9.062477421819795e+17,33,232,7.03030303030303,3,9,20,13
9.062477491174172e+17,35,236,6.742857142857143,3,9,24,11
9.062650086355098e+17,1,3,3.0,3,3,1,0
9.062653951764653e+17,4,30,7.5,7,8,2,2
9.062655267016809e+17,6,46,7.666666666666667,6,9,2,4
9.062836407813391e+17,1,3,3.0,3,3,1,0
9.063512723130888e+17,21,170,8.095238095238095,3,10,4,17
9.06390382983973e+17,4,8,2.0,1,3,4,0
9.06437274210605e+17,4,14,3.5,3,4,4,0
9.064493057939063e+17,52,509,9.788461538461538,2,12,1,51
9.06452880390405e+17,15,48,3.2,1,7,15,0
9.064711168770391e+17,1,3,3.0,3,3,1,0
9.064731858295615e+17,39,151,3.871794871794872,2,6,39,0
9.064737199485893e+17,27,254,9.407407407407407,2,13,4,23
9.064846087125747e+17,35,235,6.714285714285714,2,9,26,9
9.066048531867123e+17,14,86,6.142857142857143,4,8,12,2
9.066086011417998e+17,5,20,4.0,3,5,5,0
9.066144408538236e+17,124,822,6.629032258064516,2,9,98,26
9.066651576278781e+17,10,22,2.2,1,4,10,0
9.068807625545111e+17,1,2,2.0,2,2,1,0
9.068847630924748e+17,30,293,9.766666666666667,7,13,2,28
9.069631280436842e+17,1,4,4.0,4,4,1,0
9.069744674748549e+17,6,11,1.8333333333333333,1,3,6,0
9.069998159652183e+17,123,600,4.878048780487805,2,7,123,0
9.070170319967821e+17,49,330,6.73469387755102,3,9,36,13
9.070204741445848e+17,203,1205,5.935960591133005,2,9,188,15
9.070317885817377e+17,24,66,2.75,1,5,24,0
9.070558631724599e+17,2,15,7.5,7,8,1,1
9.071085410010098e+17,12,87,7.25,6,9,8,4
9.07109961558639e+17,1,1,1.0,1,1,1,0
9.071208289038908e+17,4,6,1.5,1,2,4,0
9.071266357720704e+17,5,11,2.2,1,3,5,0
9.071375429057467e+17,99,487,4.91919191919192,2,7,99,0
9.071392394096429e+17,7,13,1.8571428571428572,1,3,7,0
9.07145304170567e+17,15,151,10.066666666666666,8,12,0,15
9.071564938696225e+17,22,110,5.0,3,7,22,0
9.071719215858723e+17,15,29,1.9333333333333333,1,4,15,0
9.071922397699391e+17,5,24,4.8,4,5,5,0
9.072044787508855e+17,20,144,7.2,5,10,11,9
9.072212976497386e+17,41,63,1.5365853658536586,1,4,41,0
9.072286597555494e+17,24,183,7.625,2,9,8,16
9.072326781499782e+17,31,220,7.096774193548387,3,10,21,10
9.07240732091113e+17,60,402,6.7,2,9,42,18
9.072647096781009e+17,118,473,4.008474576271187,1,7,118,0
9.072736438824915e+17,5,9,1.8,1,2,5,0
9.07293058640556e+17,123,477,3.8780487804878048,1,7,123,0
9.073628198685592e+17,8,51,6.375,2,9,7,1
9.075413395096422e+17,1,9,9.0,9,9,0,1
9.075805823849468e+17,47,228,4.851063829787234,2,7,47,0
9.075925167049326e+17,4,30,7.5,7,8,2,2
9.076591794195081e+17,4,28,7.0,6,9,3,1
9.076638599482808e+17,2,7,3.5,3,4,2,0
9.076860092409567e+17,44,432,9.818181818181818,2,12,3,41
9.076972258481914e+17,35,245,7.0,5,9,25,10
9.077017271520618e+17,24,154,6.416666666666667,2,8,18,6
9.077683935004948e+17,3,6,2.0,1,3,3,0
9.077783474664713e+17,141,863,6.120567375886525,3,9,126,15
9.07856151848424e+17,50,253,5.06,3,6,50,0
9.078744845443976e+17,2,5,2.5,2,3,2,0
9.078882211982007e+17,148,896,6.054054054054054,3,9,136,12
9.07920180761674e+17,3,5,1.6666666666666667,1,3,3,0
9.079314443593335e+17,18,173,9.61111111111111,8,11,0,18
9.079321762340122e+17,1,10,10.0,10,10,0,1
9.079539051075644e+17,39,267,6.846153846153846,2,9,30,9
9.079796386275174e+17,29,209,7.206896551724138,5,9,19,10
9.07995934616161e+17,16,146,9.125,4,12,3,13
9.080508470646876e+17,77,729,9.467532467532468,2,12,9,68
9.080697994533018e+17,1,2,2.0,2,2,1,0
9.080912862345851e+17,23,163,7.086956521739131,5,10,17,6
9.082554345269733e+17,45,442,9.822222222222223,2,12,1,44
9.083783096825756e+17,57,496,8.701754385964913,2,12,8,49
9.083839492847775e+17,18,92,5.111111111111111,3,7,18,0
9.083902978285341e+17,12,115,9.583333333333334,7,13,1,11
9.08397507318815e+17,17,88,5.176470588235294,3,8,16,1
9.084014029742392e+17,3,9,3.0,2,4,3,0
9.084022914998011e+17,45,181,4.022222222222222,2,6,45,0
9.084043844777965e+17,15,33,2.2,1,4,15,0
9.084101812310295e+17,1,3,3.0,3,3,1,0
9.084111835447155e+17,18,125,6.944444444444445,5,9,14,4
9.084171890880407e+17,24,73,3.0416666666666665,1,5,24,0
9.084214290341059e+17,1,4,4.0,4,4,1,0
9.084293161466954e+17,38,83,2.1842105263157894,1,4,38,0
9.084410002091904e+17,11,34,3.090909090909091,1,4,11,0
9.084460014898075e+17,5,40,8.0,7,9,1,4
9.084946432956797e+17,117,812,6.94017094017094,5,10,84,33
9.085121605264753e+17,11,59,5.363636363636363,3,7,11,0
9.085161969497613e+17,6,11,1.8333333333333333,1,3,6,0
9.085168277868218e+17,10,75,7.5,7,8,5,5
9.085243704673103e+17,30,105,3.5,2,5,30,0
9.085311585629943e+17,5,46,9.2,8,11,0,5
9.085472404673911e+17,4,7,1.75,1,2,4,0
9.085616837552524e+17,30,278,9.266666666666667,3,11,3,27
9.08595577827504e+17,2,15,7.5,7,8,1,1
9.08624250515775e+17,31,64,2.064516129032258,1,4,31,0
9.086703457344456e+17,9,22,2.4444444444444446,1,5,9,0
9.086972962827578e+17,5,39,7.8,6,9,1,4
9.087291575363107e+17,57,223,3.912280701754386,2,6,57,0
9.087572713600951e+17,1,1,1.0,1,1,1,0
9.087847421616397e+17,2,14,7.0,6,8,1,1
9.087869929799305e+17,33,42,1.2727272727272727,1,2,33,0
9.087906951854108e+17,3,25,8.333333333333334,8,9,0,3
9.08805302149334e+17,1,7,7.0,7,7,1,0
9.088179958768653e+17,2,12,6.0,6,6,2,0
9.091173504596772e+17,35,162,4.628571428571429,2,8,34,1
9.091233762835227e+17,3,8,2.6666666666666665,2,4,3,0
9.09131387183758e+17,25,78,3.12,1,5,25,0
9.091593430304163e+17,3,22,7.333333333333333,6,8,1,2
9.091759839491068e+17,144,857,5.951388888888889,2,9,133,11
9.091826635105432e+17,16,110,6.875,5,9,12,4
9.09193416692636e+17,1,3,3.0,3,3,1,0
9.09202054930209e+17,210,1245,5.928571428571429,2,8,198,12
9.092066203631118e+17,45,307,6.822222222222222,3,9,32,13
9.0920811188218e+17,32,73,2.28125,1,4,32,0
9.09213718741724e+17,3,23,7.666666666666667,7,8,1,2
9.092303317283137e+17,33,321,9.727272727272727,2,13,2,31
9.092723325286067e+17,49,459,9.36734693877551,2,12,2,47
9.09278118448017e+17,20,101,5.05,3,6,20,0
9.092891444396707e+17,25,203,8.12,3,11,6,19
9.092908597377896e+17,1,2,2.0,2,2,1,0
9.093335414169577e+17,41,157,3.8292682926829267,2,6,41,0
9.093672511751743e+17,15,148,9.866666666666667,8,12,0,15
9.093714959910779e+17,12,19,1.5833333333333333,1,3,12,0
9.093735290603922e+17,2,21,10.5,9,12,0,2
9.093820454388129e+17,3,5,1.6666666666666667,1,3,3,0
9.094402371476058e+17,36,51,1.4166666666666667,1,4,36,0
9.094491099744657e+17,1,9,9.0,9,9,0,1
9.09455532758138e+17,2,14,7.0,6,8,1,1
9.094635829385423e+17,2,3,1.5,1,2,2,0
9.094936320860943e+17,1,5,5.0,5,5,1,0
9.094952569211981e+17,4,9,2.25,1,3,4,0
9.095093955675916e+17,3,21,7.0,6,8,2,1
9.09524841073646e+17,68,270,3.9705882352941178,2,6,68,0
9.095292241030752e+17,7,46,6.571428571428571,5,8,5,2
9.095475761026829e+17,6,49,8.166666666666666,6,10,2,4
9.095566310902609e+17,1,7,7.0,7,7,1,0
9.098162379655775e+17,1,1,1.0,1,1,1,0
9.098395131009503e+17,7,44,6.285714285714286,4,8,5,2
9.098654774553996e+17,34,218,6.411764705882353,2,9,26,8
9.098812412199738e+17,388,529,1.3634020618556701,1,4,388,0
9.09892240700301e+17,181,253,1.3977900552486189,1,3,181,0
9.099151420763958e+17,1,3,3.0,3,3,1,0
9.099200666464006e+17,11,22,2.0,1,3,11,0
9.099843557408012e+17,4,29,7.25,6,8,2,2
9.099843689432333e+17,2,12,6.0,6,6,2,0
9.099845024807532e+17,1,3,3.0,3,3,1,0
9.099875519842218e+17,100,964,9.64,2,12,8,92
9.099911202754424e+17,2,15,7.5,7,8,1,1
9.099956607915204e+17,2,17,8.5,8,9,0,2
9.100028487579944e+17,1,5,5.0,5,5,1,0
9.100037389666145e+17,4,23,5.75,2,8,3,1
9.100210314047081e+17,2,4,2.0,1,3,2,0
9.100263079204282e+17,1,2,2.0,2,2,1,0
9.100339221533498e+17,1,5,5.0,5,5,1,0
9.100411573620979e+17,2,16,8.0,8,8,0,2
9.101186323517999e+17,11,16,1.4545454545454546,1,3,11,0
9.102604750956974e+17,8,48,6.0,5,7,8,0
9.105370565500384e+17,15,45,3.0,2,5,15,0
9.105560236907805e+17,69,345,5.0,2,8,68,1
9.106507384889384e+17,43,408,9.488372093023257,3,12,1,42
9.10657013338763e+17,22,211,9.590909090909092,3,12,1,21
9.107277453355969e+17,149,1328,8.912751677852349,3,11,11,138
9.108193101826195e+17,21,36,1.7142857142857142,1,3,21,0
9.108211389274822e+17,3,4,1.3333333333333333,1,2,3,0
9.108326533915725e+17,12,72,6.0,4,8,10,2
9.10854476254866e+17,3,6,2.0,2,2,3,0
9.108697367951446e+17,4,29,7.25,6,8,2,2
9.109526042909964e+17,191,1682,8.806282722513089,2,12,25,166
9.111836992095057e+17,3,25,8.333333333333334,7,9,1,2
9.111965208676968e+17,4,33,8.25,7,9,1,3
9.112469358067974e+17,1,8,8.0,8,8,0,1
9.112580303253423e+17,3,22,7.333333333333333,5,9,1,2
9.113297060859679e+17,10,53,5.3,2,7,10,0
9.113455324331104e+17,25,145,5.8,4,8,22,3
9.113704928537326e+17,86,120,1.3953488372093024,1,4,86,0
9.11381120685877e+17,36,349,9.694444444444445,6,12,1,35
9.113978983829371e+17,3,3,1.0,1,1,3,0
9.11400108706988e+17,5,32,6.4,5,9,4,1
9.114029665334604e+17,40,345,8.625,3,11,5,35
9.114040742475585e+17,13,87,6.6923076923076925,5,9,12,1
9.114502038204541e+17,51,496,9.72549019607843,3,12,3,48
9.114637486984472e+17,92,897,9.75,2,12,2,90
9.115605214686816e+17,42,210,5.0,3,7,42,0
9.115637060176721e+17,3,27,9.0,6,11,1,2
9.115758296899962e+17,79,159,2.0126582278481013,1,5,79,0
9.116351099527379e+17,19,132,6.947368421052632,5,8,14,5
9.11659849429026e+17,54,276,5.111111111111111,2,7,54,0
9.116650917406473e+17,37,71,1.9189189189189189,1,4,37,0
9.119869601154627e+17,63,432,6.857142857142857,2,9,45,18
9.120434805617655e+17,63,67,1.0634920634920635,1,2,63,0
9.120442560098643e+17,65,248,3.8153846153846156,2,6,65,0
9.120587859849243e+17,60,297,4.95,3,7,60,0
9.120615902028812e+17,2,2,1.0,1,1,2,0
9.120658781348055e+17,18,34,1.8888888888888888,1,4,18,0
9.12082354308694e+17,5,12,2.4,1,4,5,0
9.120986126508442e+17,70,614,8.771428571428572,4,11,7,63
9.121195695235137e+17,85,129,1.5176470588235293,1,3,85,0
9.121282311775064e+17,68,410,6.029411764705882,2,8,65,3
9.121410078803616e+17,30,60,2.0,1,4,30,0
9.12143493367162e+17,78,112,1.435897435897436,1,3,78,0
9.121443383513553e+17,34,229,6.735294117647059,2,9,25,9
9.122132244139791e+17,90,637,7.0777777777777775,2,9,53,37
9.122306967001912e+17,10,24,2.4,1,4,10,0
9.122467710345166e+17,23,147,6.391304347826087,3,9,18,5
9.122615179444923e+17,5,6,1.2,1,2,5,0
9.122753491396915e+17,2,8,4.0,4,4,2,0
9.12279727403704e+17,13,47,3.6153846153846154,2,5,13,0
9.122987504573697e+17,66,653,9.893939393939394,2,12,2,64
9.123051679269943e+17,19,139,7.315789473684211,6,9,10,9
9.12350347864114e+17,22,63,2.8636363636363638,1,5,22,0
9.123544598324372e+17,57,278,4.87719298245614,3,7,57,0
9.123965101870354e+17,3,19,6.333333333333333,5,8,2,1
9.124112446225997e+17,22,110,5.0,3,7,22,0
9.124117530916654e+17,1,2,2.0,2,2,1,0
9.124130308343967e+17,10,15,1.5,1,3,10,0
9.126356451314926e+17,3,25,8.333333333333334,8,9,0,3
9.127365349372536e+17,12,105,8.75,5,10,2,10
9.127606788478296e+17,77,527,6.8441558441558445,4,9,62,15
9.127639533316227e+17,93,627,6.741935483870968,2,9,72,21
9.127768375233725e+17,53,309,5.830188679245283,3,8,51,2
9.127852214365164e+17,10,48,4.8,3,7,10,0
9.127957220062917e+17,1,9,9.0,9,9,0,1
9.127982957187785e+17,34,232,6.823529411764706,4,10,23,11
9.128022363440846e+17,93,642,6.903225806451613,3,9,66,27
9.128036655502746e+17,18,121,6.722222222222222,5,10,13,5
9.128053684294769e+17,96,682,7.104166666666667,3,10,60,36
9.128064129018246e+17,40,273,6.825,5,8,29,11
9.128179748894388e+17,32,244,7.625,5,10,15,17
9.128291998383468e+17,8,58,7.25,6,9,6,2
9.128296227944726e+17,47,320,6.808510638297872,3,9,31,16
9.12880516881771e+17,36,70,1.9444444444444444,1,4,36,0
9.128808856773857e+17,6,14,2.3333333333333335,1,4,6,0
9.128993223382008e+17,4,5,1.25,1,2,4,0
9.129742409019589e+17,22,201,9.136363636363637,2,12,2,20
9.129900986107683e+17,66,267,4.045454545454546,2,6,66,0
9.129978157712545e+17,10,24,2.4,2,5,10,0
9.130037782456782e+17,10,83,8.3,3,11,2,8
9.130149545675263e+17,47,309,6.574468085106383,3,9,39,8
9.13030052928335e+17,25,248,9.92,6,12,1,24
9.130475183029453e+17,13,29,2.230769230769231,1,4,13,0
9.130780539720992e+17,46,311,6.760869565217392,4,8,39,7
9.131187313090664e+17,33,329,9.969696969696969,8,12,0,33
9.131251858485315e+17,124,836,6.741935483870968,2,9,95,29
9.131356366801284e+17,2,17,8.5,8,9,0,2
9.132443675868183e+17,48,242,5.041666666666667,2,7,48,0
9.13367526299664e+17,12,84,7.0,5,8,7,5
9.134768640450963e+17,7,63,9.0,4,11,1,6
9.134771005181096e+17,3,5,1.6666666666666667,1,3,3,0
9.134784959392284e+17,148,586,3.9594594594594597,2,7,148,0
9.134909126598638e+17,17,127,7.470588235294118,5,9,8,9
9.135200351624412e+17,31,67,2.161290322580645,1,4,31,0
9.135306809903715e+17,3,24,8.0,7,9,1,2
9.135358336128195e+17,2,14,7.0,6,8,1,1
9.135489146891096e+17,1,4,4.0,4,4,1,0
9.135676225556237e+17,1,7,7.0,7,7,1,0
9.13575155214626e+17,1,8,8.0,8,8,0,1
9.135769412379581e+17,1,7,7.0,7,7,1,0
9.135964753727922e+17,2,6,3.0,2,4,2,0
9.136022747177093e+17,2,16,8.0,8,8,0,2
9.136043707398013e+17,12,83,6.916666666666667,5,9,10,2
9.136104233279996e+17,2,16,8.0,7,9,1,1
9.136357650579574e+17,1,9,9.0,9,9,0,1
9.136412379733014e+17,1,10,10.0,10,10,0,1
9.136467881608401e+17,46,145,3.152173913043478,1,5,46,0
9.136750927664352e+17,131,1140,8.702290076335878,2,12,15,116
9.136849421402836e+17,5,11,2.2,1,4,5,0
9.137343159675124e+17,44,367,8.340909090909092,2,11,7,37
9.13757210073782e+17,4,5,1.25,1,2,4,0
9.137678809945e+17,129,1151,8.922480620155039,6,11,12,117
9.137683609303648e+17,107,220,2.05607476635514,1,4,107,0
9.137920252281211e+17,50,488,9.76,6,12,1,49
9.138469855918865e+17,58,569,9.810344827586206,2,13,3,55
9.141403664253816e+17,3,23,7.666666666666667,6,9,1,2
9.14168242349562e+17,144,970,6.736111111111111,2,9,108,36
9.141842334541811e+17,35,167,4.771428571428571,2,6,35,0
9.141971501940253e+17,8,56,7.0,6,8,5,3
9.142119762117824e+17,12,27,2.25,1,4,12,0
9.142128174205627e+17,20,40,2.0,1,3,20,0
9.142155064033574e+17,121,1059,8.75206611570248,2,11,9,112
9.142581923172785e+17,12,14,1.1666666666666667,1,2,12,0
9.142679400639158e+17,2,7,3.5,3,4,2,0
9.143025098415181e+17,9,30,3.3333333333333335,2,5,9,0
9.143077470100257e+17,7,17,2.4285714285714284,1,3,7,0
9.143250192102968e+17,39,385,9.871794871794872,7,12,2,37
9.143260758336582e+17,4,28,7.0,5,8,2,2
9.14326320812848e+17,1,7,7.0,7,7,1,0
9.143463800740575e+17,19,181,9.526315789473685,7,12,2,17
9.143603299114396e+17,41,215,5.2439024390243905,3,7,41,0
9.143626660998328e+17,7,48,6.857142857142857,6,8,6,1
9.144083956294497e+17,62,234,3.774193548387097,1,5,62,0
9.144318767847402e+17,7,25,3.5714285714285716,3,5,7,0
9.144562728867496e+17,3,7,2.3333333333333335,2,3,3,0
9.14467851206819e+17,1,1,1.0,1,1,1,0
9.144910191771716e+17,5,13,2.6,1,4,5,0
9.144965462634268e+17,3,9,3.0,1,4,3,0
9.145362960986093e+17,84,565,6.726190476190476,2,9,62,22
9.145568823025142e+17,41,316,7.7073170731707314,2,10,16,25
9.14571599230791e+17,153,1136,7.42483660130719,2,10,65,88
9.145831465291055e+17,46,239,5.195652173913044,3,7,46,0
9.149091089985016e+17,1,4,4.0,4,4,1,0
9.149320480816959e+17,71,651,9.169014084507042,2,12,9,62
9.149512482286711e+17,28,132,4.714285714285714,3,6,28,0
9.149944678212209e+17,1,7,7.0,7,7,1,0
9.150069454372059e+17,1,7,7.0,7,7,1,0
9.150318091011875e+17,4,26,6.5,3,9,3,1
9.150368832997321e+17,6,46,7.666666666666667,7,9,3,3
9.151158481422947e+17,1,3,3.0,3,3,1,0
9.151217824410802e+17,21,104,4.9523809523809526,2,7,21,0
9.151264439631299e+17,1,3,3.0,3,3,1,0
9.151513242291162e+17,5,13,2.6,1,4,5,0
9.151586987765567e+17,46,231,5.021739130434782,3,8,45,1
9.151642926159896e+17,9,10,1.1111111111111112,1,2,9,0
9.152130474350103e+17,35,334,9.542857142857143,4,12,3,32
9.152358307307859e+17,13,65,5.0,3,6,13,0
9.153173324454054e+17,9,86,9.555555555555555,8,11,0,9
9.153438714934382e+17,35,239,6.828571428571428,2,10,26,9
9.155262392980536e+17,48,340,7.083333333333333,2,10,28,20
9.15565520507185e+17,19,167,8.789473684210526,2,11,5,14
9.1558115327424e+17,2,17,8.5,8,9,0,2
9.155840703875251e+17,60,300,5.0,2,7,60,0
9.156281517274684e+17,4,12,3.0,2,5,4,0
9.156571854360068e+17,35,238,6.8,3,9,25,10
9.156676442045578e+17,10,77,7.7,5,11,5,5
9.157036837230698e+17,48,241,5.020833333333333,2,8,47,1
9.157128512522132e+17,6,10,1.6666666666666667,1,3,6,0
9.15780463533651e+17,104,511,4.913461538461538,2,7,104,0
9.157943593535185e+17,1,3,3.0,3,3,1,0
9.158276605965276e+17,48,64,1.3333333333333333,1,3,48,0
9.158719811560975e+17,10,49,4.9,4,6,10,0
9.158951811859592e+17,49,472,9.63265306122449,2,12,2,47
9.159389018932745e+17,2,9,4.5,3,6,2,0
9.159479645425073e+17,29,143,4.931034482758621,3,7,29,0
9.159652685912192e+17,4,24,6.0,3,9,2,2
9.160254336170212e+17,13,63,4.846153846153846,3,6,13,0
9.160383832104164e+17,5,37,7.4,2,9,1,4
9.161268800003159e+17,61,591,9.688524590163935,6,12,3,58
9.163910338221522e+17,92,474,5.1521739130434785,2,7,92,0
9.16396391126227e+17,11,81,7.363636363636363,4,9,6,5
9.16400170033442e+17,22,215,9.772727272727273,5,13,2,20
9.16431314397903e+17,77,383,4.974025974025974,2,7,77,0
9.165147645542196e+17,3,5,1.6666666666666667,1,2,3,0
9.165152509810547e+17,66,554,8.393939393939394,2,11,11,55
9.166354649486591e+17,85,757,8.905882352941177,3,11,3,82
9.166537758184256e+17,112,748,6.678571428571429,3,9,86,26
9.166745125886495e+17,1,3,3.0,3,3,1,0
9.16676386511132e+17,8,80,10.0,9,11,0,8
9.166798225920494e+17,11,109,9.909090909090908,8,11,0,11
9.166812429067862e+17,22,103,4.681818181818182,2,7,22,0
9.166844830254856e+17,8,40,5.0,4,6,8,0
9.166885830881418e+17,65,568,8.738461538461538,2,11,7,58
9.166984613361915e+17,24,117,4.875,3,7,24,0
9.167272109121818e+17,5,42,8.4,7,10,1,4
9.1677006859721e+17,28,55,1.9642857142857142,1,3,28,0
9.167845548084195e+17,9,54,6.0,2,8,8,1
9.167934519755167e+17,49,90,1.836734693877551,1,4,49,0
9.170804077704398e+17,8,12,1.5,1,3,8,0
9.170812824756366e+17,5,10,2.0,1,4,5,0
9.17098747743753e+17,9,12,1.3333333333333333,1,3,9,0
9.171041977511208e+17,1,6,6.0,6,6,1,0
9.17118093890405e+17,14,98,7.0,6,9,13,1
9.171289673365225e+17,52,263,5.0576923076923075,3,8,51,1
9.171602080957627e+17,7,10,1.4285714285714286,1,2,7,0
9.171648283101083e+17,74,159,2.1486486486486487,1,4,74,0
9.171822495003521e+17,7,13,1.8571428571428572,1,4,7,0
9.172037701811798e+17,1,7,7.0,7,7,1,0
9.17211329375139e+17,8,54,6.75,2,9,5,3
9.17214987337225e+17,9,74,8.222222222222221,6,11,3,6
9.172180441433354e+17,2,6,3.0,3,3,2,0
9.172182716562833e+17,63,133,2.111111111111111,1,4,63,0
9.172188592698694e+17,70,160,2.2857142857142856,1,5,70,0
9.172226996622336e+17,30,64,2.1333333333333333,1,4,30,0
9.172359279780465e+17,13,37,2.8461538461538463,1,5,13,0
9.172417972713678e+17,117,367,3.1367521367521367,1,5,117,0
9.17285739194818e+17,2,7,3.5,3,4,2,0
9.173066969518838e+17,2,2,1.0,1,1,2,0
9.173175812387702e+17,7,34,4.857142857142857,4,6,7,0
9.173221526771964e+17,9,21,2.3333333333333335,1,3,9,0
9.173494635289428e+17,104,506,4.865384615384615,2,7,104,0
9.173991327971059e+17,66,452,6.848484848484849,2,10,39,27
9.174031593904411e+17,14,99,7.071428571428571,5,8,10,4
9.174509304773644e+17,66,132,2.0,1,4,66,0
9.174545960321082e+17,17,119,7.0,5,9,13,4
9.174754656981892e+17,2,10,5.0,5,5,2,0
9.174787792951045e+17,53,118,2.2264150943396226,1,5,53,0
9.174917700607313e+17,22,100,4.545454545454546,2,6,22,0
9.176079697982154e+17,5,15,3.0,2,4,5,0
9.177331614826164e+17,124,939,7.57258064516129,2,10,46,78
9.177783234356692e+17,10,17,1.7,1,3,10,0
9.17793375001282e+17,1,4,4.0,4,4,1,0
9.17793490426281e+17,2,6,3.0,3,3,2,0
9.177935834197828e+17,1,9,9.0,9,9,0,1
9.178009725110723e+17,12,99,8.25,2,11,3,9
9.178121713013542e+17,1,3,3.0,3,3,1,0
9.17856515687058e+17,2,11,5.5,4,7,2,0
9.178598339523735e+17,8,19,2.375,1,4,8,0
9.17862026556236e+17,5,10,2.0,1,3,5,0
9.178631127959084e+17,44,300,6.818181818181818,3,9,30,14
9.178747760646412e+17,1,2,2.0,2,2,1,0
9.178789530155469e+17,4,15,3.75,3,4,4,0
9.178932679551453e+17,8,19,2.375,2,3,8,0
9.178993797821901e+17,61,238,3.901639344262295,2,6,61,0
9.17921589883376e+17,26,129,4.961538461538462,2,7,26,0
9.17927860206047e+17,8,16,2.0,1,3,8,0
9.179388574144541e+17,1,3,3.0,3,3,1,0
9.179438300873754e+17,21,40,1.9047619047619047,1,3,21,0
9.179471509259694e+17,3,17,5.666666666666667,5,6,3,0
9.179855547491222e+17,18,94,5.222222222222222,2,8,17,1
9.180013113608178e+17,6,11,1.8333333333333333,1,3,6,0
9.180089253162212e+17,169,1190,7.041420118343195,2,9,115,54
9.18021089027194e+17,14,144,10.285714285714286,9,12,0,14
9.180249008876908e+17,1,8,8.0,8,8,0,1
9.180411347281042e+17,56,532,9.5,3,13,8,48
9.180580247270918e+17,1,3,3.0,3,3,1,0
9.180700802010417e+17,82,171,2.0853658536585367,1,4,82,0
9.181649826893436e+17,14,19,1.3571428571428572,1,3,14,0
9.181772835940564e+17,1,2,2.0,2,2,1,0
9.182107411971909e+17,46,234,5.086956521739131,3,6,46,0
9.182522501194427e+17,38,74,1.9473684210526316,1,3,38,0
9.182536739384429e+17,17,128,7.529411764705882,6,9,8,9
9.182826468818897e+17,12,109,9.083333333333334,6,10,1,11
9.183008588304392e+17,17,36,2.1176470588235294,1,4,17,0
9.184866879922021e+17,37,216,5.837837837837838,2,8,35,2
9.184980076218724e+17,42,424,10.095238095238095,5,13,1,41
9.185334693697307e+17,27,135,5.0,2,7,27,0
9.185418383475732e+17,45,129,2.8666666666666667,1,5,45,0
9.185476971317042e+17,31,58,1.8709677419354838,1,5,31,0
9.185704051240554e+17,44,216,4.909090909090909,2,8,43,1
9.185801515528147e+17,22,113,5.136363636363637,3,8,21,1
9.185818717374506e+17,43,291,6.767441860465116,4,9,32,11
9.186231705134936e+17,29,37,1.2758620689655173,1,2,29,0
9.186290697714054e+17,98,664,6.775510204081633,2,9,73,25
9.186437124047711e+17,17,68,4.0,3,5,17,0
9.186628144425617e+17,1,6,6.0,6,6,1,0
9.186771637346822e+17,69,657,9.521739130434783,3,12,5,64
9.186988054914797e+17,18,165,9.166666666666666,3,11,3,15
9.187024290830788e+17,2,20,10.0,9,11,0,2
9.187100235339562e+17,2,17,8.5,8,9,0,2
9.187288570840038e+17,178,1557,8.747191011235955,2,12,18,160
9.187480569404353e+17,45,235,5.222222222222222,4,8,44,1
9.187637595327771e+17,30,142,4.733333333333333,3,8,28,2
9.187638287168915e+17,126,1200,9.523809523809524,2,13,10,116
9.187724658446945e+17,77,303,3.935064935064935,1,7,77,0
9.187758170537955e+17,10,66,6.6,4,8,8,2
9.187787923465458e+17,12,60,5.0,3,7,12,0
9.187843223236895e+17,1,3,3.0,3,3,1,0
9.187905864707972e+17,12,59,4.916666666666667,4,6,12,0
9.187917511004154e+17,14,139,9.928571428571429,9,11,0,14
9.187921291289062e+17,10,24,2.4,1,3,10,0
9.188095454545367e+17,5,27,5.4,4,8,4,1
9.189071626394369e+17,7,62,8.857142857142858,6,10,1,6
9.189337277390095e+17,75,500,6.666666666666667,2,10,52,23
9.189487712892888e+17,67,463,6.91044776119403,4,10,47,20
9.189549809401258e+17,4,33,8.25,7,9,1,3
9.189601319906533e+17,5,37,7.4,6,9,2,3
9.189753565925637e+17,4,7,1.75,1,3,4,0
9.189931619266423e+17,2,5,2.5,2,3,2,0
9.190103756019391e+17,1,8,8.0,8,8,0,1
9.190142899041979e+17,2,14,7.0,5,9,1,1
9.19019430332809e+17,2,15,7.5,6,9,1,1
9.191684738661069e+17,1,7,7.0,7,7,1,0
9.19207501626723e+17,35,105,3.0,1,5,35,0
9.192254779212003e+17,3,5,1.6666666666666667,1,2,3,0
9.1922569559271e+17,22,195,8.863636363636363,3,11,3,19
9.192374556962483e+17,16,78,4.875,4,6,16,0
9.192408579959411e+17,2,4,2.0,1,3,2,0
9.19278871669781e+17,1,4,4.0,4,4,1,0
9.193023564692211e+17,76,588,7.7368421052631575,5,10,31,45
9.193280422684727e+17,21,74,3.5238095238095237,2,5,21,0
9.193508115772192e+17,1,1,1.0,1,1,1,0
9.193674183534771e+17,3,7,2.3333333333333335,1,3,3,0
9.19403696847015e+17,21,40,1.9047619047619047,1,4,21,0
9.194084637549901e+17,17,52,3.0588235294117645,2,4,17,0
9.194124997136535e+17,22,48,2.1818181818181817,1,4,22,0
9.194612306051864e+17,38,333,8.763157894736842,3,11,5,33
9.194666745436141e+17,50,107,2.14,1,4,50,0
9.194691501951519e+17,2,4,2.0,1,3,2,0
9.194889209316808e+17,33,230,6.96969696969697,2,9,22,11
9.195274209095003e+17,107,545,5.093457943925234,3,7,107,0
9.195503867848718e+17,46,89,1.934782608695652,1,3,46,0
9.195638186727773e+17,48,65,1.3541666666666667,1,3,48,0
9.195694476193184e+17,51,94,1.8431372549019607,1,4,51,0
9.195873928801161e+17,107,948,8.85981308411215,6,11,9,98
9.195959625062735e+17,4,36,9.0,8,10,0,4
9.196553294521684e+17,91,458,5.032967032967033,2,8,89,2
9.197184465570665e+17,46,189,4.108695652173913,2,7,46,0
9.199600710541166e+17,76,708,9.31578947368421,2,12,8,68
9.200221546614509e+17,5,38,7.6,6,9,2,3
9.200404161047628e+17,4,30,7.5,7,8,2,2
9.200412752949655e+17,2,11,5.5,5,6,2,0
9.200515857056393e+17,4,25,6.25,4,7,4,0
9.200538230121431e+17,20,61,3.05,2,5,20,0
9.200707422559137e+17,14,51,3.642857142857143,2,5,14,0
9.200860531753591e+17,41,245,5.975609756097561,2,8,39,2
9.201097799672242e+17,1,3,3.0,3,3,1,0
9.201176166244755e+17,70,291,4.1571428571428575,1,8,69,1
9.201642959423277e+17,14,24,1.7142857142857142,1,4,14,0
9.201674615280928e+17,9,21,2.3333333333333335,1,4,9,0
9.201692182798971e+17,45,226,5.022222222222222,2,8,44,1
9.201996363194569e+17,41,207,5.048780487804878,3,7,41,0
9.202284919461539e+17,4,28,7.0,6,8,3,1
9.202325833096324e+17,4,9,2.25,2,3,4,0
9.202351446388911e+17,13,40,3.076923076923077,1,5,13,0
9.202360251101491e+17,20,187,9.35,3,12,1,19
9.202501411199807e+17,8,34,4.25,3,6,8,0
9.202502272367596e+17,39,190,4.871794871794871,2,7,39,0
9.202504547921257e+17,1,2,2.0,2,2,1,0
9.202524590620646e+17,19,99,5.2105263157894735,2,8,18,1
9.20273263526551e+17,56,268,4.785714285714286,2,8,55,1
9.202946610898077e+17,38,102,2.6842105263157894,1,5,38,0
9.203297008768837e+17,44,292,6.636363636363637,2,9,32,12
9.203496804061144e+17,20,99,4.95,3,7,20,0
9.20400012917956e+17,59,574,9.728813559322035,3,12,6,53
9.204678007051384e+17,68,613,9.014705882352942,4,11,6,62
9.205227833107066e+17,91,793,8.714285714285714,2,12,9,82
9.206456547797499e+17,3,7,2.3333333333333335,2,3,3,0
9.207196082963827e+17,21,193,9.19047619047619,2,11,2,19
9.207402312214692e+17,18,26,1.4444444444444444,1,3,18,0
9.207761204220408e+17,67,272,4.059701492537314,2,6,67,0
9.207807060734131e+17,4,28,7.0,6,8,3,1
9.208067949280184e+17,2,3,1.5,1,2,2,0
9.208136681801901e+17,83,236,2.8433734939759034,1,5,83,0
9.208146702704028e+17,63,627,9.952380952380953,6,13,2,61
9.208158115421108e+17,3,23,7.666666666666667,7,8,1,2
9.208198925901012e+17,14,46,3.2857142857142856,1,5,14,0
9.208496978176462e+17,16,86,5.375,4,7,16,0
9.208888087260303e+17,79,401,5.075949367088608,2,7,79,0
9.209491963743462e+17,6,33,5.5,5,6,6,0
9.210092723259116e+17,1,7,7.0,7,7,1,0
9.210309871080826e+17,33,101,3.0606060606060606,1,5,33,0
9.210392278440381e+17,45,124,2.7555555555555555,1,5,45,0
9.210467421329737e+17,62,619,9.983870967741936,4,12,2,60
9.213858472047348e+17,1,1,1.0,1,1,1,0
9.213957426548334e+17,3,23,7.666666666666667,7,8,1,2
9.215090637172049e+17,2,6,3.0,3,3,2,0
9.215848894886665e+17,22,212,9.636363636363637,7,11,1,21
9.215968326698591e+17,53,257,4.849056603773585,2,8,52,1
9.216122254720328e+17,6,20,3.3333333333333335,3,4,6,0
9.216164952818934e+17,1,3,3.0,3,3,1,0
9.216250333954111e+17,44,412,9.363636363636363,2,12,6,38
9.216520709117615e+17,36,179,4.972222222222222,2,7,36,0
9.216669336948942e+17,20,122,6.1,2,9,18,2
9.216847770205651e+17,89,870,9.775280898876405,3,12,7,82
9.217036441840188e+17,5,31,6.2,2,8,3,2
9.21708393016271e+17,50,102,2.04,1,4,50,0
9.217085240065559e+17,19,75,3.9473684210526314,2,6,19,0
9.21727394920033e+17,90,621,6.9,3,9,61,29
9.217414605803455e+17,18,166,9.222222222222221,3,11,2,16
9.21745691927329e+17,1,2,2.0,2,2,1,0
9.217505599736639e+17,116,562,4.844827586206897,2,7,116,0
9.217508946137989e+17,9,22,2.4444444444444446,1,4,9,0
9.217653877767154e+17,13,133,10.23076923076923,9,13,0,13
9.218350587457983e+17,2,4,2.0,1,3,2,0
9.221680786156147e+17,4,23,5.75,5,6,4,0
9.221701886290748e+17,1,2,2.0,2,2,1,0
9.221834445093572e+17,2,17,8.5,8,9,0,2
9.22188055021049e+17,72,696,9.666666666666666,4,13,6,66
9.222230828845096e+17,13,90,6.923076923076923,6,8,11,2
9.22237460804422e+17,34,48,1.411764705882353,1,3,34,0
9.222523539636541e+17,3,18,6.0,2,8,1,2
9.2225618922665e+17,5,32,6.4,5,8,4,1
9.222614466193069e+17,1,8,8.0,8,8,0,1
9.222618562100215e+17,20,191,9.55,6,11,1,19
9.222635175649489e+17,30,111,3.7,1,6,30,0
9.222690229109661e+17,1,6,6.0,6,6,1,0
9.222713323193126e+17,1,2,2.0,2,2,1,0
9.222747564252631e+17,1,10,10.0,10,10,0,1
9.222781416640618e+17,11,112,10.181818181818182,8,11,0,11
9.222794857250062e+17,37,186,5.027027027027027,3,8,35,2
9.222902073918029e+17,8,58,7.25,6,9,5,3
9.223124794074303e+17,5,35,7.0,5,8,3,2
9.223224429266561e+17,4,32,8.0,7,9,1,3
9.223318955666825e+17,1,6,6.0,6,6,1,0
9.223371020692918e+17,68,675,9.926470588235293,5,13,3,65
9.223443507599473e+17,2,7,3.5,3,4,2,0
9.223574612058253e+17,41,88,2.1463414634146343,1,4,41,0
9.223732038752078e+17,4,28,7.0,6,8,2,2
9.223811686188019e+17,1,6,6.0,6,6,1,0
9.223824031832739e+17,7,9,1.2857142857142858,1,2,7,0
9.223926351554113e+17,31,208,6.709677419354839,3,8,24,7
9.223993366432462e+17,67,461,6.880597014925373,3,9,48,19
9.224088560306152e+17,50,464,9.28,3,12,8,42
9.22451417255213e+17,22,208,9.454545454545455,7,12,2,20
9.224529013608915e+17,62,308,4.967741935483871,3,7,62,0
9.224623215184904e+17,58,396,6.827586206896552,2,9,39,19
9.224693748191924e+17,134,657,4.902985074626866,2,7,134,0
9.224867966372627e+17,7,52,7.428571428571429,6,10,5,2
9.225030582993473e+17,72,346,4.805555555555555,2,7,72,0
9.225605311717914e+17,6,8,1.3333333333333333,1,2,6,0
9.225716442582536e+17,2,3,1.5,1,2,2,0
9.226188779730426e+17,9,14,1.5555555555555556,1,3,9,0
9.227402614496518e+17,123,813,6.609756097560975,2,9,97,26
9.228605210484557e+17,2,5,2.5,2,3,2,0
9.229217216033137e+17,5,40,8.0,7,9,1,4
9.229286928734083e+17,7,49,7.0,6,8,5,2
9.229296141206415e+17,23,154,6.695652173913044,3,8,17,6
9.229332555881828e+17,6,13,2.1666666666666665,2,3,6,0
9.229361151394616e+17,7,51,7.285714285714286,5,9,3,4
9.22936435291234e+17,11,93,8.454545454545455,7,11,2,9
9.2294059374637e+17,7,50,7.142857142857143,6,8,3,4
9.229426172791732e+17,2,15,7.5,7,8,1,1
9.22946919058009e+17,37,246,6.648648648648648,2,9,26,11
9.229490995726039e+17,8,57,7.125,6,8,6,2
9.229611766098093e+17,10,24,2.4,1,4,10,0
9.230356645962583e+17,20,49,2.45,1,5,20,0
9.230457343511598e+17,1,7,7.0,7,7,1,0
9.230579999936317e+17,8,20,2.5,1,4,8,0
9.230664026496964e+17,5,11,2.2,1,4,5,0
9.230688508151278e+17,23,64,2.782608695652174,1,4,23,0
9.230763319793242e+17,81,162,2.0,1,4,81,0
9.230824866465085e+17,96,913,9.510416666666666,3,12,8,88
9.23102829851098e+17,2,12,6.0,4,8,1,1
9.23113378127736e+17,9,20,2.2222222222222223,1,4,9,0
9.231200080436123e+17,45,432,9.6,3,12,3,42
9.23123230115394e+17,93,904,9.720430107526882,2,13,7,86
9.231262268231218e+17,42,82,1.9523809523809523,1,4,42,0
9.231355011453222e+17,112,1078,9.625,2,12,7,105
9.231361218231479e+17,11,113,10.272727272727273,9,12,0,11
9.231467558369313e+17,112,1120,10.0,2,12,5,107
9.232081610883832e+17,32,281,8.78125,7,11,1,31
9.23238112538423e+17,47,229,4.872340425531915,2,8,46,1
9.232403175141069e+17,11,96,8.727272727272727,8,10,0,11
9.232843477415907e+17,2,7,3.5,3,4,2,0
9.233688920161486e+17,73,214,2.9315068493150687,1,5,73,0
9.233877571057056e+17,15,28,1.8666666666666667,1,4,15,0
9.23519341298619e+17,67,329,4.91044776119403,2,8,66,1
9.236122424415233e+17,36,350,9.722222222222221,6,12,3,33
9.236774588428244e+17,40,192,4.8,2,7,40,0
9.237000503495136e+17,2,13,6.5,6,7,2,0
9.237404457452756e+17,106,623,5.877358490566038,2,8,105,1
9.238045165505573e+17,22,111,5.045454545454546,3,7,22,0
9.238414706944403e+17,9,21,2.3333333333333335,1,4,9,0
9.238505295726632e+17,5,34,6.8,6,8,4,1
9.238534411021926e+17,107,1026,9.588785046728972,2,12,6,101
9.238628447948886e+17,76,718,9.447368421052632,3,12,7,69
9.238638100531973e+17,49,284,5.795918367346939,3,9,45,4
9.238882291963237e+17,39,234,6.0,3,9,35,4
9.238922158047987e+17,12,39,3.25,1,4,12,0
9.23919197942212e+17,22,91,4.136363636363637,2,5,22,0
9.23927355365736e+17,22,148,6.7272727272727275,4,8,14,8
9.239933883382156e+17,11,65,5.909090909090909,5,8,10,1
9.240041487210377e+17,18,120,6.666666666666667,5,8,14,4
9.240108273656966e+17,16,95,5.9375,5,8,15,1
9.240167171221838e+17,12,68,5.666666666666667,5,7,12,0
9.240271010311145e+17,38,116,3.0526315789473686,1,5,38,0
9.240416539879715e+17,68,461,6.779411764705882,3,9,46,22
9.243622874860298e+17,52,344,6.615384615384615,2,10,38,14
9.243848082123736e+17,36,244,6.777777777777778,2,9,28,8
9.24390829072073e+17,11,22,2.0,1,3,11,0
9.243962449130528e+17,6,16,2.6666666666666665,2,4,6,0
9.244073669612403e+17,1,7,7.0,7,7,1,0
9.244442025011428e+17,27,60,2.2222222222222223,1,4,27,0
9.244749979598084e+17,33,127,3.8484848484848486,2,6,33,0
9.244797173847214e+17,18,124,6.888888888888889,2,9,11,7
9.244810053039414e+17,37,180,4.864864864864865,3,8,36,1
9.245033680867886e+17,3,6,2.0,1,3,3,0
9.245151353144567e+17,2,3,1.5,1,2,2,0
9.245192678801897e+17,2,3,1.5,1,2,2,0
9.245258712539447e+17,1,3,3.0,3,3,1,0
9.245265628198186e+17,7,67,9.571428571428571,8,11,0,7
9.245275091695066e+17,15,55,3.6666666666666665,3,6,15,0
9.245304977366341e+17,71,358,5.042253521126761,2,7,71,0
9.245325446269678e+17,4,22,5.5,5,6,4,0
9.245369602822555e+17,2,4,2.0,1,3,2,0
9.245436082029727e+17,76,155,2.039473684210526,1,5,76,0
9.245503220358299e+17,33,74,2.242424242424242,1,5,33,0
9.245620326776237e+17,89,272,3.056179775280899,1,5,89,0
9.245668529186088e+17,29,206,7.103448275862069,4,9,18,11
9.24567951105714e+17,1,1,1.0,1,1,1,0
9.245691510495121e+17,3,5,1.6666666666666667,1,2,3,0
9.245715371980118e+17,11,70,6.363636363636363,2,8,9,2
9.24571634621889e+17,1,3,3.0,3,3,1,0
9.245744754740156e+17,19,126,6.631578947368421,2,9,15,4
9.245746213422088e+17,34,228,6.705882352941177,2,9,27,7
9.245785389380335e+17,24,173,7.208333333333333,5,9,14,10
9.245830347387997e+17,309,2689,8.702265372168284,2,13,34,275
9.246252927302849e+17,17,156,9.176470588235293,8,11,0,17
9.246489933085818e+17,10,18,1.8,1,4,10,0
9.246506147078653e+17,3,6,2.0,1,3,3,0
9.246800638962348e+17,20,139,6.95,5,9,12,8
9.247276640118033e+17,92,344,3.739130434782609,1,6,92,0
9.247306765324605e+17,15,26,1.7333333333333334,1,3,15,0
9.247509187220979e+17,2,4,2.0,1,3,2,0
9.249374590137962e+17,5,5,1.0,1,1,5,0
9.251083568976773e+17,13,41,3.1538461538461537,2,7,13,0
9.251113486998971e+17,8,50,6.25,3,8,6,2
9.251330467613546e+17,20,43,2.15,1,4,20,0
9.251624530147199e+17,1,6,6.0,6,6,1,0
9.251670655962561e+17,15,27,1.8,1,4,15,0
9.25206414371308e+17,22,50,2.272727272727273,1,5,22,0
9.252254320237942e+17,13,28,2.1538461538461537,1,4,13,0
9.252369386009162e+17,91,878,9.648351648351648,2,12,5,86
9.252849538802854e+17,91,793,8.714285714285714,2,12,13,78
9.253239255579461e+17,23,46,2.0,1,4,23,0
9.25361690404828e+17,5,10,2.0,1,3,5,0
9.253755103496458e+17,49,198,4.040816326530612,2,6,49,0
9.253793171098373e+17,32,225,7.03125,5,9,23,9
9.254103257979812e+17,35,336,9.6,3,12,2,33
9.254643456914061e+17,8,18,2.25,1,4,8,0
9.254671131557243e+17,1,9,9.0,9,9,0,1
9.254776042233857e+17,1,5,5.0,5,5,1,0
9.258397744903535e+17,32,163,5.09375,3,8,31,1
9.259013702833992e+17,4,17,4.25,2,6,4,0
9.259088637691315e+17,50,286,5.72,2,9,47,3
9.259243150326598e+17,117,465,3.9743589743589745,1,6,117,0
9.259302424674938e+17,4,26,6.5,5,9,3,1
9.259937164058944e+17,7,72,10.285714285714286,9,12,0,7
9.260071922535892e+17,19,199,10.473684210526315,9,12,0,19
9.260184843437585e+17,5,13,2.6,1,6,5,0
9.260524260217777e+17,1,2,2.0,2,2,1,0
9.260924147141298e+17,30,78,2.6,1,5,30,0
9.260926851178848e+17,8,62,7.75,6,11,4,4
9.262283820154981e+17,42,287,6.833333333333333,5,9,34,8
9.26268509935219e+17,35,329,9.4,2,12,1,34
9.264932364724348e+17,3,10,3.3333333333333335,3,4,3,0
9.265132037823429e+17,45,439,9.755555555555556,3,13,2,43
9.265606009822221e+17,17,157,9.235294117647058,3,11,2,15
9.266782694316652e+17,11,73,6.636363636363637,5,8,10,1
9.266809263956904e+17,4,8,2.0,1,3,4,0
9.266894869722616e+17,1,7,7.0,7,7,1,0
9.266923768482176e+17,1,1,1.0,1,1,1,0
9.267678847314825e+17,102,530,5.196078431372549,2,8,101,1
9.26777300204127e+17,2,13,6.5,6,7,2,0
9.267970805909763e+17,42,419,9.976190476190476,7,12,1,41
9.268122415222813e+17,13,108,8.307692307692308,2,10,4,9
9.268782888234209e+17,6,17,2.8333333333333335,1,4,6,0
9.268799773426728e+17,1,11,11.0,11,11,0,1
9.269383931137569e+17,45,218,4.844444444444444,2,7,45,0
9.2694001057767e+17,15,145,9.666666666666666,7,12,1,14
9.271207563732058e+17,12,81,6.75,4,8,10,2
9.272019941411552e+17,6,34,5.666666666666667,5,7,6,0
9.272657611803195e+17,20,37,1.85,1,4,20,0
9.273113680957577e+17,2,6,3.0,3,3,2,0
9.273126338429332e+17,26,178,6.846153846153846,5,9,20,6
9.273373277924129e+17,16,108,6.75,2,9,11,5
9.273566805741985e+17,8,35,4.375,3,7,8,0
9.273657741012504e+17,1,3,3.0,3,3,1,0
9.273910226743023e+17,6,9,1.5,1,3,6,0
9.273954588949097e+17,3,29,9.666666666666666,8,11,0,3
9.273969940735191e+17,42,366,8.714285714285714,7,10,7,35
9.274202725625188e+17,4,35,8.75,8,10,0,4
9.274577084888576e+17,7,61,8.714285714285714,7,11,2,5
9.27474443628059e+17,3,7,2.3333333333333335,2,3,3,0
9.274958816136128e+17,2,13,6.5,5,8,1,1
9.27528844340187e+17,8,48,6.0,3,8,7,1
9.275442892625851e+17,28,116,4.142857142857143,2,7,28,0
9.27556775975048e+17,47,417,8.872340425531915,2,11,5,42
9.275648293891021e+17,1,6,6.0,6,6,1,0
9.279670122789431e+17,36,352,9.777777777777779,4,12,1,35
9.279702032426186e+17,9,69,7.666666666666667,4,10,5,4
9.27973273961642e+17,25,44,1.76,1,4,25,0
9.280002403579292e+17,16,28,1.75,1,3,16,0
9.280147667358798e+17,7,44,6.285714285714286,4,7,7,0
9.28014913573533e+17,7,49,7.0,6,9,5,2
9.280150458679041e+17,31,207,6.67741935483871,3,9,22,9
9.280689186740113e+17,40,194,4.85,2,7,40,0
9.280961611350794e+17,20,41,2.05,1,3,20,0
9.28097930567024e+17,29,251,8.655172413793103,4,10,4,25
9.281011231327692e+17,37,348,9.405405405405405,4,12,3,34
9.281700893065147e+17,74,212,2.864864864864865,1,5,74,0
9.281802289600134e+17,74,663,8.95945945945946,7,11,3,71
9.28186477149851e+17,68,336,4.9411764705882355,2,7,68,0
9.282097670542614e+17,85,816,9.6,2,12,8,77
9.28218686533457e+17,13,128,9.846153846153847,8,12,0,13
9.282430234520443e+17,55,546,9.927272727272728,7,12,3,52
9.282786712194129e+17,27,104,3.8518518518518516,2,6,27,0
9.286305227658339e+17,8,12,1.5,1,2,8,0
9.286373770671421e+17,3,6,2.0,1,3,3,0
9.28649303420517e+17,28,271,9.678571428571429,3,12,2,26
9.28684964441864e+17,9,64,7.111111111111111,3,9,5,4
9.287027420091736e+17,25,80,3.2,1,5,25,0
9.287463943305676e+17,2,16,8.0,7,9,1,1
9.287498308342657e+17,11,78,7.090909090909091,5,8,7,4
9.287749823385596e+17,103,705,6.844660194174757,3,10,78,25
9.287799806265821e+17,40,392,9.8,2,12,3,37
9.288093502689837e+17,37,68,1.837837837837838,1,3,37,0
9.288944289478135e+17,25,252,10.08,9,12,0,25
9.289243387972044e+17,52,356,6.846153846153846,5,10,36,16
9.289316601872338e+17,31,301,9.709677419354838,5,12,3,28
9.289463390449213e+17,28,185,6.607142857142857,2,9,21,7
9.28958767931545e+17,2,14,7.0,6,8,1,1
9.289631630083333e+17,1,2,2.0,2,2,1,0
9.289844873230275e+17,3,23,7.666666666666667,7,9,2,1
9.289865244602515e+17,50,152,3.04,2,5,50,0
9.28997321516433e+17,1,1,1.0,1,1,1,0
9.290586957774662e+17,6,13,2.1666666666666665,1,3,6,0
9.290611307502615e+17,34,319,9.382352941176471,3,11,3,31
9.291150395816721e+17,17,40,2.3529411764705883,1,4,17,0
9.293644689942248e+17,11,19,1.7272727272727273,1,3,11,0
9.293666254007817e+17,41,129,3.1463414634146343,1,5,41,0
9.29429625321463e+17,20,99,4.95,3,6,20,0
9.294327913767764e+17,3,8,2.6666666666666665,2,4,3,0
9.294422153093135e+17,16,28,1.75,1,4,16,0
9.294741055030813e+17,2,13,6.5,5,8,1,1
9.294796546344073e+17,15,105,7.0,5,9,11,4
9.294950289592776e+17,12,57,4.75,3,6,12,0
9.294954286533165e+17,25,129,5.16,3,7,25,0
9.29498338073382e+17,1,8,8.0,8,8,0,1
9.294998116434637e+17,99,675,6.818181818181818,3,10,71,28
9.29557713072747e+17,37,56,1.5135135135135136,1,3,37,0
9.295619060868141e+17,46,237,5.1521739130434785,3,7,46,0
9.295888598379452e+17,2,11,5.5,4,7,2,0
9.296069263913734e+17,9,43,4.777777777777778,4,6,9,0
9.296081974553101e+17,8,31,3.875,1,6,8,0
9.2963213184484e+17,1,1,1.0,1,1,1,0
9.296652011151807e+17,170,1170,6.882352941176471,2,10,124,46
9.29689060219196e+17,23,65,2.8260869565217392,2,5,23,0
9.297284509931072e+17,32,41,1.28125,1,3,32,0
9.297541766179887e+17,25,54,2.16,1,4,25,0
9.301307214245747e+17,18,121,6.722222222222222,3,9,13,5
9.301488021858903e+17,37,141,3.810810810810811,2,6,37,0
9.301704305475602e+17,7,70,10.0,9,11,0,7
9.301727545030674e+17,52,264,5.076923076923077,2,7,52,0
9.302160746234876e+17,74,375,5.0675675675675675,2,7,74,0
9.302370311889393e+17,12,31,2.5833333333333335,1,4,12,0
9.302517065832728e+17,7,45,6.428571428571429,5,8,6,1
9.302839351855e+17,22,86,3.909090909090909,2,6,22,0
9.30301702975493e+17,31,210,6.774193548387097,5,10,25,6
9.303556846190515e+17,38,336,8.842105263157896,4,11,3,35
9.303785679990675e+17,17,97,5.705882352941177,4,8,16,1
9.303921222252835e+17,3,8,2.6666666666666665,2,3,3,0
9.303923299517462e+17,7,23,3.2857142857142856,2,5,7,0
9.304350730003624e+17,37,330,8.91891891891892,2,12,6,31
9.304461648580433e+17,216,1094,5.064814814814815,2,8,213,3
9.304958538956073e+17,23,181,7.869565217391305,6,9,5,18
9.305303641938903e+17,1,5,5.0,5,5,1,0
9.306195623487642e+17,1,5,5.0,5,5,1,0
9.306463469986944e+17,1,8,8.0,8,8,0,1
9.30652386386391e+17,1,7,7.0,7,7,1,0
9.306745418092468e+17,1,7,7.0,7,7,1,0
9.306807247566577e+17,1,9,9.0,9,9,0,1
9.307088663550528e+17,1,7,7.0,7,7,1,0
9.307258189675808e+17,1,7,7.0,7,7,1,0
9.307332602341449e+17,1,3,3.0,3,3,1,0
9.307376052443898e+17,2,17,8.5,8,9,0,2
9.307496914951007e+17,2,5,2.5,2,3,2,0
9.307603411210904e+17,1,8,8.0,8,8,0,1
9.307793628294785e+17,3,21,7.0,5,8,1,2
9.30885855984447e+17,6,11,1.8333333333333333,1,3,6,0
9.30897568032086e+17,124,1090,8.790322580645162,2,12,16,108
9.309222793024946e+17,4,26,6.5,6,7,4,0
9.309410731526903e+17,3,18,6.0,5,7,3,0
9.309451997074775e+17,61,121,1.9836065573770492,1,4,61,0
9.310119423417445e+17,50,434,8.68,6,10,5,45
9.310622439544998e+17,39,75,1.9230769230769231,1,4,39,0
9.311263107700806e+17,21,109,5.190476190476191,2,7,21,0
9.31172621051092e+17,1,1,1.0,1,1,1,0
9.311978818712036e+17,48,101,2.1041666666666665,1,4,48,0
9.312247163541019e+17,191,763,3.994764397905759,2,7,191,0
9.312912021879542e+17,25,153,6.12,2,8,22,3
9.31420385438124e+17,93,460,4.946236559139785,2,7,93,0
9.31420390681004e+17,103,507,4.922330097087379,2,7,103,0
9.315271806836531e+17,68,576,8.470588235294118,2,12,9,59
9.315854404325254e+17,69,335,4.855072463768116,2,8,68,1
9.316475079952673e+17,7,36,5.142857142857143,3,7,7,0
9.31665375098972e+17,32,128,4.0,2,6,32,0
9.316667913469203e+17,21,46,2.1904761904761907,1,3,21,0
9.316825884793944e+17,24,164,6.833333333333333,4,9,18,6
9.317765311027661e+17,55,486,8.836363636363636,2,11,3,52
9.317895562515758e+17,52,268,5.153846153846154,2,7,52,0
9.317932563507977e+17,181,733,4.0497237569060776,1,7,181,0
9.317999317535992e+17,18,52,2.888888888888889,2,5,18,0
9.318391243007041e+17,41,204,4.975609756097561,2,7,41,0
9.318486340635752e+17,2,5,2.5,2,3,2,0
9.31858215767639e+17,2,5,2.5,2,3,2,0
9.318598712066405e+17,12,107,8.916666666666666,8,10,0,12
9.318629989112728e+17,30,154,5.133333333333334,3,7,30,0
9.31878770509013e+17,10,42,4.2,3,7,10,0
9.318922503750586e+17,3,13,4.333333333333333,4,5,3,0
9.319362979862879e+17,2,5,2.5,2,3,2,0
9.319903582122048e+17,28,257,9.178571428571429,7,11,1,27
9.320159544553083e+17,2,5,2.5,2,3,2,0
9.320991717534505e+17,10,16,1.6,1,4,10,0
9.322419900058241e+17,27,244,9.037037037037036,2,12,3,24
9.322624111135686e+17,1,4,4.0,4,4,1,0
9.323327249428015e+17,2,5,2.5,2,3,2,0
9.324324719522068e+17,6,52,8.666666666666666,7,11,2,4
9.324777048842877e+17,80,554,6.925,5,9,61,19
9.324847438762168e+17,3,4,1.3333333333333333,1,2,3,0
9.32508202202068e+17,2,20,10.0,10,10,0,2
9.325237291527739e+17,13,126,9.692307692307692,7,12,1,12
9.325443511113069e+17,2,3,1.5,1,2,2,0
9.325488464969074e+17,46,58,1.2608695652173914,1,3,46,0
9.325579639602611e+17,18,178,9.88888888888889,8,13,0,18
9.325606878927159e+17,18,110,6.111111111111111,4,8,16,2
9.326370262270121e+17,94,884,9.404255319148936,3,13,9,85
9.326622858745615e+17,14,29,2.0714285714285716,1,4,14,0
9.326874989342116e+17,12,29,2.4166666666666665,1,4,12,0
9.330002782468438e+17,1,2,2.0,2,2,1,0
9.330056467743992e+17,24,173,7.208333333333333,6,9,14,10
9.330203453697866e+17,1,2,2.0,2,2,1,0
9.330425463001747e+17,77,310,4.025974025974026,1,7,77,0
9.330619344063153e+17,140,1357,9.692857142857143,3,13,10,130
9.330836657612888e+17,50,114,2.28,1,4,50,0
9.330859384653094e+17,33,231,7.0,4,10,21,12
9.330865628752681e+17,1,8,8.0,8,8,0,1
9.330909152508147e+17,1,2,2.0,2,2,1,0
9.331051806659676e+17,38,83,2.1842105263157894,1,5,38,0
9.331171066304667e+17,7,40,5.714285714285714,5,7,7,0
9.332183106133066e+17,26,74,2.8461538461538463,1,4,26,0
9.332300191303721e+17,32,42,1.3125,1,3,32,0
9.332509332706838e+17,19,95,5.0,4,6,19,0
9.332644044123849e+17,12,123,10.25,9,11,0,12
9.332849673166474e+17,32,163,5.09375,3,8,31,1
9.333231361896406e+17,16,158,9.875,8,12,0,16
9.333705173808566e+17,72,512,7.111111111111111,4,10,44,28
9.333737826120806e+17,9,17,1.8888888888888888,1,3,9,0
9.333775172471784e+17,18,36,2.0,1,5,18,0
9.334134013792883e+17,21,107,5.095238095238095,3,7,21,0
9.334234026953349e+17,21,46,2.1904761904761907,1,4,21,0
9.334433609089492e+17,2,4,2.0,2,2,2,0
9.337103791014545e+17,9,64,7.111111111111111,6,8,5,4
9.337816836291363e+17,62,443,7.145161290322581,3,9,38,24
9.337874674869165e+17,4,9,2.25,1,3,4,0
9.337887390495764e+17,2,6,3.0,2,4,2,0
9.337976497307994e+17,39,346,8.871794871794872,2,11,3,36
9.338038157037362e+17,3,17,5.666666666666667,4,8,2,1
9.338216507151441e+17,9,17,1.8888888888888888,1,3,9,0
9.33830702305305e+17,59,458,7.762711864406779,6,10,25,34
9.338589172464709e+17,2,4,2.0,2,2,2,0
9.338631420806758e+17,45,321,7.133333333333334,2,9,25,20
9.33865609174961e+17,137,668,4.875912408759124,2,7,137,0
9.338771681159378e+17,86,164,1.9069767441860466,1,4,86,0
9.338811119287222e+17,31,142,4.580645161290323,2,7,31,0
9.338983801185887e+17,102,769,7.53921568627451,4,10,45,57
9.339076126632276e+17,1,3,3.0,3,3,1,0
9.339079922566203e+17,1,4,4.0,4,4,1,0
9.339274420081582e+17,2,8,4.0,4,4,2,0
9.339346541281289e+17,1,1,1.0,1,1,1,0
9.339606265169686e+17,61,525,8.60655737704918,2,11,8,53
9.33960793050914e+17,9,65,7.222222222222222,4,9,6,3
9.339668868518988e+17,7,10,1.4285714285714286,1,2,7,0
9.33970406253723e+17,3,17,5.666666666666667,4,7,3,0
9.339781930026944e+17,1,2,2.0,2,2,1,0
9.339996580312428e+17,5,37,7.4,6,8,2,3
9.34008450279759e+17,31,153,4.935483870967742,3,7,31,0
9.340173274830867e+17,6,8,1.3333333333333333,1,2,6,0
9.340183881043972e+17,17,28,1.6470588235294117,1,3,17,0
9.340374052049308e+17,1,3,3.0,3,3,1,0
9.340913907781087e+17,80,160,2.0,1,5,80,0
9.34122653019384e+17,5,20,4.0,2,6,5,0
9.341498086361992e+17,30,146,4.866666666666666,3,7,30,0
9.34424791416337e+17,5,20,4.0,3,5,5,0
9.344395743701286e+17,2,8,4.0,3,5,2,0
9.344509835938358e+17,6,23,3.8333333333333335,3,6,6,0
9.344704447140941e+17,47,99,2.106382978723404,1,4,47,0
9.344848464960957e+17,58,409,7.051724137931035,2,10,37,21
9.3450083764927e+17,6,7,1.1666666666666667,1,2,6,0
9.345086309158245e+17,58,391,6.741379310344827,2,9,45,13
9.345167204087809e+17,15,67,4.466666666666667,3,6,15,0
9.345388839023896e+17,98,401,4.091836734693878,1,6,98,0
9.345420851061573e+17,121,483,3.9917355371900825,2,7,121,0
9.345505088242248e+17,59,401,6.796610169491525,4,10,43,16
9.345766736019364e+17,47,231,4.914893617021277,2,8,46,1
9.345860237537777e+17,107,529,4.94392523364486,2,7,107,0
9.345907763639287e+17,17,160,9.411764705882353,3,12,3,14
9.345940869388973e+17,11,17,1.5454545454545454,1,3,11,0
9.346532793172699e+17,10,68,6.8,6,9,7,3
9.34660196501153e+17,11,33,3.0,2,4,11,0
9.347082491252091e+17,1,2,2.0,2,2,1,0
9.347128733300975e+17,217,1048,4.829493087557604,2,8,215,2
9.347142152144063e+17,206,1008,4.893203883495145,2,8,204,2
9.347246848075553e+17,56,74,1.3214285714285714,1,3,56,0
9.347289643382986e+17,145,1097,7.56551724137931,2,10,58,87
9.347450086497043e+17,77,298,3.8701298701298703,1,7,77,0
9.348148767870337e+17,12,35,2.9166666666666665,1,5,12,0
9.348596833764823e+17,79,171,2.1645569620253164,1,5,79,0
9.349217443122866e+17,33,64,1.9393939393939394,1,4,33,0
9.349254504758588e+17,61,133,2.180327868852459,1,4,61,0
9.349625983548234e+17,11,23,2.090909090909091,1,4,11,0
9.352144229758702e+17,37,76,2.054054054054054,1,4,37,0
9.352219013177723e+17,5,10,2.0,1,3,5,0
9.352222650990328e+17,3,11,3.6666666666666665,3,4,3,0
9.352431383353101e+17,1,2,2.0,2,2,1,0
9.35245054966199e+17,1,2,2.0,2,2,1,0
9.352483431551436e+17,2,6,3.0,3,3,2,0
9.352535081215133e+17,1,3,3.0,3,3,1,0
9.353156242159295e+17,14,95,6.785714285714286,4,9,10,4
9.353237714912328e+17,48,246,5.125,3,7,48,0
9.353560692842858e+17,20,47,2.35,1,4,20,0
9.353583765315753e+17,8,19,2.375,1,4,8,0
9.354042243116902e+17,1,6,6.0,6,6,1,0
9.354505900182459e+17,39,378,9.692307692307692,2,12,2,37
9.355062640090601e+17,9,81,9.0,7,10,1,8
9.355314538046973e+17,15,50,3.3333333333333335,2,5,15,0
9.355462175144204e+17,50,152,3.04,1,5,50,0
9.355872003421935e+17,113,991,8.769911504424778,3,12,19,94
9.356105335966089e+17,88,623,7.079545454545454,3,11,57,31
9.358996454934144e+17,15,44,2.933333333333333,1,4,15,0
9.359272339268037e+17,7,15,2.142857142857143,1,3,7,0
9.359757804250403e+17,1,5,5.0,5,5,1,0
9.359978220508897e+17,58,293,5.051724137931035,3,7,58,0
9.360208841016458e+17,68,130,1.911764705882353,1,4,68,0
9.360268177896058e+17,13,27,2.076923076923077,1,4,13,0
9.360294779381554e+17,32,209,6.53125,4,8,26,6
9.360350200204797e+17,5,6,1.2,1,2,5,0
9.361018999009212e+17,88,121,1.375,1,3,88,0
9.36124113320655e+17,6,52,8.666666666666666,4,11,1,5
9.361419516896198e+17,1,3,3.0,3,3,1,0
9.361552812617834e+17,33,157,4.757575757575758,3,7,33,0
9.361619322464765e+17,39,187,4.794871794871795,3,7,39,0
9.361787772174963e+17,1,2,2.0,2,2,1,0
9.361877444615809e+17,55,222,4.036363636363636,1,6,55,0
9.362069571374244e+17,11,73,6.636363636363637,2,8,8,3
9.362378552458938e+17,19,93,4.894736842105263,3,7,19,0
9.362625857493148e+17,3,3,1.0,1,1,3,0
9.363101042418787e+17,17,176,10.352941176470589,8,12,0,17
9.363243158399277e+17,102,956,9.372549019607844,2,12,8,94
9.36325271829555e+17,86,772,8.976744186046512,2,12,8,78
9.364538713046858e+17,6,13,2.1666666666666665,1,4,6,0
9.366333659382003e+17,30,218,7.266666666666667,3,9,13,17
9.366336016394221e+17,26,178,6.846153846153846,5,9,19,7
9.366337545477408e+17,44,333,7.568181818181818,4,10,22,22
9.366339523969596e+17,63,486,7.714285714285714,3,10,21,42
9.36634120461158e+17,19,50,2.6315789473684212,1,4,19,0
9.366343023363741e+17,34,269,7.911764705882353,5,9,10,24
9.366751761353066e+17,1,5,5.0,5,5,1,0
9.366752017118488e+17,11,105,9.545454545454545,8,11,0,11
9.366819317096477e+17,77,110,1.4285714285714286,1,3,77,0
9.36694483969886e+17,4,43,10.75,9,12,0,4
9.36722727821259e+17,19,184,9.68421052631579,8,11,0,19
9.367552502734981e+17,19,131,6.894736842105263,5,9,16,3
9.3678309379565e+17,2,7,3.5,3,4,2,0
9.367850894116699e+17,4,32,8.0,7,9,1,3
9.368027074876059e+17,21,100,4.761904761904762,2,7,21,0
9.368063746056086e+17,5,20,4.0,4,4,5,0
9.368427753124175e+17,40,280,7.0,5,9,26,14
9.368600324067169e+17,33,170,5.151515151515151,3,8,32,1
9.370054156614858e+17,46,384,8.347826086956522,3,11,9,37
9.370965444466586e+17,100,485,4.85,2,7,100,0
9.371360740185596e+17,151,1449,9.596026490066226,2,12,7,144
9.373857889176114e+17,2,5,2.5,2,3,2,0
9.37393297011079e+17,70,214,3.057142857142857,1,6,70,0
9.374052209040004e+17,42,276,6.571428571428571,2,8,37,5
9.374148110458647e+17,25,113,4.52,1,6,25,0
9.374171003495982e+17,1,7,7.0,7,7,1,0
9.374178772135196e+17,70,678,9.685714285714285,3,12,4,66
9.37436802243962e+17,1,4,4.0,4,4,1,0
9.374584469468212e+17,11,25,2.272727272727273,1,4,11,0
9.374674113589596e+17,6,14,2.3333333333333335,1,4,6,0
9.374731363161644e+17,47,97,2.0638297872340425,1,5,47,0
9.37478718853525e+17,29,251,8.655172413793103,4,11,3,26
9.375047168198223e+17,4,15,3.75,2,5,4,0
9.375480106955716e+17,188,905,4.8138297872340425,2,7,188,0
9.375493221125083e+17,20,39,1.95,1,4,20,0
9.375606459479329e+17,5,31,6.2,5,7,5,0
9.376044728421256e+17,1,9,9.0,9,9,0,1
9.376188347485148e+17,38,74,1.9473684210526316,1,4,38,0
9.376189856429417e+17,32,63,1.96875,1,4,32,0
9.376190981413741e+17,24,53,2.2083333333333335,1,4,24,0
9.376307531657138e+17,1,4,4.0,4,4,1,0
9.377026844778674e+17,38,127,3.3421052631578947,1,5,38,0
9.377437565459114e+17,52,296,5.6923076923076925,2,8,47,5
9.377545531721329e+17,23,87,3.782608695652174,2,6,23,0
9.377579003322323e+17,3,26,8.666666666666666,8,9,0,3
9.377942426426501e+17,3,17,5.666666666666667,3,7,3,0
9.378285255344032e+17,58,563,9.706896551724139,2,12,2,56
9.37991361443175e+17,2,13,6.5,6,7,2,0
9.379980476704996e+17,9,54,6.0,2,8,8,1
9.381135887629558e+17,20,41,2.05,1,4,20,0
9.381336686602977e+17,46,238,5.173913043478261,3,7,46,0
9.381346957815379e+17,6,44,7.333333333333333,2,9,2,4
9.381629308126557e+17,1,2,2.0,2,2,1,0
9.381642592697734e+17,1,3,3.0,3,3,1,0
9.38178827839839e+17,6,43,7.166666666666667,6,8,4,2
9.381862660305471e+17,16,110,6.875,5,10,12,4
9.381873405947149e+17,4,27,6.75,6,8,3,1
9.381902726026223e+17,101,688,6.811881188118812,2,9,73,28
9.382065210124289e+17,110,524,4.763636363636364,2,7,110,0
9.382248767148483e+17,9,39,4.333333333333333,2,6,9,0
9.382474153021545e+17,44,93,2.1136363636363638,1,4,44,0
9.38251896502281e+17,5,39,7.8,7,8,1,4
9.382592790990342e+17,7,26,3.7142857142857144,1,5,7,0
9.382935107620005e+17,1,2,2.0,2,2,1,0
9.383165076669335e+17,105,703,6.695238095238095,2,9,80,25
9.383173545660096e+17,73,362,4.958904109589041,2,7,73,0
9.383417510600101e+17,74,356,4.8108108108108105,2,7,74,0
9.383445271721628e+17,54,108,2.0,1,4,54,0
9.383464753535127e+17,44,93,2.1136363636363638,1,4,44,0
9.38401032439653e+17,42,168,4.0,2,5,42,0
9.384074396745958e+17,89,612,6.876404494382022,2,9,66,23
9.384294606955163e+17,73,715,9.794520547945206,4,12,2,71
9.38456721494925e+17,1,3,3.0,3,3,1,0
9.385040988062145e+17,45,396,8.8,2,12,7,38
9.387621663818796e+17,41,397,9.682926829268293,2,12,4,37
9.38813206785202e+17,51,241,4.7254901960784315,2,8,49,2
9.388701877817518e+17,2,14,7.0,7,7,2,0
9.388733931593043e+17,2,15,7.5,7,8,1,1
9.388798534704557e+17,19,39,2.0526315789473686,1,3,19,0
9.388884842526609e+17,2,4,2.0,2,2,2,0
9.389407632424808e+17,1,7,7.0,7,7,1,0
9.389424876896298e+17,1,8,8.0,8,8,0,1
9.389446594818912e+17,10,71,7.1,6,8,7,3
9.389446688659753e+17,4,26,6.5,5,8,3,1
9.389478711017765e+17,1,8,8.0,8,8,0,1
9.38948961109167e+17,1,7,7.0,7,7,1,0
9.389522878990739e+17,1,4,4.0,4,4,1,0
9.389528116003935e+17,62,304,4.903225806451613,3,7,62,0
9.389559866876072e+17,3,15,5.0,3,6,3,0
9.389579380669002e+17,2,4,2.0,1,3,2,0
9.389599686866136e+17,4,10,2.5,2,4,4,0
9.38979826795219e+17,15,109,7.266666666666667,6,9,9,6
9.389867687754915e+17,75,374,4.986666666666666,3,7,75,0
9.390009811639032e+17,4,9,2.25,1,5,4,0
9.390019205588063e+17,2,11,5.5,5,6,2,0
9.39039866937692e+17,3,7,2.3333333333333335,2,3,3,0
9.390942183974675e+17,1,3,3.0,3,3,1,0
9.390942439357015e+17,1,3,3.0,3,3,1,0
9.39094327566812e+17,3,6,2.0,1,3,3,0
9.390943457892581e+17,1,2,2.0,2,2,1,0
9.390946220908671e+17,1,2,2.0,2,2,1,0
9.390946692616676e+17,1,1,1.0,1,1,1,0
9.391027917142552e+17,18,87,4.833333333333333,3,7,18,0
9.391681399721956e+17,2,2,1.0,1,1,2,0
9.391715358088794e+17,4,33,8.25,8,9,0,4
9.39182266106871e+17,4,6,1.5,1,2,4,0
9.392056046775922e+17,3,9,3.0,2,4,3,0
9.395474241888088e+17,148,713,4.8175675675675675,2,7,148,0
9.395887005457983e+17,41,401,9.78048780487805,4,12,1,40
9.395921159676424e+17,12,98,8.166666666666666,2,11,3,9
9.395922838689943e+17,12,106,8.833333333333334,6,11,1,11
9.395937283767611e+17,88,589,6.693181818181818,2,10,64,24
9.396158613231712e+17,86,335,3.895348837209302,1,7,86,0
9.396253170059181e+17,47,236,5.0212765957446805,3,7,47,0
9.39635434356048e+17,10,96,9.6,9,11,0,10
9.396677458153793e+17,42,203,4.833333333333333,3,8,41,1
9.396746884754766e+17,76,546,7.184210526315789,4,10,44,32
9.396804943711864e+17,54,125,2.314814814814815,1,5,54,0
9.396805851859501e+17,32,72,2.25,1,4,32,0
9.396807049008964e+17,51,114,2.235294117647059,1,4,51,0
9.396939297457247e+17,76,290,3.8157894736842106,2,6,76,0
9.39700762192131e+17,52,155,2.980769230769231,1,5,52,0
9.397070138740595e+17,10,103,10.3,10,11,0,10
9.397107022138012e+17,62,319,5.145161290322581,3,7,62,0
9.397474709121379e+17,1,6,6.0,6,6,1,0
9.397573156330395e+17,4,13,3.25,2,5,4,0
9.397588870606697e+17,12,28,2.3333333333333335,1,4,12,0
9.397617541285225e+17,3,15,5.0,4,6,3,0
9.397633986485432e+17,3,16,5.333333333333333,5,6,3,0
9.397702312273393e+17,2,8,4.0,3,5,2,0
9.397735083021585e+17,1,3,3.0,3,3,1,0
9.397928782198707e+17,36,80,2.2222222222222223,1,4,36,0
9.397940252917522e+17,78,396,5.076923076923077,2,7,78,0
9.398175485883951e+17,7,18,2.5714285714285716,1,4,7,0
9.399387785907288e+17,1,1,1.0,1,1,1,0
9.399569441649745e+17,33,228,6.909090909090909,5,9,25,8
9.402787478004022e+17,1,2,2.0,2,2,1,0
9.402815452176788e+17,24,235,9.791666666666666,8,13,0,24
9.402817705634289e+17,1,2,2.0,2,2,1,0
9.402906025360736e+17,3,5,1.6666666666666667,1,2,3,0
9.402962304397294e+17,12,103,8.583333333333334,7,11,2,10
9.403021935830765e+17,7,32,4.571428571428571,3,6,7,0
9.403025063306708e+17,1,10,10.0,10,10,0,1
9.403221538891462e+17,8,13,1.625,1,3,8,0
9.403544675190276e+17,39,194,4.9743589743589745,2,8,38,1
9.403818756633741e+17,3,14,4.666666666666667,3,6,3,0
9.403819091903263e+17,26,103,3.9615384615384617,2,6,26,0
9.403848868884334e+17,12,22,1.8333333333333333,1,3,12,0
9.403848940875665e+17,7,11,1.5714285714285714,1,3,7,0
9.403929260618349e+17,10,93,9.3,5,11,1,9
9.404013878260856e+17,25,31,1.24,1,2,25,0
9.404020251243965e+17,19,60,3.1578947368421053,1,4,19,0
9.404095656354016e+17,63,137,2.1746031746031744,1,5,63,0
9.404219689073432e+17,13,23,1.7692307692307692,1,3,13,0
9.404312579531898e+17,17,20,1.1764705882352942,1,2,17,0
9.405129103133449e+17,21,204,9.714285714285714,3,12,2,19
9.405166222436605e+17,11,23,2.090909090909091,1,3,11,0
9.405561870562794e+17,3,3,1.0,1,1,3,0
9.405605291725016e+17,11,75,6.818181818181818,5,9,9,2
9.40576655743592e+17,7,65,9.285714285714286,8,12,0,7
9.405813188815077e+17,4,15,3.75,1,6,4,0
9.405836231129997e+17,2,3,1.5,1,2,2,0
9.40595949316958e+17,1,5,5.0,5,5,1,0
9.406051639965635e+17,58,500,8.620689655172415,4,10,9,49
9.40614491966192e+17,2,8,4.0,4,4,2,0
9.406163341117688e+17,45,226,5.022222222222222,3,9,44,1
9.406242023811226e+17,71,697,9.816901408450704,2,13,3,68
9.40624284062687e+17,7,9,1.2857142857142858,1,2,7,0
9.406246063308129e+17,56,553,9.875,2,13,3,53
9.40632708131124e+17,9,43,4.777777777777778,3,6,9,0
9.409935353189623e+17,16,80,5.0,3,6,16,0
9.410156671232177e+17,4,10,2.5,1,4,4,0
9.410226513946822e+17,46,95,2.0652173913043477,1,4,46,0
9.410284352577684e+17,72,695,9.652777777777779,2,13,3,69
9.410338819151297e+17,16,42,2.625,1,5,16,0
9.410918800328445e+17,25,170,6.8,3,9,16,9
9.410973932029043e+17,41,164,4.0,2,6,41,0
9.411146553743976e+17,30,208,6.933333333333334,4,9,19,11
9.41218514733066e+17,5,22,4.4,3,6,5,0
9.412466677556264e+17,35,181,5.171428571428572,4,8,34,1
9.412471619388581e+17,24,89,3.7083333333333335,1,5,24,0
9.412519819825873e+17,3,26,8.666666666666666,8,9,0,3
9.412628661155425e+17,12,38,3.1666666666666665,2,4,12,0
9.412803187514459e+17,5,38,7.6,7,8,2,3
9.412961342846236e+17,5,7,1.4,1,2,5,0
9.413275316690307e+17,22,209,9.5,4,12,2,20
9.413856873787736e+17,2,12,6.0,6,6,2,0
9.414069696542287e+17,4,21,5.25,4,6,4,0
9.41695277846289e+17,89,620,6.966292134831461,4,9,60,29
9.418397191845627e+17,61,587,9.62295081967213,3,13,4,57
9.419220988932678e+17,29,58,2.0,1,4,29,0
9.419432547506275e+17,8,20,2.5,1,5,8,0
9.419699673294825e+17,108,752,6.962962962962963,3,9,71,37
9.419939515025226e+17,38,157,4.131578947368421,2,7,38,0
9.420217757706924e+17,11,76,6.909090909090909,5,8,9,2
9.420273842943804e+17,23,42,1.826086956521739,1,3,23,0
9.420427161808259e+17,9,64,7.111111111111111,6,8,6,3
9.423628364822988e+17,23,155,6.739130434782608,3,8,18,5
9.42413375575081e+17,32,283,8.84375,7,12,4,28
9.424861387763368e+17,26,125,4.8076923076923075,3,7,26,0
9.425289757708404e+17,35,83,2.3714285714285714,1,4,35,0
9.425394398152458e+17,2,8,4.0,2,6,2,0
9.425460329487895e+17,1,8,8.0,8,8,0,1
9.425519771298147e+17,3,6,2.0,1,3,3,0
9.42557796388381e+17,45,180,4.0,2,7,45,0
9.425609983659926e+17,6,13,2.1666666666666665,1,3,6,0
9.425971243525329e+17,3,21,7.0,6,8,2,1
9.426505576005853e+17,16,109,6.8125,5,8,12,4
9.426715114644724e+17,15,28,1.8666666666666667,1,4,15,0
9.426801638939944e+17,14,17,1.2142857142857142,1,2,14,0
9.4268660582556e+17,77,295,3.831168831168831,2,7,77,0
9.426887421094328e+17,115,587,5.104347826086957,3,8,114,1
9.42692162925654e+17,26,58,2.230769230769231,1,4,26,0
9.427075139211354e+17,6,25,4.166666666666667,3,5,6,0
9.427083749829806e+17,4,27,6.75,5,8,3,1
9.427089701935608e+17,16,118,7.375,6,9,10,6
9.428078093125555e+17,96,467,4.864583333333333,3,7,96,0
9.428108608863139e+17,60,125,2.0833333333333335,1,5,60,0
9.429027841736307e+17,29,48,1.6551724137931034,1,3,29,0
9.431164740665426e+17,68,349,5.132352941176471,2,8,66,2
9.431811006387503e+17,18,91,5.055555555555555,3,6,18,0
9.432103356590661e+17,42,379,9.023809523809524,7,11,2,40
9.432197644035546e+17,42,90,2.142857142857143,1,4,42,0
9.432303946687273e+17,8,73,9.125,8,11,0,8
9.432403560001556e+17,1,8,8.0,8,8,0,1
9.432445644071361e+17,3,13,4.333333333333333,4,5,3,0
9.432503512579589e+17,42,92,2.1904761904761907,1,4,42,0
9.43255029124308e+17,18,125,6.944444444444445,4,8,8,10
9.432639360643963e+17,82,637,7.7682926829268295,3,11,31,51
9.432671479840221e+17,31,161,5.193548387096774,3,7,31,0
9.433029791161248e+17,27,77,2.8518518518518516,1,4,27,0
9.433062094358335e+17,53,113,2.1320754716981134,1,4,53,0
9.43315376561918e+17,10,24,2.4,1,4,10,0
9.433250277681897e+17,87,608,6.988505747126437,4,9,61,26
9.433433044865627e+17,3,14,4.666666666666667,4,5,3,0
9.433443058998016e+17,1,4,4.0,4,4,1,0
9.433725835520067e+17,11,82,7.454545454545454,6,10,8,3
9.434341278060115e+17,1,4,4.0,4,4,1,0
9.434346059075786e+17,44,220,5.0,3,7,44,0
9.434405125576355e+17,1,11,11.0,11,11,0,1
9.434458856021386e+17,4,39,9.75,9,11,0,4
9.434624775680887e+17,24,193,8.041666666666666,2,11,5,19
9.43498203248609e+17,37,219,5.918918918918919,3,9,33,4
9.436091170872833e+17,1,1,1.0,1,1,1,0
9.437094542434659e+17,7,45,6.428571428571429,4,7,7,0
9.4390592433971e+17,36,351,9.75,5,12,2,34
9.439114205076357e+17,22,101,4.590909090909091,2,6,22,0
9.439130903529137e+17,61,107,1.7540983606557377,1,4,61,0
9.439170364756211e+17,25,49,1.96,1,4,25,0
9.43921536444461e+17,10,48,4.8,3,7,10,0
9.439830975475057e+17,22,49,2.227272727272727,1,4,22,0
9.439999781254236e+17,22,114,5.181818181818182,3,7,22,0
9.440219429050446e+17,2,17,8.5,8,9,0,2
9.440400882081815e+17,5,12,2.4,1,4,5,0
9.440629753017952e+17,1,1,1.0,1,1,1,0
9.441097203088297e+17,1,3,3.0,3,3,1,0
9.441454183128206e+17,3,3,1.0,1,1,3,0
9.441561798753475e+17,38,351,9.236842105263158,3,11,3,35
9.441566878804042e+17,84,331,3.9404761904761907,2,6,84,0
9.44181901495035e+17,6,18,3.0,2,4,6,0
9.443085064109627e+17,30,115,3.8333333333333335,2,6,30,0
9.443116000494938e+17,43,163,3.7906976744186047,1,6,43,0
9.443175769741303e+17,54,283,5.2407407407407405,2,8,52,2
9.44354940987923e+17,3,5,1.6666666666666667,1,3,3,0
9.443959224175558e+17,26,154,5.923076923076923,4,8,24,2
9.446019398317181e+17,8,16,2.0,1,3,8,0
9.446088128088607e+17,25,202,8.08,5,10,7,18
9.446389423978996e+17,162,808,4.987654320987654,2,7,162,0
9.446749355887291e+17,34,66,1.9411764705882353,1,4,34,0
9.447021099494341e+17,84,847,10.083333333333334,2,13,4,80
9.447809447454734e+17,4,8,2.0,1,3,4,0
9.447928768760577e+17,7,44,6.285714285714286,2,9,5,2
9.448205115190272e+17,9,92,10.222222222222221,9,12,0,9
9.448346898958656e+17,62,127,2.0483870967741935,1,4,62,0
9.448413509800982e+17,5,12,2.4,2,3,5,0
9.448483519137951e+17,24,58,2.4166666666666665,1,5,24,0
9.448698432437414e+17,1,2,2.0,2,2,1,0
9.448698441777948e+17,2,4,2.0,1,3,2,0
9.448701473500311e+17,1,1,1.0,1,1,1,0
9.448703853572874e+17,1,5,5.0,5,5,1,0
9.448704060992882e+17,1,1,1.0,1,1,1,0
9.448728924352617e+17,1,4,4.0,4,4,1,0
9.448781727786717e+17,9,22,2.4444444444444446,1,4,9,0
9.45011265057882e+17,104,991,9.528846153846153,2,13,8,96
9.450877927438253e+17,4,10,2.5,1,3,4,0
9.451059634527162e+17,4,9,2.25,1,4,4,0
9.451253011806518e+17,129,888,6.883720930232558,2,10,88,41
9.451305777738921e+17,10,25,2.5,1,4,10,0
9.451491894803448e+17,72,360,5.0,3,7,72,0
9.45340828956544e+17,2,14,7.0,7,7,2,0
9.453895190703159e+17,43,311,7.232558139534884,4,9,24,19
9.453947390366323e+17,35,317,9.057142857142857,5,11,2,33
9.453959781938376e+17,73,127,1.7397260273972603,1,3,73,0
9.454057882149367e+17,35,162,4.628571428571429,3,7,35,0
9.454066361638385e+17,61,538,8.819672131147541,6,11,5,56
9.454232504461798e+17,21,44,2.0952380952380953,1,4,21,0
9.454281286925181e+17,30,144,4.8,2,8,29,1
9.454294484432598e+17,88,417,4.738636363636363,3,6,88,0
9.454534649788383e+17,3,25,8.333333333333334,8,9,0,3
9.454564129817455e+17,3,8,2.6666666666666665,2,3,3,0
9.454807004430414e+17,69,671,9.72463768115942,2,13,5,64
9.45494797630398e+17,69,345,5.0,3,7,69,0
9.455248521705217e+17,78,689,8.833333333333334,5,12,8,70
9.45626088440414e+17,38,333,8.763157894736842,2,11,5,33
9.456401103169262e+17,4,9,2.25,2,3,4,0
9.457443786102488e+17,26,55,2.1153846153846154,1,4,26,0
9.457597188515334e+17,13,69,5.3076923076923075,4,8,12,1
9.458047274994975e+17,46,449,9.76086956521739,2,12,1,45
9.460504133175764e+17,5,40,8.0,7,9,2,3
9.460913823888572e+17,42,199,4.738095238095238,3,6,42,0
9.460959288353713e+17,58,291,5.017241379310345,3,7,58,0
9.461142027851119e+17,20,192,9.6,6,11,1,19
9.462760541571073e+17,11,78,7.090909090909091,5,9,8,3
9.46323279334174e+17,129,643,4.984496124031008,2,7,129,0
9.463282017705318e+17,42,212,5.0476190476190474,3,7,42,0
9.463392365570248e+17,46,221,4.804347826086956,2,7,46,0
9.463647324959909e+17,9,55,6.111111111111111,5,8,8,1
9.46405575508543e+17,64,316,4.9375,2,7,64,0
9.464638199855034e+17,4,7,1.75,1,3,4,0
9.468678720011443e+17,5,17,3.4,1,5,5,0
9.468728124033366e+17,1,2,2.0,2,2,1,0
9.469549716987067e+17,25,131,5.24,3,8,24,1
9.470914114888927e+17,29,231,7.9655172413793105,5,9,7,22
9.470939320139672e+17,35,132,3.7714285714285714,2,6,35,0
9.470998149935587e+17,52,246,4.730769230769231,2,6,52,0
9.471111829622949e+17,71,208,2.9295774647887325,1,6,71,0
9.471127286554744e+17,65,319,4.907692307692308,2,7,65,0
9.471326079271076e+17,52,508,9.76923076923077,5,12,2,50
9.471699834193226e+17,14,66,4.714285714285714,4,6,14,0
9.472147209996262e+17,2,13,6.5,6,7,2,0
9.474328959076995e+17,5,41,8.2,6,10,2,3
9.475115750429814e+17,60,355,5.916666666666667,2,8,56,4
9.475126405326308e+17,19,53,2.789473684210526,1,4,19,0
9.475337169627791e+17,3,9,3.0,3,3,3,0
9.475406610401701e+17,23,96,4.173913043478261,3,6,23,0
9.475415057572206e+17,6,56,9.333333333333334,8,11,0,6
9.475862496932009e+17,28,240,8.571428571428571,2,11,4,24
9.475878772387619e+17,17,116,6.823529411764706,5,9,12,5
9.476038310422413e+17,54,312,5.777777777777778,2,8,51,3
9.476059029250798e+17,54,102,1.8888888888888888,1,4,54,0
9.476967886846885e+17,14,31,2.2142857142857144,1,5,14,0
9.477031145831606e+17,4,8,2.0,1,3,4,0
9.477185918264355e+17,10,68,6.8,4,9,7,3
9.477232612222281e+17,14,26,1.8571428571428572,1,3,14,0
9.47723810290753e+17,1,4,4.0,4,4,1,0
9.477296483692735e+17,2,7,3.5,3,4,2,0
9.477369440027845e+17,5,29,5.8,5,7,5,0
9.477377221417219e+17,1,6,6.0,6,6,1,0
9.477395358852065e+17,2,4,2.0,2,2,2,0
9.477507901222757e+17,19,83,4.368421052631579,2,6,19,0
9.47852445299944e+17,1,3,3.0,3,3,1,0
9.479005052950181e+17,15,74,4.933333333333334,3,7,15,0
9.479131578846892e+17,39,189,4.846153846153846,2,7,39,0
9.479315551268238e+17,34,317,9.323529411764707,3,12,5,29
9.479704471427072e+17,4,35,8.75,8,10,0,4
9.482453835970771e+17,11,32,2.909090909090909,1,5,11,0
9.482557210114982e+17,54,535,9.907407407407407,6,13,2,52
9.482576732055763e+17,10,25,2.5,1,4,10,0
9.48262195368035e+17,4,14,3.5,3,4,4,0
9.482827418238769e+17,11,19,1.7272727272727273,1,3,11,0
9.482940307689665e+17,36,249,6.916666666666667,3,9,27,9
9.48316812315938e+17,54,265,4.907407407407407,2,7,54,0
9.483456766639014e+17,52,508,9.76923076923077,4,12,1,51
9.48394683354612e+17,1,2,2.0,2,2,1,0
9.484236331881926e+17,1,2,2.0,2,2,1,0
9.484258264724412e+17,144,727,5.048611111111111,2,8,143,1
9.484342991530566e+17,17,74,4.352941176470588,2,6,17,0
9.484479257300869e+17,24,155,6.458333333333333,4,9,17,7
9.484488570884145e+17,64,563,8.796875,3,12,8,56
9.484538389495485e+17,3,16,5.333333333333333,5,6,3,0
9.484658144996448e+17,12,81,6.75,5,8,9,3
9.484836673908026e+17,5,10,2.0,1,3,5,0
9.484843650515916e+17,3,21,7.0,7,7,3,0
9.485178005763953e+17,8,27,3.375,1,4,8,0
9.485200553527255e+17,4,27,6.75,6,7,4,0
9.485253880981358e+17,35,312,8.914285714285715,5,11,4,31
9.485731528405659e+17,84,544,6.476190476190476,2,9,62,22
9.485902937698973e+17,79,385,4.8734177215189876,3,8,77,2
9.486809557873016e+17,12,90,7.5,7,10,9,3
9.489803485560801e+17,56,271,4.839285714285714,2,7,56,0
9.489987121690076e+17,76,729,9.592105263157896,2,13,7,69
9.490046179731109e+17,18,168,9.333333333333334,4,12,2,16
9.490133271835928e+17,12,18,1.5,1,3,12,0
9.490257095133321e+17,2,20,10.0,10,10,0,2
9.490311710931717e+17,21,65,3.0952380952380953,2,5,21,0
9.490574050979265e+17,17,98,5.764705882352941,3,7,17,0
9.490741234538244e+17,98,765,7.8061224489795915,2,11,31,67
9.490934608142147e+17,92,169,1.8369565217391304,1,4,92,0
9.490999452799464e+17,112,240,2.142857142857143,1,5,112,0
9.491102123487338e+17,51,311,6.098039215686274,3,8,45,6
9.491128782944177e+17,56,273,4.875,2,7,56,0
9.491447967135357e+17,103,590,5.728155339805825,3,9,101,2
9.491616836164663e+17,48,227,4.729166666666667,2,7,48,0
9.491713437803252e+17,59,408,6.915254237288136,4,10,38,21
9.49171865936451e+17,57,177,3.1052631578947367,2,5,57,0
9.491824209485002e+17,86,179,2.0813953488372094,1,5,86,0
9.491924227953144e+17,84,161,1.9166666666666667,1,4,84,0
9.492292438630652e+17,165,973,5.8969696969696965,2,9,151,14
9.49248627276584e+17,4,13,3.25,2,5,4,0
9.49291091914196e+17,52,304,5.846153846153846,2,8,47,5
9.492994314376614e+17,7,24,3.4285714285714284,2,6,7,0
9.493080812737133e+17,61,480,7.868852459016393,4,10,20,41
9.493106939895887e+17,19,72,3.789473684210526,2,5,19,0
9.49369983300398e+17,71,690,9.71830985915493,5,12,6,65
9.494007813595443e+17,2,8,4.0,3,5,2,0
9.496405594945714e+17,7,50,7.142857142857143,7,8,6,1
9.496972354746241e+17,43,416,9.674418604651162,2,12,2,41
9.497007888314363e+17,7,67,9.571428571428571,9,11,0,7
9.497161260367882e+17,1,2,2.0,2,2,1,0
9.497257690714725e+17,2,6,3.0,3,3,2,0
9.497270045770045e+17,20,39,1.95,1,5,20,0
9.497312035050966e+17,2,21,10.5,10,11,0,2
9.497650248563465e+17,117,1135,9.7008547008547,2,13,6,111
9.49765237220308e+17,38,76,2.0,1,4,38,0
9.497813221048227e+17,4,30,7.5,7,8,2,2
9.497813264503581e+17,7,46,6.571428571428571,5,8,6,1
9.49781330171233e+17,16,105,6.5625,4,8,13,3
9.497813334441321e+17,2,15,7.5,7,8,1,1
9.49788067110786e+17,2,4,2.0,2,2,2,0
9.498307875622849e+17,1,10,10.0,10,10,0,1
9.498403893912887e+17,25,162,6.48,4,8,21,4
9.498491011477192e+17,21,155,7.380952380952381,4,9,9,12
9.498528154456596e+17,71,276,3.887323943661972,2,6,71,0
9.498621957445222e+17,1,2,2.0,2,2,1,0
9.498756724398794e+17,112,1096,9.785714285714286,2,12,9,103
9.49911594141792e+17,45,94,2.088888888888889,1,4,45,0
9.49917958163517e+17,18,45,2.5,1,5,18,0
9.499197050879597e+17,76,685,9.013157894736842,2,12,12,64
9.499328708881021e+17,4,8,2.0,1,3,4,0
9.499332163765883e+17,4,10,2.5,1,4,4,0
9.499356171985491e+17,1,3,3.0,3,3,1,0
9.499592735037501e+17,101,956,9.465346534653465,2,12,7,94
9.500036513858355e+17,52,107,2.0576923076923075,1,4,52,0
9.500187906079764e+17,3,18,6.0,3,9,2,1
9.500232377377166e+17,179,1218,6.804469273743017,2,9,131,48
9.500939242057358e+17,31,58,1.8709677419354838,1,4,31,0
9.501411070645076e+17,74,148,2.0,1,5,74,0
9.50165224506361e+17,76,167,2.1973684210526314,1,5,76,0
9.503517534102952e+17,55,365,6.636363636363637,3,8,42,13
9.504040773897974e+17,21,42,2.0,1,3,21,0
9.504057190793335e+17,2,6,3.0,3,3,2,0
9.504415848899743e+17,42,245,5.833333333333333,2,8,41,1
9.504540379042548e+17,3,18,6.0,4,7,3,0
9.504774452736417e+17,16,45,2.8125,1,4,16,0
9.50497211259478e+17,9,19,2.111111111111111,1,4,9,0
9.50509415044688e+17,100,888,8.88,2,11,8,92
9.505147067748718e+17,73,490,6.712328767123288,2,9,52,21
9.50518158600329e+17,24,36,1.5,1,3,24,0
9.505199892001407e+17,14,42,3.0,1,4,14,0
9.50563209862448e+17,8,23,2.875,1,4,8,0
9.506058828885454e+17,43,212,4.930232558139535,3,7,43,0
9.50685194042574e+17,133,1032,7.7593984962406015,2,11,47,86
9.507795181704045e+17,32,153,4.78125,2,7,32,0
9.50808132448401e+17,25,73,2.92,1,5,25,0
9.508107947758775e+17,174,351,2.0172413793103448,1,4,174,0
9.511035761419035e+17,5,9,1.8,1,3,5,0
9.511736709867706e+17,90,354,3.933333333333333,1,7,90,0
9.511903040461481e+17,2,14,7.0,6,8,1,1
9.512118209702468e+17,44,428,9.727272727272727,6,12,4,40
9.512256847780484e+17,55,279,5.072727272727272,3,7,55,0
9.512597309746232e+17,3,21,7.0,6,8,2,1
9.513654119457691e+17,17,83,4.882352941176471,4,6,17,0
9.513781193592398e+17,72,682,9.472222222222221,2,13,8,64
9.513829020084353e+17,1,7,7.0,7,7,1,0
9.514595450594337e+17,108,750,6.944444444444445,4,10,77,31
9.518661953098477e+17,53,521,9.830188679245284,3,12,1,52
9.519124146773824e+17,18,172,9.555555555555555,7,11,2,16
9.519446530190474e+17,16,155,9.6875,4,12,1,15
9.519919731412536e+17,6,10,1.6666666666666667,1,3,6,0
9.520221129085481e+17,45,306,6.8,4,9,35,10
9.520481980466889e+17,14,133,9.5,3,12,2,12
9.521597710731244e+17,48,234,4.875,2,7,48,0
9.524243720004692e+17,2,6,3.0,2,4,2,0
9.5254460133309e+17,1,3,3.0,3,3,1,0
9.525692312920374e+17,4,26,6.5,6,7,4,0
9.525764796913181e+17,94,920,9.787234042553191,2,12,5,89
9.526182839453112e+17,57,529,9.280701754385966,3,12,8,49
9.526195378421674e+17,20,43,2.15,1,4,20,0
9.52640518015454e+17,76,519,6.828947368421052,2,9,50,26
9.52653984892689e+17,73,142,1.9452054794520548,1,4,73,0
9.52702155769113e+17,9,18,2.0,1,3,9,0
9.527333319949289e+17,7,62,8.857142857142858,7,11,1,6
9.527353747607688e+17,40,276,6.9,5,9,25,15
9.527620657705034e+17,13,87,6.6923076923076925,5,9,11,2
9.527764059283035e+17,51,195,3.823529411764706,2,6,51,0
9.52778959159313e+17,72,506,7.027777777777778,2,10,49,23
9.527790146543899e+17,117,688,5.880341880341881,2,8,113,4
9.527998633748877e+17,54,524,9.703703703703704,2,12,2,52
9.528050368491634e+17,2,7,3.5,2,5,2,0
9.528055919357289e+17,17,82,4.823529411764706,2,7,17,0
9.528077369537275e+17,2,8,4.0,3,5,2,0
9.52894579980658e+17,5,17,3.4,3,4,5,0
9.529000153165105e+17,9,20,2.2222222222222223,1,4,9,0
9.529002493001491e+17,7,16,2.2857142857142856,1,4,7,0
9.529760944032104e+17,16,71,4.4375,3,6,16,0
9.529896500606451e+17,4,9,2.25,2,3,4,0
9.530544060330803e+17,36,326,9.055555555555555,7,11,1,35
9.532922495232271e+17,41,281,6.853658536585366,3,9,29,12
9.533208511324172e+17,23,50,2.1739130434782608,1,5,23,0
9.533442730775383e+17,30,67,2.2333333333333334,1,5,30,0
9.533829596253509e+17,67,196,2.925373134328358,1,5,67,0
9.534003725468041e+17,67,592,8.835820895522389,4,11,7,60
9.53404124488244e+17,87,593,6.816091954022989,2,10,61,26
9.534070892043566e+17,15,56,3.7333333333333334,2,5,15,0
9.534086996552493e+17,7,16,2.2857142857142856,1,4,7,0
9.534181878486141e+17,58,375,6.4655172413793105,2,9,45,13
9.534576008470218e+17,70,672,9.6,2,12,2,68
9.535060817181887e+17,1,3,3.0,3,3,1,0
9.535425461086021e+17,12,111,9.25,3,11,2,10
9.535475929493828e+17,2,6,3.0,3,3,2,0
9.5356362103819e+17,17,85,5.0,3,8,16,1
9.535652782974139e+17,17,65,3.823529411764706,2,6,17,0
9.535679926995165e+17,6,15,2.5,1,4,6,0
9.535741939866524e+17,13,74,5.6923076923076925,4,7,13,0
9.536344724173737e+17,88,342,3.8863636363636362,2,6,88,0
9.536413097668143e+17,14,101,7.214285714285714,2,10,6,8
9.536496215424026e+17,123,1084,8.8130081300813,2,12,8,115
9.537778186163077e+17,49,480,9.795918367346939,2,12,1,48
9.537780382794392e+17,27,37,1.3703703703703705,1,3,27,0
9.538404680508398e+17,10,20,2.0,1,3,10,0
9.539278109451418e+17,7,45,6.428571428571429,6,8,6,1
9.539964384490332e+17,7,12,1.7142857142857142,1,4,7,0
9.540021344311922e+17,21,141,6.714285714285714,3,8,14,7
9.540097830029958e+17,53,468,8.830188679245284,3,12,10,43
9.540176348672116e+17,7,16,2.2857142857142856,1,4,7,0
9.540528555472767e+17,13,27,2.076923076923077,1,3,13,0
9.540785943173564e+17,1,2,2.0,2,2,1,0
9.5408072950785e+17,1,2,2.0,2,2,1,0
9.540981542670858e+17,27,56,2.074074074074074,1,4,27,0
9.541109279035867e+17,10,64,6.4,2,9,7,3
9.541374045438104e+17,1,1,1.0,1,1,1,0
9.541425667316054e+17,18,126,7.0,2,9,10,8
9.541439335091924e+17,1,5,5.0,5,5,1,0
9.541701190308625e+17,12,27,2.25,1,3,12,0
9.541776580622405e+17,3,22,7.333333333333333,7,8,2,1
9.541913993774008e+17,1,2,2.0,2,2,1,0
9.541920024216709e+17,41,217,5.2926829268292686,3,8,40,1
9.542132037955005e+17,5,15,3.0,2,4,5,0
9.542167813027634e+17,13,89,6.846153846153846,5,8,9,4
9.542427890920726e+17,16,33,2.0625,1,3,16,0
9.54261707423089e+17,2,2,1.0,1,1,2,0
9.542955358715085e+17,39,180,4.615384615384615,2,7,39,0
9.543070404358162e+17,94,190,2.021276595744681,1,4,94,0
9.543883586571155e+17,10,52,5.2,4,6,10,0
9.544653128310948e+17,88,836,9.5,2,12,8,80
9.545316273021548e+17,45,224,4.977777777777778,2,7,45,0
9.545396709634188e+17,88,124,1.4090909090909092,1,3,88,0
9.548258227337632e+17,1,3,3.0,3,3,1,0
9.548523380251191e+17,6,41,6.833333333333333,6,8,4,2
9.548523857752694e+17,14,101,7.214285714285714,6,9,9,5
9.548525913662568e+17,1,7,7.0,7,7,1,0
9.548526059980488e+17,6,48,8.0,7,9,1,5
9.549004377071145e+17,1,2,2.0,2,2,1,0
9.549988472632234e+17,39,197,5.051282051282051,2,8,38,1
9.55002830257868e+17,57,387,6.7894736842105265,2,9,41,16
9.550735628775063e+17,2,17,8.5,8,9,0,2
9.550758979914893e+17,3,6,2.0,2,2,3,0
9.550783121190022e+17,1,3,3.0,3,3,1,0
9.5508726615566e+17,15,133,8.866666666666667,6,10,3,12
9.551293892709732e+17,36,151,4.194444444444445,3,6,36,0
9.551346527764529e+17,55,284,5.163636363636364,2,8,53,2
9.55175688750761e+17,21,73,3.4761904761904763,2,5,21,0
9.55295343705797e+17,15,85,5.666666666666667,4,7,15,0
9.554684230549507e+17,6,24,4.0,2,5,6,0
9.554812560818226e+17,5,21,4.2,4,5,5,0
9.555279508092988e+17,17,88,5.176470588235294,3,7,17,0
9.555699819626035e+17,10,20,2.0,1,3,10,0
9.555723905095293e+17,73,359,4.917808219178082,2,7,73,0
9.556157687998086e+17,3,7,2.3333333333333335,2,3,3,0
9.556203323406743e+17,4,36,9.0,9,9,0,4
9.556537154662285e+17,11,82,7.454545454545454,6,9,6,5
9.556723460185719e+17,4,9,2.25,2,3,4,0
9.556803578163921e+17,61,250,4.098360655737705,2,7,61,0
9.55695924980373e+17,36,321,8.916666666666666,4,11,3,33
9.55726867730913e+17,84,426,5.071428571428571,3,7,84,0
9.557273001605923e+17,2,3,1.5,1,2,2,0
9.558392664691485e+17,75,510,6.8,3,9,53,22
9.558678868979857e+17,10,82,8.2,4,10,2,8
9.55889872029978e+17,36,45,1.25,1,3,36,0
9.561074205627496e+17,1,4,4.0,4,4,1,0
9.562237440737661e+17,71,616,8.67605633802817,3,11,9,62
9.562411364833117e+17,1,2,2.0,2,2,1,0
9.562427569705459e+17,53,422,7.962264150943396,5,10,16,37
9.562483352063336e+17,68,521,7.661764705882353,2,10,22,46
9.562484682895516e+17,27,111,4.111111111111111,2,6,27,0
9.562513595268573e+17,2,16,8.0,7,9,1,1
9.562562063276607e+17,63,478,7.587301587301587,2,10,25,38
9.562875184720495e+17,53,259,4.886792452830188,2,7,53,0
9.5633824732855e+17,5,40,8.0,6,9,1,4
9.563400799432206e+17,26,176,6.769230769230769,3,9,17,9
9.563441109847052e+17,4,4,1.0,1,1,4,0
9.564155940735068e+17,61,302,4.950819672131147,3,7,61,0
9.564337170313033e+17,1,2,2.0,2,2,1,0
9.564388935883954e+17,1,6,6.0,6,6,1,0
9.564872103403855e+17,3,4,1.3333333333333333,1,2,3,0
9.565522065663517e+17,27,133,4.925925925925926,3,7,27,0
9.566700409548796e+17,14,144,10.285714285714286,8,12,0,14
9.570025991155064e+17,2,2,1.0,1,1,2,0
9.571425599631176e+17,9,57,6.333333333333333,3,8,5,4
9.571518497852106e+17,26,216,8.307692307692308,2,12,8,18
9.572442733776877e+17,6,56,9.333333333333334,6,11,1,5
9.57277992369982e+17,45,91,2.022222222222222,1,5,45,0
9.573061269424015e+17,3,20,6.666666666666667,6,7,3,0
9.573447831550845e+17,2,8,4.0,3,5,2,0
9.573468099834556e+17,2,10,5.0,5,5,2,0
9.573471194339301e+17,2,6,3.0,3,3,2,0
9.57379828749525e+17,31,154,4.967741935483871,3,7,31,0
9.576420554714685e+17,7,13,1.8571428571428572,1,3,7,0
9.576990491774957e+17,17,160,9.411764705882353,3,13,2,15
9.577344060992781e+17,84,645,7.678571428571429,2,10,29,55
9.577430381516995e+17,66,326,4.9393939393939394,3,7,66,0
9.57744605095641e+17,51,90,1.7647058823529411,1,4,51,0
9.577562211406061e+17,10,71,7.1,6,8,7,3
9.57764904910629e+17,10,17,1.7,1,4,10,0
9.577767309491724e+17,29,143,4.931034482758621,3,6,29,0
9.578150873285912e+17,2,13,6.5,6,7,2,0
9.578222561426024e+17,13,25,1.9230769230769231,1,4,13,0
9.578238912539474e+17,3,3,1.0,1,1,3,0
9.578394005704902e+17,5,30,6.0,3,9,4,1
9.578787966451228e+17,9,83,9.222222222222221,8,11,0,9
9.578825949672038e+17,2,9,4.5,4,5,2,0
9.578969936224735e+17,13,53,4.076923076923077,2,6,13,0
9.579011762164036e+17,10,54,5.4,2,7,10,0
9.579028286378075e+17,33,176,5.333333333333333,2,7,33,0
9.579179231124709e+17,34,130,3.823529411764706,2,7,34,0
9.579196983544776e+17,35,105,3.0,1,5,35,0
9.579433731943923e+17,80,539,6.7375,2,9,55,25
9.579909310181633e+17,3,19,6.333333333333333,4,9,2,1
9.580009283342902e+17,1,4,4.0,4,4,1,0
9.58014589513888e+17,13,77,5.923076923076923,3,8,11,2
9.580237667628634e+17,7,9,1.2857142857142858,1,2,7,0
9.581106246484918e+17,14,32,2.2857142857142856,1,4,14,0
9.584078400434592e+17,57,174,3.0526315789473686,1,5,57,0
9.584527716056434e+17,40,192,4.8,3,8,39,1
9.585215913125746e+17,15,28,1.8666666666666667,1,3,15,0
9.586133844098751e+17,1,4,4.0,4,4,1,0
9.586763559451639e+17,87,749,8.60919540229885,2,11,16,71
9.587291599723153e+17,77,740,9.61038961038961,3,12,6,71
9.58809378953326e+17,12,78,6.5,5,7,12,0
9.588415703731228e+17,35,107,3.057142857142857,1,5,35,0
9.590094175493635e+17,3,21,7.0,7,7,3,0
9.590664762928536e+17,8,19,2.375,2,4,8,0
9.592046825431587e+17,7,49,7.0,5,8,5,2
9.592600979298449e+17,6,58,9.666666666666666,9,11,0,6
9.593238242809765e+17,32,96,3.0,1,5,32,0
9.593565756575674e+17,24,76,3.1666666666666665,2,5,24,0
9.595701876720924e+17,12,47,3.9166666666666665,2,5,12,0
9.598817152382063e+17,4,37,9.25,8,10,0,4
9.598856841327279e+17,1,4,4.0,4,4,1,0
9.598993588766647e+17,6,44,7.333333333333333,6,9,3,3
9.599387814917034e+17,5,34,6.8,6,7,5,0
9.600077169265143e+17,19,54,2.8421052631578947,1,4,19,0
9.600510137113879e+17,12,123,10.25,8,12,0,12
9.600663680104818e+17,7,36,5.142857142857143,2,7,7,0
9.603016190974587e+17,13,90,6.923076923076923,3,10,8,5
9.605252912837588e+17,63,607,9.634920634920634,2,12,7,56
9.605504071001478e+17,15,29,1.9333333333333333,1,4,15,0
9.605507760376946e+17,1,6,6.0,6,6,1,0
9.605522613741897e+17,3,18,6.0,5,7,3,0
9.605594204526784e+17,2,2,1.0,1,1,2,0
9.605695175445531e+17,2,12,6.0,5,7,2,0
9.605956054425356e+17,3,17,5.666666666666667,5,6,3,0
9.606019512216817e+17,2,15,7.5,7,8,1,1
9.606248786177454e+17,4,9,2.25,1,3,4,0
9.60640053022247e+17,1,1,1.0,1,1,1,0
9.606595193670116e+17,31,303,9.774193548387096,2,13,2,29
9.606667665551156e+17,1,8,8.0,8,8,0,1
9.606861294797245e+17,16,48,3.0,1,6,16,0
9.607173158341366e+17,19,38,2.0,1,4,19,0
9.607576349530502e+17,22,217,9.863636363636363,3,12,2,20
9.608408851744205e+17,11,19,1.7272727272727273,1,4,11,0
9.608851440275818e+17,8,59,7.375,3,10,3,5
9.609232530894333e+17,56,400,7.142857142857143,5,9,36,20
9.612393934561041e+17,18,180,10.0,4,12,1,17
9.61266992832268e+17,14,142,10.142857142857142,9,12,0,14
9.612903081348676e+17,3,7,2.3333333333333335,2,3,3,0
9.616092954068317e+17,158,758,4.7974683544303796,2,8,157,1
9.6197736723552e+17,61,300,4.918032786885246,3,8,60,1
9.62017761226983e+17,5,26,5.2,3,7,5,0
9.623051745217729e+17,25,257,10.28,6,12,1,24
9.624243722367793e+17,42,398,9.476190476190476,3,12,4,38
9.624828234291182e+17,30,152,5.066666666666666,2,8,29,1
9.628415732139267e+17,63,540,8.571428571428571,2,11,8,55
9.628465727928453e+17,25,121,4.84,2,8,24,1
9.628788535973491e+17,19,35,1.8421052631578947,1,3,19,0
9.62888915481155e+17,4,17,4.25,3,5,4,0
9.62891240606773e+17,17,162,9.529411764705882,4,11,2,15
9.629882176089624e+17,4,8,2.0,2,2,4,0
9.630619211589843e+17,4,12,3.0,1,4,4,0
9.630938576684086e+17,82,537,6.548780487804878,2,10,69,13
9.630999937628145e+17,26,148,5.6923076923076925,4,7,26,0
9.631171538456212e+17,31,180,5.806451612903226,3,8,30,1
9.635137699879165e+17,10,71,7.1,5,9,7,3
9.635333240018719e+17,31,242,7.806451612903226,6,10,13,18
9.635378897379781e+17,6,36,6.0,2,7,6,0
9.635855665919141e+17,4,20,5.0,5,5,4,0
9.635960963900634e+17,75,515,6.866666666666666,2,10,54,21
9.63597226237189e+17,3,9,3.0,2,4,3,0
9.636058138961857e+17,10,26,2.6,1,4,10,0
9.636158973031293e+17,6,53,8.833333333333334,8,10,0,6
9.636327001983432e+17,84,175,2.0833333333333335,1,5,84,0
9.636413100823995e+17,31,190,6.129032258064516,4,8,28,3
9.636616766146844e+17,64,303,4.734375,2,7,64,0
9.636897363340841e+17,40,93,2.325,1,4,40,0
9.636972574002017e+17,17,156,9.176470588235293,7,11,2,15
9.637440076699e+17,103,512,4.970873786407767,2,7,103,0
9.637769972578309e+17,2,10,5.0,5,5,2,0
9.638870612620937e+17,26,182,7.0,5,9,21,5
9.64125861423335e+17,104,520,5.0,2,7,104,0
9.64204897879388e+17,25,53,2.12,1,4,25,0
9.642150208551058e+17,14,20,1.4285714285714286,1,3,14,0
9.642532945741567e+17,30,208,6.933333333333334,4,9,20,10
9.642541238144436e+17,35,244,6.9714285714285715,5,9,24,11
9.642624722285682e+17,31,37,1.1935483870967742,1,3,31,0
9.64264910530966e+17,13,124,9.538461538461538,7,11,1,12
9.642958460773688e+17,13,46,3.5384615384615383,2,6,13,0
9.642992857656819e+17,1,2,2.0,2,2,1,0
9.643148102512658e+17,3,14,4.666666666666667,4,5,3,0
9.643733191412882e+17,7,68,9.714285714285714,6,12,1,6
9.644076836927634e+17,69,681,9.869565217391305,5,12,3,66
9.644266535780119e+17,61,535,8.770491803278688,4,11,5,56
9.644379675721338e+17,22,221,10.045454545454545,8,12,0,22
9.644610159959002e+17,2,5,2.5,1,4,2,0
9.645584780719594e+17,13,50,3.8461538461538463,2,5,13,0
9.649147778393416e+17,4,40,10.0,9,11,0,4
9.649360306893732e+17,34,167,4.911764705882353,3,7,34,0
9.649430373536438e+17,25,107,4.28,2,6,25,0
9.649605801385471e+17,20,70,3.5,1,5,20,0
9.649863138259004e+17,49,363,7.408163265306122,3,10,20,29
9.649888758342627e+17,40,286,7.15,5,9,21,19
9.65077928372531e+17,1,4,4.0,4,4,1,0
9.651117819738559e+17,2,3,1.5,1,2,2,0
9.651535069470545e+17,5,12,2.4,1,3,5,0
9.652011468876554e+17,7,21,3.0,1,4,7,0
9.652985710855653e+17,9,62,6.888888888888889,6,8,8,1
9.653335637633946e+17,160,932,5.825,2,9,149,11
9.655853244785108e+17,41,208,5.073170731707317,2,7,41,0
9.656036287753617e+17,29,183,6.310344827586207,4,8,26,3
9.656221079986772e+17,72,701,9.73611111111111,2,12,3,69
9.656228179702874e+17,12,41,3.4166666666666665,1,5,12,0
9.656474113964419e+17,20,160,8.0,6,9,4,16
9.657043131016077e+17,45,176,3.911111111111111,2,6,45,0
9.657334086274757e+17,4,9,2.25,1,3,4,0
9.65739436717588e+17,49,96,1.9591836734693877,1,5,49,0
9.657710985212609e+17,3,4,1.3333333333333333,1,2,3,0
9.658435889633116e+17,67,320,4.776119402985074,2,8,66,1
9.658491041158291e+17,76,672,8.842105263157896,2,11,11,65
9.659630157746262e+17,4,12,3.0,3,3,4,0
9.660137365826395e+17,17,64,3.764705882352941,2,6,17,0
9.662486076221134e+17,68,470,6.911764705882353,4,10,50,18
9.663452029995246e+17,57,554,9.719298245614034,2,12,3,54
9.664666321395368e+17,22,210,9.545454545454545,2,12,1,21
9.666314913020439e+17,13,125,9.615384615384615,8,12,0,13
9.666395395219936e+17,9,59,6.555555555555555,5,8,7,2
9.666711207286716e+17,78,667,8.551282051282051,2,11,14,64
9.667911237001839e+17,4,37,9.25,6,11,1,3
9.668049750150943e+17,15,31,2.066666666666667,1,3,15,0
9.67083781196321e+17,35,249,7.114285714285714,4,9,21,14
9.671092031941462e+17,30,292,9.733333333333333,4,12,3,27
9.671514808108297e+17,4,7,1.75,1,2,4,0
9.671533213138209e+17,7,11,1.5714285714285714,1,3,7,0
9.671620370320497e+17,8,15,1.875,1,4,8,0
9.671622519078739e+17,61,312,5.114754098360656,2,7,61,0
9.671927965658775e+17,3,9,3.0,2,4,3,0
9.672700312500132e+17,1,4,4.0,4,4,1,0
9.673432773697649e+17,12,85,7.083333333333333,6,9,10,2
9.673874936421475e+17,3,4,1.3333333333333333,1,2,3,0
9.674242556424282e+17,38,246,6.473684210526316,2,8,29,9
9.67446234878676e+17,11,55,5.0,4,6,11,0
9.674500803050734e+17,12,122,10.166666666666666,8,12,0,12
9.674908283567338e+17,2,5,2.5,2,3,2,0
9.674927312568786e+17,1,4,4.0,4,4,1,0
9.674978222375459e+17,2,9,4.5,4,5,2,0
9.675013877048808e+17,2,4,2.0,2,2,2,0
9.675084590163e+17,2,4,2.0,2,2,2,0
9.675098874860904e+17,2,3,1.5,1,2,2,0
9.675116061334825e+17,6,38,6.333333333333333,6,8,5,1
9.67513903819325e+17,3,9,3.0,2,4,3,0
9.675167000032495e+17,1,1,1.0,1,1,1,0
9.675196798135052e+17,1,1,1.0,1,1,1,0
9.675226295452591e+17,3,6,2.0,2,2,3,0
9.675239002924641e+17,6,17,2.8333333333333335,1,5,6,0
9.675253033628288e+17,4,31,7.75,7,9,2,2
9.675277137631274e+17,2,5,2.5,2,3,2,0
9.676232011219041e+17,13,33,2.5384615384615383,1,4,13,0
9.677095612728536e+17,41,287,7.0,3,9,25,16
9.67760070783166e+17,18,80,4.444444444444445,2,6,18,0
9.677942333698217e+17,14,19,1.3571428571428572,1,3,14,0
9.678210303872315e+17,2,7,3.5,3,4,2,0
9.679045637178828e+17,35,234,6.685714285714286,4,9,26,9
9.67923813154536e+17,15,30,2.0,1,3,15,0
9.679326192912527e+17,67,326,4.865671641791045,2,7,67,0
9.679456433457151e+17,12,24,2.0,1,4,12,0
9.67974661953352e+17,51,440,8.627450980392156,2,11,8,43
9.679879017218784e+17,5,10,2.0,1,3,5,0
9.680124914600238e+17,55,263,4.781818181818182,2,8,54,1
9.68019992161985e+17,73,273,3.73972602739726,1,6,73,0
9.680559843282711e+17,54,211,3.9074074074074074,2,6,54,0
9.680704428921801e+17,48,457,9.520833333333334,2,12,4,44
9.681136096553907e+17,15,101,6.733333333333333,5,8,12,3
9.681158591078106e+17,1,1,1.0,1,1,1,0
9.681556105646368e+17,36,325,9.027777777777779,7,12,2,34
9.685537728223416e+17,72,273,3.7916666666666665,2,6,72,0
9.685659758725811e+17,30,50,1.6666666666666667,1,4,30,0
9.686680390991205e+17,8,16,2.0,1,3,8,0
9.686923428634185e+17,5,35,7.0,5,9,4,1
9.687063447445423e+17,1,6,6.0,6,6,1,0
9.687068049698758e+17,4,5,1.25,1,2,4,0
9.687220966294403e+17,11,25,2.272727272727273,1,4,11,0
9.68765369482855e+17,28,49,1.75,1,4,28,0
9.688545433868467e+17,16,134,8.375,5,10,2,14
9.691869790801961e+17,95,204,2.1473684210526316,1,4,95,0
9.692233701873455e+17,16,145,9.0625,2,11,2,14
9.692740010972236e+17,6,29,4.833333333333333,4,6,6,0
9.692955890581752e+17,31,62,2.0,1,3,31,0
9.693270423137964e+17,99,209,2.111111111111111,1,5,99,0
9.69344651218437e+17,7,15,2.142857142857143,2,3,7,0
9.693582824455386e+17,2,2,1.0,1,1,2,0
9.693718552453985e+17,14,27,1.9285714285714286,1,4,14,0
9.693779617439286e+17,7,14,2.0,1,3,7,0
9.693851377680443e+17,2,6,3.0,3,3,2,0
9.693853060234159e+17,1,8,8.0,8,8,0,1
9.6939920705844e+17,135,638,4.725925925925926,2,8,133,2
9.694062327189665e+17,11,98,8.909090909090908,4,12,2,9
9.695140637334913e+17,3,17,5.666666666666667,3,8,2,1
9.695258584171357e+17,21,42,2.0,1,4,21,0
9.695685374705203e+17,1,3,3.0,3,3,1,0
9.696055462118747e+17,20,158,7.9,4,10,6,14
9.699394768224101e+17,4,27,6.75,6,7,4,0
9.700134448390592e+17,42,262,6.238095238095238,2,8,39,3
9.700365998508806e+17,119,249,2.092436974789916,1,5,119,0
9.700802922758822e+17,51,104,2.0392156862745097,1,4,51,0
9.700876831229674e+17,29,277,9.551724137931034,3,13,3,26
9.700964506589513e+17,25,166,6.64,3,9,20,5
9.700985750591342e+17,64,310,4.84375,3,8,63,1
9.702006073399596e+17,5,36,7.2,5,9,3,2
9.702006207826117e+17,20,32,1.6,1,4,20,0
9.702017324867153e+17,14,94,6.714285714285714,5,8,11,3
9.70201734205074e+17,10,24,2.4,1,4,10,0
9.702018445724046e+17,3,6,2.0,1,3,3,0
9.702018632824172e+17,18,126,7.0,5,9,11,7
9.702235170654369e+17,37,192,5.1891891891891895,2,7,37,0
9.702403980418153e+17,1,1,1.0,1,1,1,0
9.702451435423898e+17,46,232,5.043478260869565,2,8,45,1
9.702537474533674e+17,17,36,2.1176470588235294,1,4,17,0
9.702572214844095e+17,37,314,8.486486486486486,2,11,6,31
9.702896960287603e+17,3,19,6.333333333333333,5,7,3,0
9.7032364514436e+17,30,238,7.933333333333334,6,10,9,21
9.703260838635887e+17,39,389,9.974358974358974,4,12,1,38
9.703829796468764e+17,14,95,6.785714285714286,5,8,9,5
9.706977201492302e+17,2,6,3.0,2,4,2,0
9.707148006536186e+17,1,1,1.0,1,1,1,0
9.707151134539729e+17,32,310,9.6875,5,12,2,30
9.70748058291387e+17,3,24,8.0,8,8,0,3
9.707675369643791e+17,19,58,3.0526315789473686,1,5,19,0
9.707929210271616e+17,31,210,6.774193548387097,4,8,24,7
9.707936990709869e+17,12,91,7.583333333333333,6,10,6,6
9.708660657752703e+17,6,23,3.8333333333333335,3,5,6,0
9.709847597199484e+17,40,348,8.7,4,11,5,35
9.709962101818932e+17,73,227,3.1095890410958904,1,5,73,0
9.710270546815508e+17,12,117,9.75,7,13,2,10
9.711089818517875e+17,148,293,1.9797297297297298,1,4,148,0
9.714299524776044e+17,67,463,6.91044776119403,5,10,47,20
9.714318011679461e+17,60,134,2.2333333333333334,1,4,60,0
9.71439157487841e+17,13,118,9.076923076923077,3,11,2,11
9.714459812636273e+17,2,15,7.5,7,8,1,1
9.715094988126602e+17,70,679,9.7,2,13,2,68
9.715453830970842e+17,12,44,3.6666666666666665,2,5,12,0
9.715847010088573e+17,77,165,2.142857142857143,1,5,77,0
9.716003976004347e+17,19,50,2.6315789473684212,1,5,19,0
9.716135951510049e+17,7,48,6.857142857142857,5,8,6,1
9.71613712693047e+17,8,15,1.875,1,3,8,0
9.716790824011706e+17,72,626,8.694444444444445,3,12,11,61
9.718747778091562e+17,97,188,1.9381443298969072,1,4,97,0
9.721278000116512e+17,49,104,2.122448979591837,1,4,49,0
9.721304195206239e+17,98,693,7.071428571428571,2,10,62,36
9.723158736275882e+17,1,4,4.0,4,4,1,0
9.723396611014432e+17,19,172,9.052631578947368,6,11,1,18
9.723856340103222e+17,1,1,1.0,1,1,1,0
9.724211967216883e+17,6,44,7.333333333333333,3,9,1,5
9.724268355490295e+17,40,165,4.125,1,6,40,0
9.725110984407064e+17,26,155,5.961538461538462,2,8,24,2
9.725853375833396e+17,52,415,7.980769230769231,4,10,16,36
9.726017803910579e+17,10,49,4.9,3,6,10,0
9.726025270066401e+17,15,64,4.266666666666667,3,6,15,0
9.726172853920404e+17,3,20,6.666666666666667,6,7,3,0
9.728714224672003e+17,8,54,6.75,5,9,6,2
9.729008027877582e+17,10,42,4.2,3,6,10,0
9.729777111340335e+17,3,8,2.6666666666666665,2,3,3,0
9.729885115285034e+17,1,3,3.0,3,3,1,0
9.729946741543616e+17,1,6,6.0,6,6,1,0
9.730152875817888e+17,7,48,6.857142857142857,6,8,6,1
9.73036289280641e+17,13,27,2.076923076923077,1,4,13,0
9.730656136416101e+17,56,287,5.125,3,7,56,0
9.730698123328521e+17,2,5,2.5,2,3,2,0
9.731288587408876e+17,4,16,4.0,3,5,4,0
9.731314430041348e+17,14,134,9.571428571428571,3,11,1,13
9.731336679880635e+17,38,241,6.342105263157895,2,8,32,6
9.731583412218661e+17,4,6,1.5,1,3,4,0
9.732152664782533e+17,16,78,4.875,3,7,16,0
9.732682362229366e+17,61,230,3.7704918032786887,2,5,61,0
9.735654750538452e+17,38,177,4.657894736842105,2,6,38,0
9.735979319927482e+17,61,612,10.032786885245901,4,12,1,60
9.736043387642083e+17,72,486,6.75,4,9,54,18
9.736537858898593e+17,16,52,3.25,2,5,16,0
9.736583723118647e+17,16,156,9.75,6,11,1,15
9.736780600434797e+17,9,40,4.444444444444445,3,6,9,0
9.736823106115758e+17,2,16,8.0,8,8,0,2
9.737037690755076e+17,26,221,8.5,5,10,4,22
9.737039922466195e+17,77,652,8.467532467532468,2,11,11,66
9.737179795731604e+17,33,285,8.636363636363637,6,12,2,31
9.73738260226349e+17,44,308,7.0,3,10,31,13
9.73745370720611e+17,24,38,1.5833333333333333,1,3,24,0
9.738023858605958e+17,44,219,4.9772727272727275,3,7,44,0
9.738210003062035e+17,4,29,7.25,4,10,2,2
9.73886561093271e+17,9,67,7.444444444444445,7,8,5,4
9.739023911864498e+17,55,373,6.781818181818182,3,10,42,13
9.739056302173243e+17,23,45,1.9565217391304348,1,5,23,0
9.7403847612278e+17,103,206,2.0,1,5,103,0
9.74367073800804e+17,12,37,3.0833333333333335,1,6,12,0
9.743865285642088e+17,37,73,1.972972972972973,1,4,37,0
9.743958579382423e+17,56,226,4.035714285714286,2,6,56,0
9.744042918093266e+17,15,104,6.933333333333334,3,9,9,6
9.744137933675482e+17,19,76,4.0,2,6,19,0
9.74417574572593e+17,5,25,5.0,4,6,5,0
9.744234835019946e+17,2,14,7.0,7,7,2,0
9.744460683840366e+17,10,65,6.5,4,8,8,2
9.744720676586976e+17,71,351,4.943661971830986,2,7,71,0
9.744829195279054e+17,18,179,9.944444444444445,4,13,1,17
9.744836151098216e+17,41,211,5.146341463414634,3,8,39,2
9.745275964018403e+17,38,187,4.921052631578948,2,7,38,0
9.745402824376054e+17,10,50,5.0,4,7,10,0
9.74576272043031e+17,34,98,2.8823529411764706,1,5,34,0
9.746261439543954e+17,89,185,2.0786516853932584,1,4,89,0
9.747652679114011e+17,14,131,9.357142857142858,7,11,2,12
9.749378974819068e+17,30,294,9.8,4,12,1,29
9.750365502994575e+17,1,8,8.0,8,8,0,1
9.750441187360558e+17,5,33,6.6,5,8,4,1
9.750595322305862e+17,23,209,9.08695652173913,7,11,1,22
9.750668335211306e+17,53,474,8.943396226415095,7,11,3,50
9.75100658573265e+17,1,8,8.0,8,8,0,1
9.75141538982929e+17,42,286,6.809523809523809,5,9,31,11
9.751774655933919e+17,44,168,3.8181818181818183,2,7,44,0
9.75179003529847e+17,8,54,6.75,5,8,6,2
9.751992417762427e+17,19,47,2.473684210526316,1,4,19,0
9.752055380712641e+17,34,306,9.0,2,12,5,29
9.752071297516659e+17,65,97,1.4923076923076923,1,4,65,0
9.752746374359425e+17,12,76,6.333333333333333,5,8,10,2
9.752748992813097e+17,3,4,1.3333333333333333,1,2,3,0
9.752753077996466e+17,4,5,1.25,1,2,4,0
9.752860408195007e+17,25,120,4.8,3,7,25,0
9.753084693822042e+17,13,38,2.923076923076923,1,5,13,0
9.753220658795848e+17,8,39,4.875,4,7,8,0
9.753770156358317e+17,36,149,4.138888888888889,2,6,36,0
9.753866732950611e+17,28,266,9.5,2,11,1,27
9.754132153640806e+17,74,740,10.0,6,12,3,71
9.754356135189516e+17,28,111,3.9642857142857144,2,5,28,0
9.754939002611939e+17,19,27,1.4210526315789473,1,3,19,0
9.755335101163345e+17,75,216,2.88,1,6,75,0
9.755611731420474e+17,17,38,2.235294117647059,1,4,17,0
9.755924739002886e+17,31,92,2.967741935483871,1,4,31,0
9.756394559686248e+17,77,316,4.103896103896104,1,6,77,0
9.757484284155985e+17,8,56,7.0,5,8,4,4
9.757694695524e+17,38,387,10.18421052631579,6,12,1,37
9.758026024662984e+17,3,12,4.0,2,5,3,0
9.758091015027345e+17,111,534,4.8108108108108105,2,8,110,1
9.758154459152095e+17,44,296,6.7272727272727275,2,9,35,9
9.758195993371062e+17,41,409,9.975609756097562,2,13,1,40
9.758786082225207e+17,15,62,4.133333333333334,2,6,15,0
9.758977117786181e+17,12,32,2.6666666666666665,2,4,12,0
9.759127930561654e+17,23,160,6.956521739130435,2,9,16,7
9.759488625451725e+17,7,49,7.0,7,7,7,0
9.759590676769066e+17,8,58,7.25,6,8,5,3
9.759665548810917e+17,9,63,7.0,6,8,7,2
9.760765327011212e+17,49,186,3.795918367346939,1,6,49,0
9.762407874962365e+17,8,8,1.0,1,1,8,0
9.764420792222711e+17,17,34,2.0,1,4,17,0
9.766013550669174e+17,3,6,2.0,2,2,3,0
9.766306241346968e+17,11,76,6.909090909090909,5,8,7,4
9.766542307133258e+17,47,410,8.72340425531915,2,10,7,40
9.767405496196927e+17,2,16,8.0,7,9,1,1
9.768050556905006e+17,33,235,7.121212121212121,3,9,21,12
9.768419388663805e+17,29,172,5.931034482758621,4,8,27,2
9.768483576168503e+17,73,706,9.67123287671233,3,12,4,69
9.768615855796774e+17,64,308,4.8125,2,8,63,1
9.768800089257329e+17,3,6,2.0,2,2,3,0
9.770276910754775e+17,13,55,4.230769230769231,3,6,13,0
9.77300078172774e+17,14,118,8.428571428571429,5,11,2,12
9.773736690511805e+17,57,109,1.912280701754386,1,4,57,0
9.774268657992049e+17,78,689,8.833333333333334,2,11,9,69
9.774507620565705e+17,2,4,2.0,1,3,2,0
9.774896604444698e+17,2,15,7.5,7,8,1,1
9.774908815716973e+17,3,14,4.666666666666667,4,5,3,0
9.775178869809336e+17,68,471,6.926470588235294,2,9,45,23
9.775788448145596e+17,9,34,3.7777777777777777,3,5,9,0
9.779661617181476e+17,1,8,8.0,8,8,0,1
9.779676552275067e+17,17,114,6.705882352941177,5,8,14,3
9.779822969132929e+17,35,179,5.114285714285714,3,8,34,1
9.780667456971587e+17,93,630,6.774193548387097,2,9,75,18
9.781081948524028e+17,87,423,4.862068965517241,3,8,86,1
9.781101538887004e+17,13,63,4.846153846153846,2,7,13,0
9.781235298280024e+17,29,187,6.448275862068965,3,8,23,6
9.78129705458023e+17,1,3,3.0,3,3,1,0
9.78130311314618e+17,2,14,7.0,7,7,2,0
9.781492355478516e+17,60,113,1.8833333333333333,1,4,60,0
9.781663091655735e+17,28,165,5.892857142857143,3,8,27,1
9.781804999545341e+17,67,324,4.835820895522388,2,7,67,0
9.781971343493848e+17,3,5,1.6666666666666667,1,2,3,0
9.782316862974031e+17,3,10,3.3333333333333335,3,4,3,0
9.782521482092206e+17,16,43,2.6875,1,6,16,0
9.782536214669247e+17,2,7,3.5,3,4,2,0
9.782563889253335e+17,15,74,4.933333333333334,2,6,15,0
9.784039587748183e+17,2,6,3.0,3,3,2,0
9.784613365989745e+17,9,76,8.444444444444445,7,10,1,8
9.785187430685455e+17,37,177,4.783783783783784,2,8,36,1
9.786642286429492e+17,20,200,10.0,8,12,0,20
9.786737828682079e+17,13,121,9.307692307692308,8,11,0,13
9.787221035694968e+17,24,160,6.666666666666667,4,8,20,4
9.787226378784136e+17,40,200,5.0,3,7,40,0
9.787510883901075e+17,22,43,1.9545454545454546,1,5,22,0
9.787614046872864e+17,14,30,2.142857142857143,1,4,14,0
9.787749145307684e+17,12,24,2.0,1,4,12,0
9.787874038232536e+17,1,3,3.0,3,3,1,0
9.787907690303094e+17,1,3,3.0,3,3,1,0
9.788145364030097e+17,69,327,4.739130434782608,2,7,69,0
9.788414174307967e+17,3,18,6.0,6,6,3,0
9.788485236450286e+17,23,112,4.869565217391305,2,7,23,0
9.788562957322836e+17,16,152,9.5,6,12,2,14
9.788614855458473e+17,96,748,7.791666666666667,2,11,35,61
9.788660169209628e+17,44,229,5.204545454545454,3,8,42,2
9.788729293152095e+17,5,7,1.4,1,2,5,0
9.789363528987146e+17,21,203,9.666666666666666,8,11,0,21
9.789368172014461e+17,27,193,7.148148148148148,5,9,19,8
9.789546463417016e+17,38,188,4.947368421052632,2,8,37,1
9.789859610997481e+17,21,192,9.142857142857142,8,11,0,21
9.790094794478363e+17,27,165,6.111111111111111,2,9,22,5
9.790146979972297e+17,13,73,5.615384615384615,2,8,12,1
9.790153575987008e+17,28,198,7.071428571428571,5,9,19,9
9.790827257230248e+17,18,53,2.9444444444444446,1,4,18,0
9.790871970726688e+17,32,153,4.78125,3,6,32,0
9.791097698097263e+17,19,81,4.2631578947368425,3,6,19,0
9.793516867085853e+17,7,17,2.4285714285714284,1,4,7,0
9.793802507447813e+17,4,19,4.75,3,6,4,0
9.794177693959455e+17,69,278,4.028985507246377,2,6,69,0
9.794197568854294e+17,119,602,5.0588235294117645,2,7,119,0
9.794840350298976e+17,27,135,5.0,3,7,27,0
9.794884938933475e+17,18,91,5.055555555555555,2,6,18,0
9.79541151053268e+17,28,166,5.928571428571429,4,8,27,1
9.79551337062209e+17,10,47,4.7,2,7,10,0
9.795565849185391e+17,10,23,2.3,1,3,10,0
9.795657221535035e+17,4,30,7.5,6,8,1,3
9.795755281926578e+17,65,185,2.8461538461538463,1,5,65,0
9.795962875087878e+17,6,50,8.333333333333334,8,9,0,6
9.796219239324042e+17,7,23,3.2857142857142856,2,4,7,0
9.797349005741608e+17,1,8,8.0,8,8,0,1
9.797647304450525e+17,21,144,6.857142857142857,3,8,14,7
9.7978315648729e+17,38,78,2.0526315789473686,1,5,38,0
9.797880739704379e+17,41,75,1.829268292682927,1,5,41,0
9.797901271721066e+17,13,51,3.923076923076923,2,6,13,0
9.798249962159014e+17,1,6,6.0,6,6,1,0
9.799623707546591e+17,6,32,5.333333333333333,5,6,6,0
9.799687000855796e+17,25,100,4.0,3,6,25,0
9.801797263730391e+17,21,36,1.7142857142857142,1,3,21,0
9.802043934199462e+17,9,61,6.777777777777778,6,8,8,1
9.80223086246956e+17,15,103,6.866666666666666,5,10,12,3
9.802242663430874e+17,33,157,4.757575757575758,2,7,33,0
9.802253706506525e+17,15,67,4.466666666666667,2,6,15,0
9.802944561811372e+17,30,195,6.5,4,9,25,5
9.802949428679241e+17,36,277,7.694444444444445,4,9,12,24
9.802969715316653e+17,17,139,8.176470588235293,7,10,4,13
9.80300834326117e+17,21,65,3.0952380952380953,2,4,21,0
9.803107096067526e+17,50,62,1.24,1,3,50,0
9.803229739234204e+17,1,3,3.0,3,3,1,0
9.803584733525772e+17,4,26,6.5,6,7,4,0
9.803585823320874e+17,2,14,7.0,7,7,2,0
9.804291849123148e+17,55,279,5.072727272727272,2,7,55,0
9.804328477637098e+17,1,7,7.0,7,7,1,0
9.804329759493637e+17,1,2,2.0,2,2,1,0
9.80438051004599e+17,4,24,6.0,5,8,3,1
9.805819256932227e+17,12,100,8.333333333333334,3,11,2,10
9.807529299300151e+17,2,5,2.5,2,3,2,0
9.807832406224932e+17,20,43,2.15,1,4,20,0
9.808229876758015e+17,36,282,7.833333333333333,6,10,15,21
9.808357696172507e+17,1,5,5.0,5,5,1,0
9.808982751795237e+17,4,25,6.25,2,8,2,2
9.809289854714254e+17,8,80,10.0,6,12,1,7
9.80972601112905e+17,1,2,2.0,2,2,1,0
9.809965520408081e+17,29,55,1.896551724137931,1,4,29,0
9.810045003756119e+17,1,5,5.0,5,5,1,0
9.810117737353929e+17,3,15,5.0,4,6,3,0
9.810253262470573e+17,10,69,6.9,4,9,7,3
9.810256152160536e+17,28,54,1.9285714285714286,1,4,28,0
9.810258121225893e+17,9,16,1.7777777777777777,1,3,9,0
9.810260278622561e+17,23,42,1.826086956521739,1,4,23,0
9.810261765565452e+17,20,44,2.2,1,4,20,0
9.81035914558886e+17,17,33,1.9411764705882353,1,3,17,0
9.810359335209992e+17,2,11,5.5,5,6,2,0
9.810362846270602e+17,13,26,2.0,1,3,13,0
9.810421543919578e+17,29,63,2.1724137931034484,1,4,29,0
9.810423828604456e+17,15,28,1.8666666666666667,1,4,15,0
9.810472283123028e+17,2,6,3.0,2,4,2,0
9.810527541237335e+17,3,13,4.333333333333333,4,5,3,0
9.810545133556886e+17,8,19,2.375,1,3,8,0
9.810559951498382e+17,2,8,4.0,4,4,2,0
9.810955743190441e+17,15,128,8.533333333333333,6,10,2,13
9.811047664248434e+17,11,100,9.090909090909092,8,10,0,11
9.811065276111676e+17,27,112,4.148148148148148,2,6,27,0
9.811354563232558e+17,2,7,3.5,3,4,2,0
9.811586383592198e+17,56,538,9.607142857142858,2,12,3,53
9.812293972365966e+17,75,232,3.0933333333333333,1,6,75,0
9.815723157654304e+17,2,14,7.0,7,7,2,0
9.815844504880972e+17,56,385,6.875,3,9,38,18
9.816194836787158e+17,34,229,6.735294117647059,2,9,27,7
9.816837769524054e+17,34,305,8.970588235294118,2,12,3,31
9.81684088093457e+17,40,155,3.875,1,6,40,0
9.817200865370839e+17,9,44,4.888888888888889,2,6,9,0
9.817274912538482e+17,38,184,4.842105263157895,2,7,38,0
9.81743102839884e+17,54,354,6.555555555555555,2,9,38,16
9.817543259001718e+17,15,74,4.933333333333334,2,7,15,0
9.818993089299965e+17,24,111,4.625,3,6,24,0
9.819797963234629e+17,46,391,8.5,2,11,8,38
9.824258723652307e+17,17,152,8.941176470588236,3,11,2,15
9.824569310970382e+17,4,22,5.5,4,6,4,0
9.824924165248401e+17,6,26,4.333333333333333,2,6,6,0
9.825110260033903e+17,85,824,9.694117647058823,4,12,3,82
9.825228132017524e+17,1,5,5.0,5,5,1,0
9.825521846231396e+17,7,17,2.4285714285714284,1,4,7,0
9.825707007732906e+17,80,774,9.675,5,13,5,75
9.825773258213477e+17,166,664,4.0,2,7,166,0
9.825785109854181e+17,124,614,4.951612903225806,2,7,124,0
9.82583717951939e+17,5,6,1.2,1,2,5,0
9.825860199375002e+17,58,566,9.758620689655173,5,12,1,57
9.825895210425988e+17,88,848,9.636363636363637,3,12,6,82
9.825919957530232e+17,57,549,9.631578947368421,3,12,3,54
9.830359912793238e+17,3,5,1.6666666666666667,1,3,3,0
9.830551741713341e+17,2,5,2.5,2,3,2,0
9.830859700840925e+17,57,330,5.7894736842105265,2,9,55,2
9.830917241694739e+17,26,158,6.076923076923077,4,9,22,4
9.83194204244557e+17,13,56,4.3076923076923075,2,6,13,0
9.832861662225326e+17,3,8,2.6666666666666665,2,3,3,0
9.832877449830065e+17,33,302,9.151515151515152,6,11,2,31
9.833428446703978e+17,16,50,3.125,1,5,16,0
9.833510219971052e+17,16,129,8.0625,5,10,4,12
9.833758755282964e+17,24,233,9.708333333333334,5,12,1,23
9.834130140268695e+17,83,254,3.0602409638554215,1,6,83,0
9.834984955697795e+17,18,47,2.611111111111111,1,4,18,0
9.837419985430362e+17,5,23,4.6,4,6,5,0
9.837599257843756e+17,26,256,9.846153846153847,2,11,1,25
9.837693352664248e+17,38,178,4.684210526315789,3,7,38,0
9.837826160995607e+17,1,3,3.0,3,3,1,0
9.83792030756853e+17,21,196,9.333333333333334,4,12,3,18
9.838594012824627e+17,2,7,3.5,3,4,2,0
9.838835710618523e+17,2,8,4.0,3,5,2,0
9.839037109838566e+17,15,27,1.8,1,3,15,0
9.839114229095301e+17,10,99,9.9,6,12,1,9
9.839281136758548e+17,46,101,2.1956521739130435,1,4,46,0
9.839370805329197e+17,56,546,9.75,2,12,3,53
9.840030790589394e+17,34,43,1.2647058823529411,1,3,34,0
9.840073190452452e+17,30,149,4.966666666666667,2,7,30,0
9.842351276349023e+17,25,71,2.84,1,5,25,0
9.84249169488731e+17,48,99,2.0625,1,4,48,0
9.842590656928068e+17,38,116,3.0526315789473686,1,5,38,0
9.842640984013295e+17,80,165,2.0625,1,5,80,0
9.842718127001298e+17,78,155,1.9871794871794872,1,5,78,0
9.842813250630633e+17,79,156,1.9746835443037976,1,4,79,0
9.84287388243312e+17,33,74,2.242424242424242,1,5,33,0
9.844693402633036e+17,60,110,1.8333333333333333,1,4,60,0
9.844743029216507e+17,9,47,5.222222222222222,4,6,9,0
9.844911181181613e+17,8,18,2.25,1,3,8,0
9.845379137567813e+17,3,17,5.666666666666667,5,6,3,0
9.84553071368431e+17,1,5,5.0,5,5,1,0
9.845663734878194e+17,47,409,8.702127659574469,2,11,6,41
9.845687190352268e+17,10,45,4.5,3,6,10,0
9.845755714753385e+17,1,9,9.0,9,9,0,1
9.845824902837958e+17,55,532,9.672727272727272,3,12,3,52
9.845930937003301e+17,86,415,4.825581395348837,2,8,85,1
9.846059076279433e+17,28,55,1.9642857142857142,1,4,28,0
9.846809182047059e+17,8,56,7.0,5,8,4,4
9.84721049064284e+17,3,3,1.0,1,1,3,0
9.847248919795247e+17,43,59,1.372093023255814,1,3,43,0
9.847473415497078e+17,10,73,7.3,6,9,6,4
9.847882753869873e+17,94,464,4.9361702127659575,3,8,93,1
9.848275073949132e+17,27,53,1.962962962962963,1,4,27,0
9.84827892048797e+17,32,278,8.6875,3,10,4,28
9.852062843818026e+17,1,3,3.0,3,3,1,0
9.85213546183503e+17,71,139,1.9577464788732395,1,5,71,0
9.852188407532577e+17,23,117,5.086956521739131,3,7,23,0
9.852234949022148e+17,7,16,2.2857142857142856,1,4,7,0
9.852240516980694e+17,35,63,1.8,1,3,35,0
9.852501410648229e+17,1,6,6.0,6,6,1,0
9.852932675741098e+17,68,321,4.720588235294118,2,7,68,0
9.852973705354444e+17,44,294,6.681818181818182,2,9,34,10
9.853037222559892e+17,35,76,2.1714285714285713,1,4,35,0
9.85306788291491e+17,1,4,4.0,4,4,1,0
9.85323730793885e+17,51,249,4.882352941176471,2,7,51,0
9.853499491706268e+17,27,60,2.2222222222222223,1,4,27,0
9.853783767460919e+17,10,64,6.4,4,8,8,2
9.853955207488266e+17,23,116,5.043478260869565,3,7,23,0
9.854032072134273e+17,68,599,8.808823529411764,2,12,8,60
9.854079604072317e+17,75,371,4.946666666666666,2,8,74,1
9.854181868791675e+17,31,293,9.451612903225806,2,12,3,28
9.854291319922257e+17,30,115,3.8333333333333335,2,6,30,0
9.854375401210726e+17,12,27,2.25,1,4,12,0
9.85531479320798e+17,17,165,9.705882352941176,8,12,0,17
9.855498683793211e+17,23,227,9.869565217391305,2,12,1,22
9.856004244449556e+17,60,402,6.7,2,9,47,13
9.856072506545157e+17,3,12,4.0,3,5,3,0
9.858588498112699e+17,41,388,9.463414634146341,3,13,3,38
9.859276011905905e+17,46,227,4.934782608695652,2,8,45,1
9.859473101118472e+17,56,112,2.0,1,4,56,0
9.859489673484923e+17,1,3,3.0,3,3,1,0
9.859519820074934e+17,29,54,1.8620689655172413,1,4,29,0
9.859595549130659e+17,27,58,2.1481481481481484,1,4,27,0
9.859682305436897e+17,33,70,2.121212121212121,1,4,33,0
9.859737101571406e+17,5,21,4.2,3,6,5,0
9.860082337010597e+17,1,7,7.0,7,7,1,0
9.860313867541603e+17,66,452,6.848484848484849,3,9,45,21
9.860540709700465e+17,1,3,3.0,3,3,1,0
9.860543832527565e+17,9,21,2.3333333333333335,1,4,9,0
9.860554956909439e+17,13,67,5.153846153846154,4,7,13,0
9.860904898018303e+17,5,5,1.0,1,1,5,0
9.861519309270179e+17,10,57,5.7,4,7,10,0
9.86155388923923e+17,14,128,9.142857142857142,3,12,2,12
9.86176007126028e+17,14,51,3.642857142857143,3,4,14,0
9.862323722590002e+17,29,272,9.379310344827585,3,11,3,26
9.863176680609902e+17,16,129,8.0625,6,10,3,13
9.863385688147457e+17,19,128,6.7368421052631575,3,10,14,5
9.863414892806415e+17,75,518,6.906666666666666,3,9,49,26
9.867248591729829e+17,30,155,5.166666666666667,4,7,30,0
9.86747942430427e+17,3,10,3.3333333333333335,3,4,3,0
9.869237296482341e+17,38,191,5.026315789473684,4,7,38,0
9.869939790934441e+17,60,415,6.916666666666667,5,10,46,14
9.870110199654066e+17,30,129,4.3,2,7,30,0
9.87373657025959e+17,15,155,10.333333333333334,8,12,0,15
9.874634147217426e+17,38,50,1.3157894736842106,1,3,38,0
9.875637432655364e+17,8,10,1.25,1,2,8,0
9.8758382030861e+17,36,131,3.638888888888889,1,6,36,0
9.876102164167168e+17,1,1,1.0,1,1,1,0
9.876369722655201e+17,61,407,6.672131147540983,3,10,45,16
9.87643952011439e+17,7,49,7.0,5,8,4,3
9.876904052222195e+17,34,301,8.852941176470589,2,12,4,30
9.877914526041916e+17,1,3,3.0,3,3,1,0
9.880858719352767e+17,24,126,5.25,3,7,24,0
9.881155670373349e+17,67,317,4.731343283582089,2,8,66,1
9.881195246056078e+17,74,358,4.837837837837838,3,7,74,0
9.881255598834385e+17,59,218,3.694915254237288,1,7,59,0
9.88131882494965e+17,48,98,2.0416666666666665,1,4,48,0
9.881365046734367e+17,8,37,4.625,2,7,8,0
9.881487707613709e+17,33,105,3.1818181818181817,1,5,33,0
9.881489841038843e+17,1,1,1.0,1,1,1,0
9.881569374785996e+17,31,204,6.580645161290323,4,8,25,6
9.881719869476687e+17,113,526,4.654867256637168,2,8,112,1
9.881738901443982e+17,23,42,1.826086956521739,1,3,23,0
9.88207855305233e+17,33,295,8.93939393939394,3,11,2,31
9.882421350866138e+17,17,89,5.235294117647059,3,7,17,0
9.882507213433601e+17,38,381,10.026315789473685,6,12,1,37
9.882671333406787e+17,3,24,8.0,7,9,1,2
9.882876793324177e+17,20,167,8.35,5,11,2,18
9.882886694547566e+17,24,126,5.25,3,8,23,1
9.882998715580924e+17,12,56,4.666666666666667,4,7,12,0
9.88305106939103e+17,102,206,2.019607843137255,1,5,102,0
9.883446654678871e+17,36,86,2.388888888888889,1,4,36,0
9.883679402956637e+17,47,424,9.02127659574468,4,12,2,45
9.883713578510144e+17,27,81,3.0,1,5,27,0
9.884218165272283e+17,66,643,9.742424242424242,2,13,3,63
9.884465297109112e+17,30,44,1.4666666666666666,1,3,30,0
9.885137709465514e+17,42,127,3.0238095238095237,1,6,42,0
9.885576287197203e+17,60,478,7.966666666666667,4,10,18,42
9.888232343751612e+17,71,678,9.549295774647888,3,12,6,65
9.88862985554314e+17,46,312,6.782608695652174,5,9,36,10
9.888668216551542e+17,39,119,3.051282051282051,1,5,39,0
9.888907477033903e+17,12,117,9.75,8,12,0,12
9.888914445508512e+17,79,663,8.39240506329114,2,12,18,61
9.888957548116576e+17,4,29,7.25,5,8,1,3
9.888959109603087e+17,46,86,1.8695652173913044,1,3,46,0
9.889004558358022e+17,4,7,1.75,1,3,4,0
9.889196748927606e+17,12,35,2.9166666666666665,1,5,12,0
9.889481132137761e+17,6,11,1.8333333333333333,1,3,6,0
9.88974998435229e+17,38,271,7.131578947368421,4,9,22,16
9.890168013480608e+17,46,309,6.717391304347826,3,9,36,10
9.890497318238879e+17,29,76,2.6206896551724137,1,4,29,0
9.89060240068937e+17,2,4,2.0,1,3,2,0
9.891090139815291e+17,19,173,9.105263157894736,7,11,1,18
9.891534021223992e+17,18,119,6.611111111111111,5,9,15,3
9.891598946348251e+17,23,234,10.173913043478262,6,12,1,22
9.891660062277691e+17,1,6,6.0,6,6,1,0
9.89216491864038e+17,1,8,8.0,8,8,0,1
9.892268583617041e+17,21,184,8.761904761904763,7,11,3,18
9.892628897567629e+17,15,80,5.333333333333333,4,7,15,0
9.89263460436234e+17,21,92,4.380952380952381,2,8,20,1
9.896415816556631e+17,1,1,1.0,1,1,1,0
9.896468809387086e+17,32,126,3.9375,2,6,32,0
9.897190593476698e+17,77,381,4.9480519480519485,2,7,77,0
9.897431639551896e+17,51,244,4.784313725490196,2,7,51,0
9.898431451405192e+17,36,238,6.611111111111111,2,9,29,7
9.898432594624764e+17,6,11,1.8333333333333333,1,3,6,0
9.898433814001056e+17,16,108,6.75,5,9,13,3
9.898435114137536e+17,19,36,1.894736842105263,1,4,19,0
9.898436162935628e+17,30,210,7.0,3,9,20,10
9.898437232297527e+17,9,61,6.777777777777778,5,9,7,2
9.898438810282198e+17,4,31,7.75,7,9,2,2
9.898445442913865e+17,41,289,7.048780487804878,5,9,27,14
9.89844680629028e+17,12,77,6.416666666666667,4,9,10,2
9.898452755401965e+17,28,58,2.0714285714285716,1,3,28,0
9.898456305857764e+17,13,84,6.461538461538462,2,9,9,4
9.898922285212394e+17,97,489,5.041237113402062,3,8,96,1
9.899695134204054e+17,63,532,8.444444444444445,2,11,9,54
9.899852904441992e+17,44,121,2.75,1,5,44,0
9.901047772245518e+17,4,7,1.75,1,2,4,0
9.902032892774451e+17,5,9,1.8,1,3,5,0
9.902326373926721e+17,19,172,9.052631578947368,7,11,2,17
9.902351264968051e+17,1,2,2.0,2,2,1,0
9.902558320513644e+17,76,515,6.776315789473684,2,9,57,19
9.903321127687951e+17,45,175,3.888888888888889,2,6,45,0
9.903354289277624e+17,1,3,3.0,3,3,1,0
9.903416633002661e+17,7,13,1.8571428571428572,1,3,7,0
9.904071454403852e+17,3,16,5.333333333333333,4,7,3,0
9.904215021302661e+17,17,30,1.7647058823529411,1,3,17,0
9.90522174459205e+17,77,673,8.74025974025974,2,10,11,66
9.905243803023028e+17,70,623,8.9,4,11,6,64
9.905276323671729e+17,8,13,1.625,1,4,8,0
9.905334672248806e+17,45,323,7.177777777777778,5,9,26,19
9.906668927249454e+17,44,345,7.840909090909091,4,10,15,29
9.906818790457202e+17,60,302,5.033333333333333,3,8,59,1
9.90691826330097e+17,46,128,2.782608695652174,1,5,46,0
9.907638675931872e+17,7,18,2.5714285714285716,1,3,7,0
9.909044054366314e+17,71,547,7.704225352112676,2,10,21,50
9.910167492162612e+17,42,291,6.928571428571429,5,9,28,14
9.91113323014431e+17,26,119,4.576923076923077,2,6,26,0
9.91129958310488e+17,26,104,4.0,2,6,26,0
9.911476521703543e+17,168,1317,7.839285714285714,2,11,56,112
9.911483155304637e+17,69,442,6.405797101449275,2,8,56,13
9.912195685649414e+17,9,53,5.888888888888889,2,8,7,2
9.912616700722153e+17,22,147,6.681818181818182,4,9,17,5
9.912670248098829e+17,45,308,6.844444444444444,4,9,34,11
9.913233178009005e+17,19,177,9.31578947368421,8,11,0,19
9.913253323448684e+17,14,68,4.857142857142857,3,7,14,0
9.915865113218518e+17,38,47,1.236842105263158,1,3,38,0
9.917572026042508e+17,51,505,9.901960784313726,5,12,1,50
9.917760218092739e+17,29,56,1.9310344827586208,1,3,29,0
9.918204146242904e+17,3,3,1.0,1,1,3,0
9.919513660453535e+17,37,84,2.27027027027027,1,4,37,0
9.919615712289628e+17,77,235,3.051948051948052,1,5,77,0
9.920196134123168e+17,5,39,7.8,7,9,2,3
9.920944683845389e+17,139,818,5.884892086330935,2,8,133,6
9.92140161435893e+17,5,35,7.0,6,9,4,1
9.921850430096678e+17,1,11,11.0,11,11,0,1
9.92197271017099e+17,4,17,4.25,3,5,4,0
9.92204576992986e+17,1,11,11.0,11,11,0,1
9.924220314727235e+17,64,328,5.125,3,7,64,0
9.924728750093399e+17,81,393,4.851851851851852,2,7,81,0
9.925441497397811e+17,63,132,2.0952380952380953,1,4,63,0
9.925606289080979e+17,9,85,9.444444444444445,5,11,1,8
9.925645796041466e+17,29,228,7.862068965517241,6,9,7,22
9.92751271572601e+17,4,20,5.0,4,7,4,0
9.93180783652057e+17,58,92,1.5862068965517242,1,4,58,0
9.932060140029587e+17,3,20,6.666666666666667,6,8,2,1
9.932567287637412e+17,69,473,6.855072463768116,3,10,52,17
9.93257787909826e+17,12,27,2.25,1,5,12,0
9.932910237060996e+17,46,101,2.1956521739130435,1,4,46,0
9.933065750496252e+17,31,88,2.838709677419355,1,5,31,0
9.93312308905238e+17,75,137,1.8266666666666667,1,4,75,0
9.933835619609189e+17,20,185,9.25,2,11,2,18
9.93391333530666e+17,49,96,1.9591836734693877,1,4,49,0
9.934140012272899e+17,14,129,9.214285714285714,8,10,0,14
9.93471647594605e+17,9,15,1.6666666666666667,1,3,9,0
9.935617837263327e+17,43,264,6.1395348837209305,3,9,39,4
9.935691287356244e+17,10,16,1.6,1,3,10,0
9.936042312848116e+17,11,14,1.2727272727272727,1,2,11,0
9.936184181995615e+17,37,81,2.189189189189189,1,4,37,0
9.936685582117359e+17,7,47,6.714285714285714,5,8,5,2
9.938503786398307e+17,22,160,7.2727272727272725,5,9,14,8
9.939160793483616e+17,1,6,6.0,6,6,1,0
9.93933713143194e+17,26,172,6.615384615384615,4,9,20,6
9.939879648563377e+17,1,2,2.0,2,2,1,0
9.939932925504759e+17,2,16,8.0,7,9,1,1
9.940778498258743e+17,1,4,4.0,4,4,1,0
9.941132802800042e+17,13,85,6.538461538461538,4,8,11,2
9.941666525722623e+17,7,23,3.2857142857142856,2,5,7,0
9.941735826900475e+17,21,35,1.6666666666666667,1,3,21,0
9.941751198277217e+17,3,21,7.0,6,8,2,1
9.941992953350541e+17,84,432,5.142857142857143,3,8,82,2
9.942172776580643e+17,72,552,7.666666666666667,2,10,27,45
9.942542337661742e+17,2,18,9.0,9,9,0,2
9.942717172150118e+17,24,104,4.333333333333333,3,6,24,0
9.943042677825868e+17,3,7,2.3333333333333335,2,3,3,0
9.943449816474008e+17,36,137,3.8055555555555554,2,5,36,0
9.946118348445084e+17,33,319,9.666666666666666,4,12,2,31
9.946827179052605e+17,2,18,9.0,8,10,0,2
9.947729362004163e+17,10,66,6.6,2,8,6,4
9.947773954293692e+17,34,222,6.529411764705882,2,10,25,9
9.947834085882979e+17,1,3,3.0,3,3,1,0
9.948206793120621e+17,136,1336,9.823529411764707,2,13,7,129
9.948360732920676e+17,64,312,4.875,2,7,64,0
9.94841175711949e+17,69,490,7.101449275362318,4,9,45,24
9.949180964520518e+17,37,194,5.243243243243243,3,8,36,1
9.949560078953434e+17,6,45,7.5,7,9,4,2
9.949973401739114e+17,7,47,6.714285714285714,5,8,6,1
9.9501706015033e+17,3,6,2.0,1,3,3,0
9.953944357333345e+17,35,101,2.8857142857142857,1,5,35,0
9.954358697514868e+17,1,8,8.0,8,8,0,1
9.954548204387113e+17,22,44,2.0,1,4,22,0
9.954763482870938e+17,12,30,2.5,1,4,12,0
9.954780293990189e+17,15,120,8.0,7,10,4,11
9.954782114931155e+17,3,18,6.0,5,7,3,0
9.954916268159475e+17,36,334,9.277777777777779,4,13,3,33
9.954960261714477e+17,86,257,2.988372093023256,1,6,86,0
9.954999428776742e+17,3,8,2.6666666666666665,2,3,3,0
9.95511557454994e+17,3,9,3.0,2,4,3,0
9.955154112425326e+17,6,45,7.5,7,8,3,3
9.95573987753613e+17,42,90,2.142857142857143,1,5,42,0
9.955942858613649e+17,155,932,6.012903225806451,2,9,143,12
9.95788033426928e+17,75,656,8.746666666666666,3,11,7,68
9.957936166407697e+17,8,63,7.875,7,9,3,5
9.958623684810478e+17,13,39,3.0,1,5,13,0
9.958681462731937e+17,25,74,2.96,1,5,25,0
9.958696691418543e+17,16,29,1.8125,1,4,16,0
9.958707474819497e+17,47,127,2.702127659574468,1,5,47,0
9.960770200894981e+17,56,280,5.0,2,8,55,1
9.960951772354244e+17,23,227,9.869565217391305,2,13,1,22
9.960960233734858e+17,1,1,1.0,1,1,1,0
9.961354119160095e+17,47,176,3.74468085106383,1,6,47,0
9.961479213095031e+17,6,28,4.666666666666667,4,6,6,0
9.961502019066502e+17,57,295,5.175438596491228,3,8,56,1
9.961546145116645e+17,28,54,1.9285714285714286,1,5,28,0
9.961691743152124e+17,31,303,9.774193548387096,3,12,2,29
9.961854026558719e+17,6,45,7.5,5,9,2,4
9.962026761522291e+17,33,138,4.181818181818182,1,6,33,0
9.962081986014464e+17,8,66,8.25,6,10,2,6
9.96210847169413e+17,36,110,3.0555555555555554,1,5,36,0
9.962194388208503e+17,15,96,6.4,3,8,11,4
9.962213817771126e+17,3,7,2.3333333333333335,1,4,3,0
9.962494435658985e+17,18,157,8.722222222222221,2,11,3,15
9.962641537085151e+17,11,24,2.1818181818181817,1,4,11,0
9.962664552018158e+17,23,45,1.9565217391304348,1,4,23,0
9.962747056452197e+17,8,57,7.125,6,9,5,3
9.9635979669948e+17,11,75,6.818181818181818,5,8,8,3
9.963655175427526e+17,9,96,10.666666666666666,10,11,0,9
9.963997023240134e+17,52,209,4.019230769230769,2,6,52,0
9.964169287676253e+17,4,16,4.0,4,4,4,0
9.964233760708759e+17,16,80,5.0,3,7,16,0
9.964551736997796e+17,98,656,6.6938775510204085,2,9,70,28
9.965178101814487e+17,1,2,2.0,2,2,1,0
9.965708619147544e+17,39,195,5.0,3,7,39,0
9.967305574384426e+17,64,444,6.9375,5,11,46,18
9.968090909250966e+17,2,3,1.5,1,2,2,0
9.968370148282604e+17,2,22,11.0,10,12,0,2
9.968957217149535e+17,61,409,6.704918032786885,2,9,45,16
9.969124058160736e+17,23,53,2.3043478260869565,1,4,23,0
9.969147111224685e+17,19,34,1.7894736842105263,1,4,19,0
9.970188010056392e+17,3,22,7.333333333333333,6,8,1,2
9.970672362529175e+17,41,343,8.365853658536585,2,11,8,33
9.970682339393902e+17,3,6,2.0,1,3,3,0
9.970961663677302e+17,54,111,2.0555555555555554,1,4,54,0
9.971901685249562e+17,1,8,8.0,8,8,0,1
9.972749296715826e+17,35,52,1.4857142857142858,1,3,35,0
9.97468966465498e+17,1,2,2.0,2,2,1,0
9.975665803389356e+17,4,8,2.0,1,4,4,0
9.975674595505688e+17,1,2,2.0,2,2,1,0
9.975683982231936e+17,1,3,3.0,3,3,1,0
9.975898523639622e+17,7,9,1.2857142857142858,1,2,7,0
9.976752372226651e+17,53,496,9.358490566037736,3,12,4,49
9.977352992196788e+17,74,205,2.77027027027027,1,6,74,0
9.97739397564883e+17,26,76,2.923076923076923,2,5,26,0
9.9782043759067e+17,23,175,7.608695652173913,4,10,9,14
9.978405692761256e+17,11,62,5.636363636363637,4,7,11,0
9.978760696192547e+17,56,552,9.857142857142858,2,12,3,53
9.979012164465765e+17,8,56,7.0,5,9,5,3
9.97916774749157e+17,6,42,7.0,2,9,2,4
9.979251616658659e+17,6,21,3.5,3,4,6,0
9.98227531350072e+17,7,18,2.5714285714285716,2,4,7,0
9.982555774813249e+17,70,335,4.785714285714286,2,7,70,0
9.982906588031561e+17,4,8,2.0,1,3,4,0
9.98398703166112e+17,2,7,3.5,3,4,2,0
9.984137014635818e+17,4,15,3.75,3,4,4,0
9.984842812269249e+17,37,324,8.756756756756756,4,10,7,30
9.985049415387508e+17,11,54,4.909090909090909,4,6,11,0
9.986427992735007e+17,83,486,5.855421686746988,2,8,75,8
9.987063580488154e+17,28,180,6.428571428571429,2,8,22,6
9.989417798859037e+17,22,87,3.9545454545454546,2,6,22,0
9.989588357453742e+17,35,66,1.8857142857142857,1,4,35,0
9.98974724186588e+17,11,55,5.0,3,6,11,0
9.989915917024448e+17,14,42,3.0,1,5,14,0
9.989987368066191e+17,43,97,2.255813953488372,1,4,43,0
9.990265100854821e+17,96,655,6.822916666666667,2,10,68,28
9.990519310956767e+17,7,21,3.0,2,4,7,0
9.990526427323021e+17,28,59,2.107142857142857,1,4,28,0
9.990674558837889e+17,5,16,3.2,1,5,5,0
9.990711652121134e+17,4,30,7.5,7,8,2,2
9.990751490343064e+17,50,100,2.0,1,4,50,0
9.990827528435146e+17,39,72,1.8461538461538463,1,4,39,0
9.99110766059136e+17,73,364,4.986301369863014,2,7,73,0
9.9911161439706e+17,101,493,4.881188118811881,3,8,100,1
9.991246885314493e+17,46,226,4.913043478260869,3,7,46,0
9.991330226870822e+17,2,5,2.5,1,4,2,0
9.991372127705993e+17,121,942,7.785123966942149,2,11,41,80
9.991409957594455e+17,1,7,7.0,7,7,1,0
9.991760566509356e+17,16,105,6.5625,4,8,11,5
9.991810993071461e+17,80,416,5.2,3,7,80,0
9.991896268742149e+17,2,16,8.0,8,8,0,2
9.992353356763109e+17,20,182,9.1,3,12,3,17
9.992383952249326e+17,70,491,7.014285714285714,4,10,49,21
9.992401141513436e+17,7,9,1.2857142857142858,1,2,7,0
9.992767798129217e+17,9,9,1.0,1,1,9,0
9.993426784828973e+17,9,18,2.0,1,3,9,0
9.99371677471923e+17,8,13,1.625,1,3,8,0
9.994789632684673e+17,21,43,2.0476190476190474,1,4,21,0
9.996416234004232e+17,134,932,6.955223880597015,2,10,92,42
9.996656378102428e+17,1,7,7.0,7,7,1,0
9.997205876373956e+17,33,264,8.0,2,11,10,23
9.997251275311503e+17,3,23,7.666666666666667,7,8,1,2
9.997343171171849e+17,30,53,1.7666666666666666,1,3,30,0
9.99746267536342e+17,43,90,2.0930232558139537,1,4,43,0
9.99760690272797e+17,5,13,2.6,1,3,5,0
9.997708396045727e+17,11,87,7.909090909090909,6,9,4,7
9.997804274667552e+17,69,138,2.0,1,4,69,0
9.997812018147501e+17,12,31,2.5833333333333335,1,5,12,0
9.997821696974039e+17,1,1,1.0,1,1,1,0
9.997865194833784e+17,3,19,6.333333333333333,6,7,3,0
9.997878480022156e+17,6,43,7.166666666666667,3,9,3,3
9.997960907974834e+17,30,57,1.9,1,5,30,0
9.998948331115702e+17,1,8,8.0,8,8,0,1
9.999119600941943e+17,1,7,7.0,7,7,1,0
9.999275215468751e+17,45,92,2.0444444444444443,1,4,45,0
9.999329707144127e+17,51,250,4.901960784313726,2,8,50,1
9.999511719040306e+17,73,615,8.424657534246576,2,12,15,58
9.99973907620502e+17,46,215,4.673913043478261,2,7,46,0
9.999809859208841e+17,3,7,2.3333333333333335,2,3,3,0
1.0000070514066143e+18,105,499,4.752380952380952,2,7,105,0
1.0000094723044489e+18,1,2,2.0,2,2,1,0
1.000023769473381e+18,57,272,4.771929824561403,2,8,56,1
1.0003698171808485e+18,10,19,1.9,1,3,10,0
1.0003967932873148e+18,22,198,9.0,5,11,1,21
1.000416891842871e+18,87,877,10.080459770114942,2,12,4,83
1.0004260823255596e+18,22,110,5.0,4,7,22,0
1.0004846812970981e+18,6,37,6.166666666666667,2,9,4,2
1.0005564078757068e+18,7,10,1.4285714285714286,1,2,7,0
1.000651674891963e+18,1,8,8.0,8,8,0,1
1.0006918075600351e+18,1,2,2.0,2,2,1,0
1.0008022325849943e+18,51,447,8.764705882352942,2,11,5,46
1.0008767652641247e+18,5,20,4.0,4,4,5,0
1.0011079364245038e+18,13,52,4.0,2,6,13,0
1.0011872332230766e+18,10,48,4.8,4,6,10,0
1.001198328492693e+18,10,36,3.6,3,5,10,0
1.0011990750609164e+18,92,352,3.8260869565217392,2,6,92,0
1.001206925723326e+18,51,102,2.0,1,4,51,0
1.0012233647090742e+18,91,444,4.8791208791208796,2,7,91,0
1.0012322061987821e+18,114,561,4.921052631578948,2,8,112,2
1.0012322617823452e+18,87,345,3.9655172413793105,1,6,87,0
1.0012498728841079e+18,6,15,2.5,1,4,6,0
1.0012568320966836e+18,41,194,4.7317073170731705,2,7,41,0
1.0012876904634744e+18,54,525,9.722222222222221,3,13,4,50
1.0013042888464143e+18,1,5,5.0,5,5,1,0
1.0013171621189219e+18,10,23,2.3,1,3,10,0
1.0013457554052873e+18,4,28,7.0,4,9,2,2
1.0013483251391841e+18,4,9,2.25,1,4,4,0
1.0013483328026182e+18,3,9,3.0,2,4,3,0
1.0014660231924703e+18,7,47,6.714285714285714,6,9,5,2
1.0014742085829348e+18,19,29,1.5263157894736843,1,3,19,0
1.0014941503564646e+18,143,941,6.580419580419581,2,9,111,32
1.0020649589071327e+18,22,39,1.7727272727272727,1,4,22,0
1.0021219066380667e+18,12,13,1.0833333333333333,1,2,12,0
1.0021515811562158e+18,62,310,5.0,2,7,62,0
1.0022866134978176e+18,10,32,3.2,2,4,10,0
1.002587697483596e+18,3,20,6.666666666666667,5,8,2,1
1.0026503005766118e+18,5,15,3.0,1,5,5,0
1.0026524741813359e+18,6,15,2.5,1,4,6,0
1.0026692543104262e+18,15,101,6.733333333333333,5,8,13,2
1.0027811785956686e+18,4,9,2.25,1,3,4,0
1.0028125668316411e+18,2,6,3.0,3,3,2,0
1.0028171085495567e+18,22,143,6.5,2,8,15,7
1.0029469156634088e+18,24,143,5.958333333333333,4,8,22,2
1.0029507199868099e+18,58,133,2.293103448275862,1,4,58,0
1.0032853825780224e+18,5,44,8.8,8,10,0,5
1.0033159753124283e+18,47,188,4.0,2,6,47,0
1.0033210645161673e+18,2,14,7.0,6,8,1,1
1.0033471722909989e+18,14,39,2.7857142857142856,1,5,14,0
1.0033806556054543e+18,37,67,1.8108108108108107,1,3,37,0
1.00339649062806e+18,45,310,6.888888888888889,3,9,32,13
1.003405538376023e+18,27,185,6.851851851851852,3,8,17,10
1.0034151878557988e+18,24,53,2.2083333333333335,1,4,24,0
1.003420021705971e+18,10,19,1.9,1,3,10,0
1.0034304940093165e+18,2,17,8.5,6,11,1,1
1.0034433289601573e+18,8,58,7.25,6,9,6,2
1.003451978381205e+18,12,46,3.8333333333333335,2,6,12,0
1.0034568998495284e+18,18,121,6.722222222222222,5,8,15,3
1.0034669848390892e+18,47,183,3.893617021276596,2,6,47,0
1.0034693115760018e+18,23,48,2.0869565217391304,1,3,23,0
1.0034819530915117e+18,41,89,2.1707317073170733,1,4,41,0
1.0034876508512468e+18,59,585,9.915254237288135,5,12,4,55
1.0034944796667302e+18,6,11,1.8333333333333333,1,3,6,0
1.0035068017881573e+18,1,4,4.0,4,4,1,0
1.0035212950807488e+18,38,257,6.7631578947368425,3,9,28,10
1.0035338599457391e+18,3,25,8.333333333333334,6,10,1,2
1.0035365190157769e+18,1,7,7.0,7,7,1,0
1.0035397104714036e+18,1,9,9.0,9,9,0,1
1.0035401621057509e+18,35,74,2.1142857142857143,1,4,35,0
1.0035513074388494e+18,3,27,9.0,7,11,1,2
1.0035582639955369e+18,1,2,2.0,2,2,1,0
1.0035909235648156e+18,19,133,7.0,5,10,15,4
1.0036109886920164e+18,24,162,6.75,5,8,16,8
1.0036138441803146e+18,22,149,6.7727272727272725,5,8,15,7
1.0036170820633482e+18,3,25,8.333333333333334,8,9,0,3
1.0036177247314824e+18,28,64,2.2857142857142856,1,5,28,0
1.003621663740136e+18,48,103,2.1458333333333335,1,4,48,0
1.0036250388455103e+18,28,131,4.678571428571429,2,7,28,0
1.0036277097606776e+18,8,40,5.0,3,7,8,0
1.0036293953766857e+18,31,47,1.5161290322580645,1,3,31,0
1.0036638024823581e+18,2,14,7.0,7,7,2,0
1.003684125600953e+18,27,189,7.0,5,8,16,11
1.003688746006267e+18,58,168,2.896551724137931,1,5,58,0
1.0037401720877713e+18,11,21,1.9090909090909092,1,3,11,0
1.003997385109451e+18,1,1,1.0,1,1,1,0
1.0040350225777893e+18,9,73,8.11111111111111,2,11,1,8
1.0040482801855094e+18,4,25,6.25,5,7,4,0
1.004064666145735e+18,78,147,1.8846153846153846,1,4,78,0
1.0040792492257243e+18,7,13,1.8571428571428572,1,4,7,0
1.0040830277817519e+18,44,216,4.909090909090909,2,7,44,0
1.0040925414980582e+18,85,754,8.870588235294118,2,11,8,77
1.0041160162700215e+18,28,184,6.571428571428571,3,9,21,7
1.0041941348566344e+18,51,256,5.019607843137255,3,7,51,0
1.0041961948040503e+18,53,113,2.1320754716981134,1,4,53,0
1.0042279597034988e+18,9,35,3.888888888888889,2,5,9,0
1.0042763298348489e+18,64,261,4.078125,2,6,64,0
1.0042772804686295e+18,28,262,9.357142857142858,2,11,3,25
1.0042980362396472e+18,1,1,1.0,1,1,1,0
1.004305762997501e+18,19,168,8.842105263157896,7,11,3,16
1.0043095525126446e+18,30,281,9.366666666666667,7,11,1,29
1.0043191402306534e+18,63,307,4.873015873015873,2,7,63,0
1.0043676504249155e+18,1,5,5.0,5,5,1,0
1.004404464118795e+18,3,12,4.0,4,4,3,0
1.0044091420186662e+18,79,683,8.645569620253164,2,11,11,68
1.0044412042290816e+18,2,17,8.5,8,9,0,2
1.004451735859219e+18,16,126,7.875,2,10,5,11
1.0047232164941417e+18,2,16,8.0,8,8,0,2
1.0047625802010047e+18,2,14,7.0,6,8,1,1
1.0047944072513434e+18,59,115,1.9491525423728813,1,4,59,0
1.0048143013759442e+18,11,69,6.2727272727272725,4,8,8,3
1.0048444272648956e+18,29,287,9.89655172413793,4,13,1,28
1.0048454948009527e+18,52,121,2.326923076923077,1,5,52,0
1.0048472881910948e+18,30,258,8.6,4,11,4,26
1.0048754351794932e+18,3,5,1.6666666666666667,1,3,3,0
1.0048784492170086e+18,4,25,6.25,2,8,2,2
1.0048906212248504e+18,52,259,4.980769230769231,2,8,51,1
1.0049551615392972e+18,7,18,2.5714285714285716,1,4,7,0
1.0049583267840582e+18,38,77,2.026315789473684,1,4,38,0
1.0049732269169082e+18,12,34,2.8333333333333335,2,4,12,0
1.0049952908811054e+18,2,2,1.0,1,1,2,0
1.0051789862925545e+18,103,418,4.058252427184466,1,7,103,0
1.0052200126006886e+18,53,107,2.018867924528302,1,4,53,0
1.0055154757508018e+18,75,160,2.1333333333333333,1,5,75,0
1.0055266262768736e+18,16,35,2.1875,1,4,16,0
1.0056035393398756e+18,4,29,7.25,6,9,2,2
1.005646567299563e+18,2,17,8.5,8,9,0,2
1.0056633007317956e+18,13,55,4.230769230769231,3,7,13,0
1.0056746265835291e+18,13,50,3.8461538461538463,2,5,13,0
1.0056946084307823e+18,6,11,1.8333333333333333,1,3,6,0
1.0056970064243044e+18,15,103,6.866666666666666,3,9,9,6
1.0057081507136796e+18,59,238,4.033898305084746,2,7,59,0
1.005744907677314e+18,5,7,1.4,1,2,5,0
1.0057466373083752e+18,21,179,8.523809523809524,2,11,3,18
1.0058865534552114e+18,7,51,7.285714285714286,6,8,4,3
1.0059037687111803e+18,14,61,4.357142857142857,2,6,14,0
1.005971768443251e+18,55,380,6.909090909090909,2,10,35,20
1.0062788198337702e+18,26,51,1.9615384615384615,1,4,26,0
1.0062793807910299e+18,26,117,4.5,3,6,26,0
1.0062824026072724e+18,4,5,1.25,1,2,4,0
1.0063038704844434e+18,1,8,8.0,8,8,0,1
1.006347604296964e+18,2,16,8.0,7,9,1,1
1.0063592768709536e+18,1,2,2.0,2,2,1,0
1.0063785749283261e+18,5,35,7.0,3,8,1,4
1.0064243066455252e+18,63,327,5.190476190476191,3,7,63,0
1.0064259478708781e+18,75,379,5.053333333333334,2,8,74,1
1.0064519322169829e+18,18,46,2.5555555555555554,1,4,18,0
1.0064728373445917e+18,8,21,2.625,1,4,8,0
1.0064729828742529e+18,10,17,1.7,1,3,10,0
1.0064738124155784e+18,5,12,2.4,1,3,5,0
1.0064746218919694e+18,3,22,7.333333333333333,7,8,2,1
1.0064749494521123e+18,7,16,2.2857142857142856,1,4,7,0
1.0064751729235677e+18,29,203,7.0,5,10,21,8
1.0064754636460769e+18,20,146,7.3,6,10,12,8
1.006475498442496e+18,9,65,7.222222222222222,5,9,5,4
1.0064758192558035e+18,43,293,6.813953488372093,2,9,29,14
1.0064760702067583e+18,9,19,2.111111111111111,1,5,9,0
1.006477132303305e+18,13,22,1.6923076923076923,1,3,13,0
1.0064774326499373e+18,11,23,2.090909090909091,1,4,11,0
1.0064840454141532e+18,1,4,4.0,4,4,1,0
1.0065049609100675e+18,55,381,6.927272727272728,2,10,32,23
1.006640723838449e+18,23,165,7.173913043478261,5,10,18,5
1.0066776191582664e+18,115,245,2.130434782608696,1,4,115,0
1.0069541232213178e+18,16,77,4.8125,4,6,16,0
1.0069777669477064e+18,18,87,4.833333333333333,2,7,18,0
1.0070023394429623e+18,81,525,6.481481481481482,2,9,63,18
1.0070030751641057e+18,58,121,2.086206896551724,1,4,58,0
1.007237704084404e+18,104,515,4.951923076923077,2,8,103,1
1.0072435943124288e+18,2,22,11.0,11,11,0,2
1.0073337360151949e+18,1,3,3.0,3,3,1,0
1.0073346850973844e+18,11,77,7.0,6,9,8,3
1.0073348823653421e+18,17,123,7.235294117647059,4,9,10,7
1.0073373409696622e+18,39,71,1.8205128205128205,1,4,39,0
1.0073615116917693e+18,22,111,5.045454545454546,3,7,22,0
1.0074320177593742e+18,17,33,1.9411764705882353,1,4,17,0
1.007611768357814e+18,68,638,9.382352941176471,2,12,7,61
1.0077143085622013e+18,9,59,6.555555555555555,5,7,9,0
1.0077442426559895e+18,26,132,5.076923076923077,3,7,26,0
1.0078013440631799e+18,25,93,3.72,1,5,25,0
1.0078369006531462e+18,16,78,4.875,2,6,16,0
1.0078533969876151e+18,88,766,8.704545454545455,2,12,9,79
1.0078803508720087e+18,3,18,6.0,5,7,3,0
1.0079070647348448e+18,5,20,4.0,1,5,5,0
1.0079765158796175e+18,1,10,10.0,10,10,0,1
1.0079791399805528e+18,15,109,7.266666666666667,4,9,9,6
1.0080093242823613e+18,2,11,5.5,4,7,2,0
1.0080108843862299e+18,15,142,9.466666666666667,2,12,1,14
1.0080484953514979e+18,1,3,3.0,3,3,1,0
1.0080516683393932e+18,19,116,6.105263157894737,4,9,16,3
1.0080700950707086e+18,5,15,3.0,2,5,5,0
1.0081286214013971e+18,92,187,2.032608695652174,1,5,92,0
1.0083985796325757e+18,44,294,6.681818181818182,2,9,28,16
1.0084072892593056e+18,2,13,6.5,6,7,2,0
1.0084129165984454e+18,63,593,9.412698412698413,2,12,7,56
1.0084134459232861e+18,20,80,4.0,2,6,20,0
1.0084191354933046e+18,5,52,10.4,9,12,0,5
1.0084240961849295e+18,3,5,1.6666666666666667,1,2,3,0
1.0084631478643424e+18,21,105,5.0,2,7,21,0
1.0084709708653005e+18,10,18,1.8,1,4,10,0
1.00847545332322e+18,125,617,4.936,3,8,124,1
1.0085467049264991e+18,6,7,1.1666666666666667,1,2,6,0
1.0085639376487762e+18,27,135,5.0,4,6,27,0
1.0085909050012361e+18,109,222,2.036697247706422,1,4,109,0
1.0086011826635668e+18,15,27,1.8,1,4,15,0
1.0086222457081787e+18,5,36,7.2,6,8,3,2
1.0086296188180364e+18,147,1006,6.843537414965986,2,10,101,46
1.0086368291025637e+18,105,225,2.142857142857143,1,4,105,0
1.0086505030517853e+18,194,1360,7.010309278350515,2,10,130,64
1.0086554805051163e+18,130,275,2.1153846153846154,1,5,130,0
1.008655797308717e+18,1,1,1.0,1,1,1,0
1.008673349945285e+18,1,2,2.0,2,2,1,0
1.0087119240639336e+18,14,36,2.5714285714285716,1,5,14,0
1.0087491947741907e+18,5,14,2.8,1,4,5,0
1.0087777362715502e+18,7,46,6.571428571428571,6,8,6,1
1.0087909379218104e+18,24,161,6.708333333333333,2,8,16,8
1.0087983202462492e+18,11,46,4.181818181818182,2,5,11,0
1.0088057524569421e+18,32,59,1.84375,1,3,32,0
1.0088124658894788e+18,21,97,4.619047619047619,2,7,21,0
1.0088141526460827e+18,14,97,6.928571428571429,3,9,9,5
1.0088289265850397e+18,16,32,2.0,1,4,16,0
1.008829300827407e+18,144,436,3.0277777777777777,1,6,144,0
1.0088352672226826e+18,47,174,3.702127659574468,1,6,47,0
1.0091175386161112e+18,50,195,3.9,2,6,50,0
1.0092137399050684e+18,30,121,4.033333333333333,2,6,30,0
1.0092244427453303e+18,8,26,3.25,1,5,8,0
1.0092253176228924e+18,5,41,8.2,7,10,2,3
1.0092565253712663e+18,71,292,4.112676056338028,2,7,71,0
1.0092602892871476e+18,2,7,3.5,3,4,2,0
1.0092982030830442e+18,69,334,4.840579710144928,2,7,69,0
1.0093441058979059e+18,79,522,6.6075949367088604,2,9,58,21
1.0093658878022204e+18,1,7,7.0,7,7,1,0
1.009373854335643e+18,1,6,6.0,6,6,1,0
1.0093750114209326e+18,35,171,4.885714285714286,2,7,35,0
1.0093789592205809e+18,33,65,1.9696969696969697,1,4,33,0
1.0094097942149974e+18,2,15,7.5,7,8,1,1
1.0094222590033047e+18,83,178,2.144578313253012,1,5,83,0
1.0094443713980777e+18,79,758,9.594936708860759,3,12,7,72
1.0094646824122199e+18,98,285,2.9081632653061225,1,5,98,0
1.0094650233722289e+18,3,21,7.0,7,7,3,0
1.0094663457272282e+18,78,141,1.8076923076923077,1,4,78,0
1.0094677840868918e+18,116,337,2.9051724137931036,1,5,116,0
1.0094691458420831e+18,85,174,2.0470588235294116,1,5,85,0
1.0095778150991864e+18,65,441,6.7846153846153845,3,9,50,15
1.0097612797993603e+18,29,198,6.827586206896552,3,9,19,10
1.0098171983543864e+18,9,66,7.333333333333333,6,9,5,4
1.0098774688180361e+18,7,62,8.857142857142858,3,11,1,6
1.009880178118493e+18,69,208,3.0144927536231885,1,6,69,0
1.0098863272238107e+18,3,11,3.6666666666666665,3,4,3,0
1.0099282809362799e+18,4,9,2.25,1,3,4,0
1.0099422195057606e+18,56,528,9.428571428571429,2,12,3,53
1.0099588488202632e+18,89,774,8.696629213483146,2,11,14,75
1.009974859239526e+18,15,100,6.666666666666667,5,9,13,2
1.0100137176082249e+18,138,916,6.63768115942029,2,9,108,30
1.0100508857784307e+18,27,137,5.074074074074074,3,7,27,0
1.010065875020016e+18,76,224,2.9473684210526314,1,5,76,0
1.0100811494388815e+18,5,8,1.6,1,3,5,0
1.0101366570010053e+18,3,15,5.0,4,6,3,0
1.0101469114472106e+18,6,37,6.166666666666667,5,7,6,0
1.010210419359966e+18,48,333,6.9375,4,9,35,13
1.0105304847387122e+18,9,16,1.7777777777777777,1,4,9,0
1.0105815160396973e+18,54,178,3.2962962962962963,1,6,54,0
1.0106194604720334e+18,55,505,9.181818181818182,2,12,7,48
1.0106215396258235e+18,87,508,5.839080459770115,3,9,77,10
1.0106599339466653e+18,21,165,7.857142857142857,3,10,5,16
1.0107001090424818e+18,11,23,2.090909090909091,1,3,11,0
1.010725054099884e+18,6,19,3.1666666666666665,2,4,6,0
1.0107412597326403e+18,1,2,2.0,2,2,1,0
1.0108123143287103e+18,2,4,2.0,1,3,2,0
1.0108174144530884e+18,3,16,5.333333333333333,4,6,3,0
1.0108205683113137e+18,4,5,1.25,1,2,4,0
1.0108265114550496e+18,54,212,3.925925925925926,2,7,54,0
1.0108357112045718e+18,3,10,3.3333333333333335,3,4,3,0
1.0109006702291324e+18,5,5,1.0,1,1,5,0
1.0109139775596138e+18,3,4,1.3333333333333333,1,2,3,0
1.0109390865363032e+18,1,1,1.0,1,1,1,0
1.0109460707391991e+18,8,62,7.75,6,9,3,5
1.0113335815547663e+18,2,8,4.0,3,5,2,0
1.0113651889853772e+18,12,22,1.8333333333333333,1,3,12,0
1.0114053701127479e+18,36,126,3.5,2,5,36,0
1.0114837138298095e+18,24,124,5.166666666666667,3,7,24,0
1.0116763729067072e+18,8,18,2.25,1,4,8,0
1.0117625759179712e+18,43,279,6.488372093023256,2,9,34,9
1.0120824573133272e+18,14,61,4.357142857142857,3,6,14,0
1.0120833410917764e+18,19,43,2.263157894736842,1,4,19,0
1.0120845728574391e+18,63,521,8.26984126984127,2,11,11,52
1.0120997737486547e+18,79,760,9.620253164556962,2,12,7,72
1.0121520022962597e+18,5,35,7.0,6,8,4,1
1.012183629573661e+18,101,419,4.148514851485149,2,7,101,0
1.0123056900755325e+18,2,13,6.5,6,7,2,0
1.0123266351494147e+18,121,713,5.892561983471074,3,8,119,2
1.0123571730356348e+18,6,8,1.3333333333333333,1,2,6,0
1.0123726001029875e+18,1,1,1.0,1,1,1,0
1.0124328942157151e+18,20,42,2.1,1,4,20,0
1.0124792645800714e+18,20,104,5.2,4,7,20,0
1.0128061687041325e+18,5,8,1.6,1,2,5,0
1.0128482900977713e+18,108,935,8.657407407407407,3,11,16,92
1.0129373135236357e+18,31,128,4.129032258064516,1,6,31,0
1.0129541635357169e+18,63,455,7.222222222222222,5,10,38,25
1.0129739874750984e+18,2,13,6.5,6,7,2,0
1.012976789399108e+18,42,330,7.857142857142857,6,10,14,28
1.012992944264132e+18,50,199,3.98,2,6,50,0
1.0130171249422267e+18,10,21,2.1,1,4,10,0
1.0130212195833971e+18,1,2,2.0,2,2,1,0
1.0130312001305862e+18,68,349,5.132352941176471,3,7,68,0
1.0130385652544495e+18,17,100,5.882352941176471,4,8,16,1
1.0130971079331429e+18,36,210,5.833333333333333,2,8,34,2
1.0131037083693882e+18,17,34,2.0,1,5,17,0
1.0131076797062642e+18,135,270,2.0,1,4,135,0
1.0131379239221984e+18,60,358,5.966666666666667,3,9,54,6
1.0134591005130126e+18,61,303,4.967213114754099,3,8,60,1
1.0135241000308296e+18,14,92,6.571428571428571,4,9,9,5
1.0135330735959182e+18,37,355,9.594594594594595,2,13,1,36
1.0135343562712346e+18,48,322,6.708333333333333,2,9,33,15
1.0135780140684077e+18,2,4,2.0,1,3,2,0
1.0135874140383951e+18,11,28,2.5454545454545454,1,4,11,0
1.0136158113588744e+18,67,134,2.0,1,4,67,0
1.013616990400359e+18,25,52,2.08,1,4,25,0
1.0136308576404321e+18,9,37,4.111111111111111,2,6,9,0
1.0137063366924516e+18,3,23,7.666666666666667,7,8,1,2
1.0137091357762221e+18,4,9,2.25,1,3,4,0
1.0137228927084404e+18,13,87,6.6923076923076925,5,8,11,2
1.0137305630903735e+18,15,98,6.533333333333333,2,9,12,3
1.0137308076977696e+18,3,7,2.3333333333333335,1,3,3,0
1.013744310735697e+18,2,6,3.0,3,3,2,0
1.0137511079897987e+18,1,2,2.0,2,2,1,0
1.0137985394322796e+18,4,40,10.0,9,11,0,4
1.0138445082502436e+18,4,6,1.5,1,2,4,0
1.0138562768625199e+18,8,53,6.625,4,9,5,3
1.0138808087001897e+18,24,117,4.875,3,7,24,0
1.0139058620935318e+18,34,41,1.2058823529411764,1,3,34,0
1.0140730192910202e+18,24,155,6.458333333333333,2,9,18,6
1.0141263804655859e+18,3,5,1.6666666666666667,1,2,3,0
1.01419547202699e+18,10,74,7.4,7,8,6,4
1.0142412312262972e+18,43,303,7.046511627906977,5,8,30,13
1.0142715943763565e+18,20,109,5.45,4,8,19,1
1.0142821984677733e+18,2,7,3.5,3,4,2,0
1.0143148485698611e+18,8,10,1.25,1,2,8,0
1.0143324268699999e+18,16,78,4.875,4,6,16,0
1.0143858754131191e+18,37,115,3.108108108108108,1,5,37,0
1.0144451158407625e+18,25,119,4.76,3,7,25,0
1.0144499052776005e+18,61,577,9.459016393442623,2,12,4,57
1.0145129867035945e+18,98,373,3.806122448979592,2,6,98,0
1.0145237138059232e+18,98,402,4.1020408163265305,2,7,98,0
1.0145364663854125e+18,35,298,8.514285714285714,3,11,5,30
1.0146341689712676e+18,9,31,3.4444444444444446,2,4,9,0
1.0149225553206692e+18,1,2,2.0,2,2,1,0
1.0149235263286643e+18,20,146,7.3,6,10,13,7
1.0150013192344536e+18,16,30,1.875,1,3,16,0
1.0150461771068018e+18,1,7,7.0,7,7,1,0
1.0150531063745312e+18,2,19,9.5,8,11,0,2
1.0150532665348681e+18,8,28,3.5,2,5,8,0
1.0150668829561244e+18,8,14,1.75,1,4,8,0
1.0150777290948934e+18,10,49,4.9,2,7,10,0
1.0150928755863329e+18,4,6,1.5,1,2,4,0
1.0150970930325418e+18,48,390,8.125,2,10,10,38
1.015097196128662e+18,9,41,4.555555555555555,4,5,9,0
1.0150987928055409e+18,34,49,1.4411764705882353,1,3,34,0
1.0151129453039547e+18,25,44,1.76,1,3,25,0
1.0151159864347357e+18,1,1,1.0,1,1,1,0
1.0151209557257242e+18,33,64,1.9393939393939394,1,3,33,0
1.0151279519029898e+18,11,28,2.5454545454545454,1,4,11,0
1.0151332959713158e+18,22,51,2.3181818181818183,1,4,22,0
1.0151417111436113e+18,13,26,2.0,1,3,13,0
1.015152828965173e+18,35,97,2.7714285714285714,1,5,35,0
1.0151860410480731e+18,30,275,9.166666666666666,4,12,3,27
1.0152013864687002e+18,37,97,2.6216216216216215,1,4,37,0
1.0154934738932443e+18,72,501,6.958333333333333,2,9,46,26
1.0156423190953992e+18,2,3,1.5,1,2,2,0
1.0156701633176502e+18,23,148,6.434782608695652,4,9,19,4
1.0156942333677516e+18,2,15,7.5,7,8,1,1
1.015698241544485e+18,6,11,1.8333333333333333,1,3,6,0
1.0157051538143909e+18,18,139,7.722222222222222,4,10,6,12
1.015718232422858e+18,63,563,8.936507936507937,7,11,7,56
1.0157717708680986e+18,4,25,6.25,3,8,3,1
1.0158415772964941e+18,42,211,5.023809523809524,3,7,42,0
1.0158421566244992e+18,34,135,3.9705882352941178,2,6,34,0
1.0158627341766963e+18,76,303,3.986842105263158,1,7,76,0
1.0158651504329078e+18,9,15,1.6666666666666667,1,3,9,0
1.0159208745958666e+18,1,8,8.0,8,8,0,1
1.0159217652864959e+18,1,6,6.0,6,6,1,0
1.0159490979692175e+18,73,104,1.4246575342465753,1,3,73,0
1.01597383639364e+18,71,95,1.3380281690140845,1,3,71,0
1.0159746525587505e+18,45,307,6.822222222222222,3,9,32,13
1.0159754185096855e+18,14,119,8.5,4,11,3,11
1.015980397062729e+18,57,77,1.3508771929824561,1,4,57,0
1.015987829563231e+18,81,476,5.8765432098765435,2,9,75,6
1.0160119803273372e+18,20,195,9.75,6,11,2,18
1.0160231788200806e+18,98,954,9.73469387755102,3,12,6,92
1.0160246406484914e+18,75,729,9.72,3,14,6,69
1.0160715461152315e+18,20,40,2.0,1,4,20,0
1.0160806702893925e+18,119,470,3.9495798319327733,1,7,119,0
1.016084477161971e+18,1,6,6.0,6,6,1,0
1.0163845652212786e+18,61,529,8.672131147540984,5,12,7,54
1.0163917790916947e+18,49,494,10.081632653061224,4,12,1,48
1.0163938065359859e+18,17,81,4.764705882352941,2,6,17,0
1.0164410893145606e+18,91,357,3.923076923076923,2,6,91,0
1.0164436338793578e+18,86,161,1.872093023255814,1,4,86,0
1.0164679328737615e+18,2,4,2.0,1,3,2,0
1.016468177823879e+18,40,81,2.025,1,5,40,0
1.016529931467666e+18,100,306,3.06,1,5,100,0
1.0165325524072251e+18,1,8,8.0,8,8,0,1
1.0165494294739931e+18,1,4,4.0,4,4,1,0
1.0165895789719919e+18,44,204,4.636363636363637,2,7,44,0
1.0165901724599603e+18,24,54,2.25,1,5,24,0
1.016625933818757e+18,6,49,8.166666666666666,8,9,0,6
1.0166341047747442e+18,16,90,5.625,4,8,15,1
1.0169723875918525e+18,36,143,3.9722222222222223,2,6,36,0
1.0171003588119041e+18,20,87,4.35,2,6,20,0
1.0171206893180462e+18,41,130,3.1707317073170733,1,5,41,0
1.017157084867136e+18,5,11,2.2,1,4,5,0
1.0171863724403674e+18,87,441,5.068965517241379,2,7,87,0
1.0171973780781688e+18,138,1334,9.666666666666666,2,12,7,131
1.0172551804038857e+18,35,233,6.6571428571428575,3,8,25,10
1.0172906090953052e+18,28,116,4.142857142857143,2,7,28,0
1.0172977155908268e+18,69,348,5.043478260869565,3,8,68,1
1.0173218117985148e+18,9,80,8.88888888888889,8,10,0,9
1.0173264166745093e+18,24,131,5.458333333333333,3,8,23,1
1.017331797802108e+18,4,5,1.25,1,2,4,0
1.0173935637164163e+18,1,12,12.0,12,12,0,1
1.0173970459511732e+18,49,241,4.918367346938775,2,7,49,0
1.0174350696191094e+18,108,1046,9.685185185185185,2,13,6,102
1.0175135527314789e+18,12,105,8.75,3,11,2,10
1.0175263444591823e+18,17,77,4.529411764705882,3,7,17,0
1.0175402479446932e+18,39,387,9.923076923076923,7,12,2,37
1.0178300177312175e+18,8,14,1.75,1,3,8,0
1.0178383515108881e+18,6,9,1.5,1,2,6,0
1.0178462470782369e+18,24,49,2.0416666666666665,1,4,24,0
1.0178558220955387e+18,70,282,4.0285714285714285,2,7,70,0
1.0178656422994341e+18,54,274,5.074074074074074,3,8,53,1
1.0179143578946404e+18,13,26,2.0,1,4,13,0
1.017968554385628e+18,40,160,4.0,2,6,40,0
1.0179865922299034e+18,2,12,6.0,5,7,2,0
1.0180525876995722e+18,25,125,5.0,2,7,25,0
1.0181034318333201e+18,6,7,1.1666666666666667,1,2,6,0
1.0181201935834364e+18,13,129,9.923076923076923,7,12,1,12
1.0181203000857439e+18,5,24,4.8,3,6,5,0
1.0181331255606515e+18,6,36,6.0,3,8,5,1
1.0181408628226235e+18,2,6,3.0,3,3,2,0
1.0181442304540472e+18,11,102,9.272727272727273,4,11,1,10
1.0181745209103741e+18,3,13,4.333333333333333,4,5,3,0
1.0181793283060333e+18,34,71,2.088235294117647,1,4,34,0
1.0181873340050675e+18,22,55,2.5,1,5,22,0
1.0182028160821076e+18,63,307,4.873015873015873,2,7,63,0
1.0182090245242282e+18,5,22,4.4,3,6,5,0
1.0182341358355941e+18,48,146,3.0416666666666665,1,5,48,0
1.0182797478695592e+18,8,36,4.5,2,6,8,0
1.0185482917227648e+18,2,7,3.5,3,4,2,0
1.0185783157427903e+18,2,20,10.0,10,10,0,2
1.0185906959534237e+18,119,227,1.9075630252100841,1,5,119,0
1.018590780337953e+18,38,75,1.9736842105263157,1,3,38,0
1.018604409489944e+18,15,31,2.066666666666667,1,3,15,0
1.0186127025849184e+18,37,254,6.864864864864865,2,9,24,13
1.0186173122734088e+18,82,167,2.0365853658536586,1,4,82,0
1.0186253557549828e+18,49,108,2.204081632653061,1,4,49,0
1.0186322022565454e+18,34,71,2.088235294117647,1,4,34,0
1.0186641792642853e+18,2,17,8.5,8,9,0,2
1.0187156647497718e+18,52,460,8.846153846153847,2,11,6,46
1.0187456653511565e+18,22,49,2.227272727272727,1,4,22,0
1.0187611785862518e+18,15,74,4.933333333333334,4,7,15,0
1.0187888098619174e+18,20,73,3.65,2,6,20,0
1.0188049898458607e+18,22,43,1.9545454545454546,1,4,22,0
1.0188480901729489e+18,18,90,5.0,4,7,18,0
1.0188927758826299e+18,79,166,2.1012658227848102,1,4,79,0
1.0189496863015162e+18,58,214,3.689655172413793,2,6,58,0
1.0190112074736502e+18,58,443,7.637931034482759,2,10,23,35
1.0191342954120758e+18,1,3,3.0,3,3,1,0
1.0193078655838838e+18,4,18,4.5,3,6,4,0
1.0193127932974726e+18,9,20,2.2222222222222223,1,5,9,0
1.0193156275282048e+18,41,84,2.048780487804878,1,4,41,0
1.019330972749144e+18,38,118,3.1052631578947367,1,5,38,0
1.0193429946750459e+18,16,30,1.875,1,4,16,0
1.0193485489180653e+18,14,25,1.7857142857142858,1,4,14,0
1.0193514043541944e+18,38,254,6.684210526315789,3,9,29,9
1.0193615930086148e+18,128,490,3.828125,1,6,128,0
1.0193785120293134e+18,44,87,1.9772727272727273,1,5,44,0
1.0194058525497021e+18,14,139,9.928571428571429,9,11,0,14
1.0194471857067804e+18,31,68,2.193548387096774,1,4,31,0
1.0194579976495987e+18,2,7,3.5,3,4,2,0
1.0194800484105475e+18,1,10,10.0,10,10,0,1
1.019507985364907e+18,21,213,10.142857142857142,8,12,0,21
1.0195462699423944e+18,75,212,2.8266666666666667,1,5,75,0
1.0195526400835375e+18,25,172,6.88,5,9,18,7
1.019567112870282e+18,19,181,9.526315789473685,6,11,2,17
1.0196077133308329e+18,5,45,9.0,4,11,1,4
1.0196561433393697e+18,4,30,7.5,6,9,2,2
1.019708158283701e+18,122,483,3.959016393442623,1,7,122,0
1.0197236712132919e+18,75,239,3.1866666666666665,1,5,75,0
1.019779112745781e+18,15,31,2.066666666666667,1,3,15,0
1.0199413495801202e+18,16,156,9.75,8,12,0,16
1.0199831694143109e+18,86,832,9.674418604651162,3,12,4,82
1.0199942980553192e+18,2,16,8.0,7,9,1,1
1.0199967621716187e+18,6,13,2.1666666666666665,1,4,6,0
1.0200559482171707e+18,96,836,8.708333333333334,2,11,11,85
1.0200636330368452e+18,15,69,4.6,3,6,15,0
1.0200773756120865e+18,3,6,2.0,1,4,3,0
1.0200993325148214e+18,7,48,6.857142857142857,6,7,7,0
1.0201004773482596e+18,9,66,7.333333333333333,4,9,5,4
1.0201019291985656e+18,7,16,2.2857142857142856,1,3,7,0
1.0201058684089786e+18,1,4,4.0,4,4,1,0
1.0201217612192172e+18,9,18,2.0,1,4,9,0
1.0201506625326424e+18,42,366,8.714285714285714,2,11,6,36
1.0201518877414266e+18,8,56,7.0,6,9,5,3
1.0201529591697092e+18,33,68,2.0606060606060606,1,4,33,0
1.0201577132645286e+18,12,20,1.6666666666666667,1,3,12,0
1.0201595705058525e+18,7,49,7.0,6,8,5,2
1.0201604964762938e+18,6,47,7.833333333333333,7,9,2,4
1.0201613785973962e+18,35,77,2.2,1,5,35,0
1.0201705906028468e+18,60,285,4.75,3,7,60,0
1.0201746488774854e+18,13,28,2.1538461538461537,1,3,13,0
1.0201885809085012e+18,35,96,2.742857142857143,1,5,35,0
1.0202110096227196e+18,7,9,1.2857142857142858,1,2,7,0
1.0202131279267702e+18,2,14,7.0,7,7,2,0
1.020272517309859e+18,5,47,9.4,9,10,0,5
1.0203082840252741e+18,2,2,1.0,1,1,2,0
1.0203219783490198e+18,11,21,1.9090909090909092,1,3,11,0
1.0203222976904982e+18,2,14,7.0,7,7,2,0
1.0203369369872383e+18,6,43,7.166666666666667,6,9,4,2
1.020342308112462e+18,7,43,6.142857142857143,5,7,7,0
1.0203711404653871e+18,29,60,2.0689655172413794,1,4,29,0
1.0204004095034388e+18,13,116,8.923076923076923,3,11,1,12
1.0204144199460964e+18,4,18,4.5,4,5,4,0
1.0204144690645956e+18,16,80,5.0,2,8,15,1
1.020452376893104e+18,45,227,5.044444444444444,3,7,45,0
1.0207328801382898e+18,4,8,2.0,1,3,4,0
1.0207654357607635e+18,7,20,2.857142857142857,1,4,7,0
1.0207879869321972e+18,28,143,5.107142857142857,3,8,27,1
1.0208051377805431e+18,30,92,3.066666666666667,1,6,30,0
1.0208203643505123e+18,30,92,3.066666666666667,1,5,30,0
1.0208327152316157e+18,21,28,1.3333333333333333,1,2,21,0
1.0208397479924722e+18,27,85,3.1481481481481484,2,6,27,0
1.0208634497721444e+18,15,81,5.4,3,8,14,1
1.0209041744086024e+18,5,21,4.2,3,5,5,0
1.0209321973323905e+18,5,9,1.8,1,3,5,0
1.0209505613045914e+18,37,221,5.972972972972973,3,8,36,1
1.0209630317679483e+18,40,196,4.9,3,7,40,0
1.0210735715884004e+18,5,41,8.2,3,11,2,3
1.0211080696616896e+18,23,49,2.130434782608696,1,4,23,0
1.0211304434137513e+18,115,231,2.008695652173913,1,4,115,0
1.0211345840747613e+18,6,38,6.333333333333333,6,7,6,0
1.0214263210623802e+18,8,50,6.25,3,8,6,2
1.0214428956294778e+18,4,33,8.25,7,9,1,3
1.0214919227610158e+18,26,138,5.3076923076923075,3,7,26,0
1.0214930439985363e+18,14,46,3.2857142857142856,2,5,14,0
1.0215000762473371e+18,13,35,2.6923076923076925,1,4,13,0
1.0215017281718481e+18,15,46,3.066666666666667,1,5,15,0
1.0215728781946213e+18,4,8,2.0,2,2,4,0
1.0216301101035395e+18,7,9,1.2857142857142858,1,2,7,0
1.0216409719530024e+18,3,24,8.0,7,9,1,2
1.0216709310799969e+18,3,7,2.3333333333333335,1,4,3,0
1.021676311558214e+18,2,4,2.0,1,3,2,0
1.0216784442259474e+18,2,5,2.5,2,3,2,0
1.0217232102432055e+18,44,222,5.045454545454546,3,7,44,0
1.0217385989104143e+18,15,43,2.8666666666666667,2,4,15,0
1.0217499904332543e+18,3,23,7.666666666666667,7,8,1,2
1.0218107492977322e+18,86,669,7.77906976744186,2,11,32,54
1.0218758633022991e+18,21,104,4.9523809523809526,2,6,21,0
1.0222232730774508e+18,2,5,2.5,1,4,2,0
1.0222898558723036e+18,1,8,8.0,8,8,0,1
1.0223502288151222e+18,1,2,2.0,2,2,1,0
1.0224047730904205e+18,5,12,2.4,1,4,5,0
1.0224251205873631e+18,14,68,4.857142857142857,3,7,14,0
1.0224607185130907e+18,79,159,2.0126582278481013,1,4,79,0
1.0224942241686918e+18,10,52,5.2,4,7,10,0
1.0225232712014243e+18,20,201,10.05,9,11,0,20
1.0225365282729663e+18,8,32,4.0,2,5,8,0
1.0225432948976666e+18,7,70,10.0,9,11,0,7
1.0225530450459091e+18,47,449,9.553191489361701,2,13,4,43
1.0228491204462504e+18,4,39,9.75,8,11,0,4
1.0230278923111617e+18,2,16,8.0,7,9,1,1
1.0230617813189802e+18,23,76,3.3043478260869565,2,5,23,0
1.0230913359836636e+18,2,14,7.0,7,7,2,0
1.0231321386699776e+18,67,454,6.776119402985074,2,9,50,17
1.0231802011717926e+18,9,60,6.666666666666667,5,9,8,1
1.0231870541359049e+18,11,78,7.090909090909091,6,9,9,2
1.0232217045146804e+18,57,390,6.842105263157895,2,10,44,13
1.0232343351906317e+18,48,241,5.020833333333333,2,7,48,0
1.0232775084616047e+18,67,474,7.074626865671642,5,9,46,21
1.0234987157865617e+18,4,27,6.75,6,7,4,0
1.0236093337650513e+18,5,33,6.6,6,7,5,0
1.0236487078511731e+18,7,52,7.428571428571429,5,9,2,5
1.0236606406687807e+18,18,39,2.1666666666666665,1,5,18,0
1.0236674647415725e+18,60,290,4.833333333333333,3,7,60,0
1.0236702217290557e+18,12,90,7.5,6,9,7,5
1.0236715793668732e+18,6,11,1.8333333333333333,1,3,6,0
1.023671661134179e+18,9,64,7.111111111111111,5,9,5,4
1.0237035317125427e+18,138,943,6.833333333333333,3,10,103,35
1.023727549360889e+18,62,135,2.1774193548387095,1,4,62,0
1.0237286565039526e+18,12,83,6.916666666666667,6,9,10,2
1.0237348523596867e+18,17,134,7.882352941176471,6,10,6,11
1.0237413854513806e+18,14,49,3.5,2,5,14,0
1.0237443347544166e+18,1,2,2.0,2,2,1,0
1.0237461890555226e+18,13,86,6.615384615384615,2,9,8,5
1.0237623252120037e+18,9,12,1.3333333333333333,1,3,9,0
1.0237769669885953e+18,1,3,3.0,3,3,1,0
1.0237971502736252e+18,1,7,7.0,7,7,1,0
1.0238103307362156e+18,2,4,2.0,1,3,2,0
1.0238222227148122e+18,39,186,4.769230769230769,2,7,39,0
1.0238342090033938e+18,34,68,2.0,1,4,34,0
1.0238578023880828e+18,4,10,2.5,1,3,4,0
1.0238597445773044e+18,52,376,7.230769230769231,4,10,30,22
1.0238723368413807e+18,11,19,1.7272727272727273,1,3,11,0
1.0238854048806167e+18,25,119,4.76,2,7,25,0
1.0238916904210445e+18,3,11,3.6666666666666665,3,5,3,0
1.0238936109676595e+18,55,274,4.9818181818181815,3,7,55,0
1.0239020477278149e+18,5,25,5.0,4,6,5,0
1.0239175865434095e+18,3,15,5.0,4,6,3,0
1.023947269140491e+18,103,220,2.1359223300970873,1,5,103,0
1.0239677720913042e+18,14,45,3.2142857142857144,2,4,14,0
1.0240192335750409e+18,54,512,9.481481481481481,2,13,4,50
1.0240599891628671e+18,36,169,4.694444444444445,2,7,36,0
1.0244852410177078e+18,87,849,9.758620689655173,2,12,4,83
1.0244869482379466e+18,74,155,2.0945945945945947,1,4,74,0
1.0244884479998894e+18,46,92,2.0,1,5,46,0
1.0244982952833992e+18,5,36,7.2,6,9,4,1
1.024510231086822e+18,43,216,5.023255813953488,3,7,43,0
1.0245136551559635e+18,158,1107,7.006329113924051,2,10,99,59
1.0245265802189052e+18,8,59,7.375,6,8,4,4
1.024571965787456e+18,19,130,6.842105263157895,5,9,14,5
1.0245764678819084e+18,12,35,2.9166666666666665,2,5,12,0
1.0245785009885211e+18,51,435,8.529411764705882,2,11,5,46
1.0245928894826877e+18,43,93,2.1627906976744184,1,5,43,0
1.0246582974507238e+18,10,51,5.1,4,6,10,0
1.0246769256652522e+18,12,17,1.4166666666666667,1,2,12,0
1.0246940650599034e+18,5,38,7.6,3,9,1,4
1.0246949046687433e+18,87,769,8.839080459770114,3,12,13,74
1.0246971672668197e+18,11,76,6.909090909090909,2,9,7,4
1.0247054868836548e+18,4,10,2.5,1,3,4,0
1.0247061815437234e+18,1,3,3.0,3,3,1,0
1.0247184595431066e+18,30,169,5.633333333333334,2,8,28,2
1.0247223187725137e+18,47,182,3.872340425531915,2,6,47,0
1.0247435412988993e+18,12,58,4.833333333333333,3,6,12,0
1.0247652889892461e+18,9,58,6.444444444444445,3,8,8,1
1.0247654993155315e+18,1,3,3.0,3,3,1,0
1.0250885129268799e+18,63,605,9.603174603174603,3,12,4,59
1.0250893227427236e+18,15,133,8.866666666666667,2,11,2,13
1.0251208415896772e+18,7,46,6.571428571428571,2,9,4,3
1.025148107758866e+18,36,75,2.0833333333333335,1,4,36,0
1.0251543420770378e+18,1,1,1.0,1,1,1,0
1.0251575823066038e+18,34,172,5.0588235294117645,2,8,32,2
1.0251648537744353e+18,37,145,3.918918918918919,1,6,37,0
1.025188292091293e+18,8,61,7.625,6,9,3,5
1.0251911850392401e+18,18,36,2.0,1,3,18,0
1.025226922035763e+18,16,37,2.3125,1,4,16,0
1.0252516736570811e+18,65,491,7.553846153846154,2,10,25,40
1.0252619740741306e+18,10,73,7.3,2,10,5,5
1.025309640777055e+18,2,14,7.0,6,8,1,1
1.0253238633089198e+18,8,46,5.75,5,6,8,0
1.0253286594411621e+18,4,38,9.5,9,11,0,4
1.0253948314905865e+18,22,75,3.409090909090909,1,6,22,0
1.0253978519138861e+18,1,1,1.0,1,1,1,0
1.0254543742697389e+18,52,446,8.576923076923077,2,12,6,46
1.0254723181942597e+18,51,77,1.5098039215686274,1,4,51,0
1.0257279021299841e+18,1,3,3.0,3,3,1,0
1.0257832018091195e+18,7,23,3.2857142857142856,2,4,7,0
1.0258052722254606e+18,30,266,8.866666666666667,5,11,3,27
1.0258166130469501e+18,47,372,7.914893617021277,3,11,14,33
1.0258178966411284e+18,1,2,2.0,2,2,1,0
1.0258258479550285e+18,8,37,4.625,3,6,8,0
1.0258431776451325e+18,9,48,5.333333333333333,4,7,9,0
1.0258435553068918e+18,30,282,9.4,3,11,3,27
1.0258435596538675e+18,19,72,3.789473684210526,2,5,19,0
1.0258458425844593e+18,10,18,1.8,1,4,10,0
1.0258504112078595e+18,1,2,2.0,2,2,1,0
1.0258563314580604e+18,20,99,4.95,3,7,20,0
1.0258617689967994e+18,2,11,5.5,4,7,2,0
1.0258706603318447e+18,36,177,4.916666666666667,3,7,36,0
1.0258796706344114e+18,7,63,9.0,5,11,1,6
1.0258798034821901e+18,17,115,6.764705882352941,5,8,12,5
1.0259072355972293e+18,13,103,7.923076923076923,6,9,4,9
1.0259154334652882e+18,61,181,2.9672131147540983,1,4,61,0
1.0259311728602657e+18,5,22,4.4,4,5,5,0
1.0259577741594394e+18,4,42,10.5,10,11,0,4
1.0259624180626136e+18,3,10,3.3333333333333335,3,4,3,0
1.0259709266573722e+18,42,126,3.0,1,5,42,0
1.025983516732825e+18,15,107,7.133333333333334,2,9,8,7
1.0259944349301928e+18,45,130,2.888888888888889,1,5,45,0
1.0260044135402345e+18,56,179,3.1964285714285716,1,6,56,0
1.0260112219706367e+18,23,56,2.4347826086956523,1,4,23,0
1.0260153758652554e+18,13,131,10.076923076923077,8,12,0,13
1.0260358027993073e+18,45,96,2.1333333333333333,1,4,45,0
1.0260445815557074e+18,3,11,3.6666666666666665,3,5,3,0
1.0260724126260708e+18,1,2,2.0,2,2,1,0
1.0260860470909742e+18,1,3,3.0,3,3,1,0
1.0261193893904259e+18,23,51,2.217391304347826,1,4,23,0
1.0261225617001175e+18,16,136,8.5,4,11,2,14
1.0261527372913331e+18,7,54,7.714285714285714,6,8,1,6
1.0261595819266084e+18,3,6,2.0,2,2,3,0
1.0261752562279868e+18,10,27,2.7,2,4,10,0
1.0264726972981641e+18,9,18,2.0,1,3,9,0
1.026533497593473e+18,31,67,2.161290322580645,1,4,31,0
1.0265598659661687e+18,34,58,1.7058823529411764,1,3,34,0
1.0265862356658651e+18,1,2,2.0,2,2,1,0
1.0265898908512137e+18,48,235,4.895833333333333,2,6,48,0
1.026625106855032e+18,1,10,10.0,10,10,0,1
1.026628258639339e+18,1,3,3.0,3,3,1,0
1.0266564745165038e+18,44,119,2.7045454545454546,1,5,44,0
1.0266721372959418e+18,51,99,1.9411764705882353,1,5,51,0
1.0266801191381153e+18,67,460,6.865671641791045,2,9,45,22
1.026691073600174e+18,17,107,6.294117647058823,2,9,14,3
1.0267161116504782e+18,22,46,2.090909090909091,1,3,22,0
1.0267419391808342e+18,27,55,2.037037037037037,1,3,27,0
1.0268648949179795e+18,54,162,3.0,1,5,54,0
1.0269918655957312e+18,59,505,8.559322033898304,2,12,8,51
1.02729642247247e+18,3,8,2.6666666666666665,2,4,3,0
1.027314028123455e+18,8,16,2.0,1,4,8,0
1.0274375505098386e+18,91,799,8.780219780219781,2,12,11,80
1.0275019139241375e+18,46,462,10.043478260869565,6,13,1,45
1.0276268429627724e+18,3,5,1.6666666666666667,1,2,3,0
1.027787985314046e+18,8,46,5.75,5,7,8,0
1.0280001799671322e+18,36,177,4.916666666666667,3,6,36,0
1.0280094056834857e+18,1,8,8.0,8,8,0,1
1.0280207815240197e+18,102,140,1.3725490196078431,1,4,102,0
1.0281278059485528e+18,5,14,2.8,2,4,5,0
1.0282411309504896e+18,114,1120,9.824561403508772,2,13,4,110
1.0282713608287535e+18,7,16,2.2857142857142856,1,4,7,0
1.0282730494337161e+18,5,38,7.6,7,9,3,2
1.0282862598676365e+18,37,346,9.35135135135135,3,12,4,33
1.0283137655930106e+18,44,104,2.3636363636363638,1,5,44,0
1.0287415493700852e+18,20,34,1.7,1,4,20,0
1.0287606050630797e+18,9,10,1.1111111111111112,1,2,9,0
1.0288066364969631e+18,1,4,4.0,4,4,1,0
1.0288186202952984e+18,7,34,4.857142857142857,4,6,7,0
1.0288227090009094e+18,37,264,7.135135135135135,4,11,20,17
1.0288318818132691e+18,42,286,6.809523809523809,2,9,31,11
1.028841889315845e+18,39,75,1.9230769230769231,1,4,39,0
1.0288419620380827e+18,4,36,9.0,7,10,1,3
1.028849871451707e+18,7,53,7.571428571428571,6,9,4,3
1.0288626997750856e+18,3,13,4.333333333333333,3,6,3,0
1.0288902203634408e+18,5,47,9.4,9,10,0,5
1.0289086650060794e+18,4,18,4.5,4,5,4,0
1.0289149212190309e+18,6,24,4.0,3,5,6,0
1.0289155672187459e+18,15,154,10.266666666666667,7,12,1,14
1.0289161282801443e+18,55,277,5.036363636363636,3,7,55,0
1.028925609037202e+18,2,20,10.0,10,10,0,2
1.0289474977916296e+18,8,32,4.0,3,5,8,0
1.0289561176719768e+18,2,5,2.5,2,3,2,0
1.0289812179849663e+18,63,192,3.0476190476190474,1,5,63,0
1.0290007615126926e+18,32,70,2.1875,1,4,32,0
1.0290638789654275e+18,1,5,5.0,5,5,1,0
1.0290770870301921e+18,23,87,3.782608695652174,2,7,23,0
1.0290837759928852e+18,1,4,4.0,4,4,1,0
1.0291474426077921e+18,9,26,2.888888888888889,1,4,9,0
1.0292571837455688e+18,19,25,1.3157894736842106,1,3,19,0
1.0294307210208943e+18,11,21,1.9090909090909092,1,4,11,0
1.0294412825480174e+18,1,3,3.0,3,3,1,0
1.029451526364099e+18,38,181,4.7631578947368425,3,7,38,0
1.0294640969170935e+18,79,151,1.9113924050632911,1,4,79,0
1.0294721825800296e+18,42,164,3.9047619047619047,1,6,42,0
1.0294905281694071e+18,48,293,6.104166666666667,3,8,42,6
1.0295011022227364e+18,34,322,9.470588235294118,4,12,5,29
1.0295069867551694e+18,36,74,2.0555555555555554,1,4,36,0
1.0295236681128086e+18,109,527,4.834862385321101,2,7,109,0
1.0295418647458673e+18,46,230,5.0,2,7,46,0
1.0295681280195533e+18,1,9,9.0,9,9,0,1
1.0296650953323828e+18,1,2,2.0,2,2,1,0
1.0297006420859288e+18,6,27,4.5,3,6,6,0
1.0297163066313868e+18,118,237,2.0084745762711864,1,4,118,0
1.0297242208632481e+18,52,453,8.711538461538462,5,12,8,44
1.02972537087558e+18,11,101,9.181818181818182,6,12,2,9
1.0297483692360358e+18,8,55,6.875,6,8,6,2
1.0298321193051895e+18,1,2,2.0,2,2,1,0
1.0299128151563539e+18,2,8,4.0,3,5,2,0
1.030208139722476e+18,41,358,8.731707317073171,2,10,2,39
1.0302209052291164e+18,74,510,6.891891891891892,3,10,52,22
1.0302279163143697e+18,8,14,1.75,1,3,8,0
1.0302297661685193e+18,118,675,5.720338983050848,2,8,117,1
1.0302573270042031e+18,24,92,3.8333333333333335,2,6,24,0
1.0302781720386602e+18,16,48,3.0,1,5,16,0
1.0302806092979512e+18,2,15,7.5,7,8,1,1
1.0302814846878363e+18,25,74,2.96,1,4,25,0
1.0303331621819939e+18,8,40,5.0,4,7,8,0
1.0303509608911021e+18,93,626,6.731182795698925,2,9,66,27
1.0303664929750733e+18,2,14,7.0,6,8,1,1
1.0303739560847299e+18,21,60,2.857142857142857,1,6,21,0
1.030374222716702e+18,5,7,1.4,1,2,5,0
1.0303802768113612e+18,9,61,6.777777777777778,5,9,7,2
1.0303913053926813e+18,18,124,6.888888888888889,3,9,12,6
1.0304155215265027e+18,43,208,4.837209302325581,2,8,42,1
1.0304157293476484e+18,16,47,2.9375,1,5,16,0
1.0304312797997594e+18,11,71,6.454545454545454,2,9,7,4
1.0304449169118221e+18,21,192,9.142857142857142,3,11,1,20
1.0304595214547091e+18,50,462,9.24,2,12,5,45
1.0304752443098831e+18,47,235,5.0,3,8,46,1
1.0304916961230708e+18,22,211,9.590909090909092,3,12,2,20
1.0304956335999244e+18,49,103,2.1020408163265305,1,5,49,0
1.0305294593143693e+18,22,103,4.681818181818182,2,7,22,0
1.0308823308504635e+18,82,114,1.3902439024390243,1,3,82,0
1.0308942329712183e+18,7,46,6.571428571428571,5,8,6,1
1.0309040463288397e+18,25,187,7.48,6,10,15,10
1.0309055180129381e+18,2,16,8.0,7,9,1,1
1.0309084011012118e+18,74,508,6.864864864864865,3,9,52,22
1.0309255560947816e+18,6,60,10.0,9,11,0,6
1.030984482291447e+18,36,181,5.027777777777778,2,8,35,1
1.0309932426920282e+18,7,46,6.571428571428571,5,8,5,2
1.0309941428403912e+18,16,80,5.0,3,7,16,0
1.030997095182796e+18,84,800,9.523809523809524,3,13,7,77
1.0310041694587526e+18,1,5,5.0,5,5,1,0
1.03100840083297e+18,89,602,6.764044943820225,2,9,62,27
1.0310463689662166e+18,3,20,6.666666666666667,6,8,2,1
1.0310549882234377e+18,2,9,4.5,4,5,2,0
1.0310586650152453e+18,3,6,2.0,1,3,3,0
1.0310656423695587e+18,19,32,1.6842105263157894,1,3,19,0
1.031107307292359e+18,12,59,4.916666666666667,2,7,12,0
1.0311453208559395e+18,9,83,9.222222222222221,4,11,2,7
1.031149902982919e+18,28,132,4.714285714285714,2,7,28,0
1.0311917176534758e+18,17,132,7.764705882352941,6,9,7,10
1.0312238799922849e+18,1,2,2.0,2,2,1,0
1.0312312291175725e+18,35,74,2.1142857142857143,1,4,35,0
1.0312494403371756e+18,96,923,9.614583333333334,2,13,5,91
1.0313015743802134e+18,18,142,7.888888888888889,4,10,6,12
1.0313610156241889e+18,42,175,4.166666666666667,1,6,42,0
1.0313835036326721e+18,6,50,8.333333333333334,7,10,2,4
1.0315630255842409e+18,13,52,4.0,3,6,13,0
1.0315845917510968e+18,12,120,10.0,8,11,0,12
1.031591618640743e+18,6,53,8.833333333333334,8,10,0,6
1.0316113774455928e+18,20,172,8.6,6,12,6,14
1.031634987640105e+18,3,10,3.3333333333333335,3,4,3,0
1.0316961639576543e+18,4,28,7.0,6,8,2,2
1.0316992886813638e+18,4,7,1.75,1,3,4,0
1.0316997593556972e+18,3,27,9.0,9,9,0,3
1.031700363135418e+18,87,593,6.816091954022989,4,9,69,18
1.0317041878911666e+18,14,124,8.857142857142858,3,12,3,11
1.031704743354571e+18,2,19,9.5,8,11,0,2
1.03170625001016e+18,51,355,6.96078431372549,3,10,33,18
1.0317107088791976e+18,1,2,2.0,2,2,1,0
1.0317129851288285e+18,2,19,9.5,9,10,0,2
1.0317164455306705e+18,11,109,9.909090909090908,8,12,0,11
1.0317237817372068e+18,4,41,10.25,9,12,0,4
1.0317263748230391e+18,3,15,5.0,3,6,3,0
1.031732552148612e+18,3,16,5.333333333333333,3,8,2,1
1.0317676787734583e+18,37,49,1.3243243243243243,1,3,37,0
1.0317833212777354e+18,39,154,3.948717948717949,2,6,39,0
1.0318307369382982e+18,4,11,2.75,1,4,4,0
1.031847351630942e+18,3,28,9.333333333333334,9,10,0,3
1.031853252172419e+18,8,75,9.375,8,12,0,8
1.0319533640509327e+18,156,1042,6.67948717948718,2,9,124,32
1.0319833875697687e+18,6,13,2.1666666666666665,1,3,6,0
1.0320407502098307e+18,26,60,2.3076923076923075,1,4,26,0
1.0323286540759845e+18,52,247,4.75,2,8,51,1
1.0323662264349935e+18,3,23,7.666666666666667,7,8,1,2
1.0323666281629082e+18,12,53,4.416666666666667,3,6,12,0
1.0323709024067398e+18,43,340,7.906976744186046,3,11,15,28
1.0324560538929267e+18,15,77,5.133333333333334,3,7,15,0
1.032550391734677e+18,1,3,3.0,3,3,1,0
1.0325509086408151e+18,3,6,2.0,1,3,3,0
1.0326571886896262e+18,40,193,4.825,2,7,40,0
1.0326912109308102e+18,13,28,2.1538461538461537,1,5,13,0
1.0326941288358092e+18,43,87,2.0232558139534884,1,4,43,0
1.0329367427485569e+18,4,13,3.25,3,4,4,0
1.0330574162800799e+18,6,57,9.5,7,12,1,5
1.0330685555953526e+18,7,25,3.5714285714285716,3,5,7,0
1.0331281454537276e+18,13,81,6.230769230769231,2,9,11,2
1.033154317676857e+18,51,110,2.156862745098039,1,5,51,0
1.0331790035216571e+18,3,31,10.333333333333334,10,11,0,3
1.0331923958982216e+18,3,22,7.333333333333333,3,10,1,2
1.0331983755246502e+18,1,9,9.0,9,9,0,1
1.0332061589028534e+18,2,19,9.5,9,10,0,2
1.0332284426793861e+18,35,248,7.085714285714285,3,9,23,12
1.0332383637993912e+18,30,147,4.9,3,8,29,1
1.0332643260929311e+18,88,769,8.738636363636363,2,11,10,78
1.0332742691693503e+18,9,14,1.5555555555555556,1,3,9,0
1.0332771851625599e+18,16,76,4.75,2,7,16,0
1.033324542362929e+18,9,83,9.222222222222221,7,12,2,7
1.033345314015664e+18,10,49,4.9,3,6,10,0
1.0333566433054152e+18,1,12,12.0,12,12,0,1
1.0333575757118175e+18,6,59,9.833333333333334,8,11,0,6
1.0334468668333085e+18,23,186,8.08695652173913,6,10,7,16
1.0334785072301645e+18,1,3,3.0,3,3,1,0
1.0337284611776211e+18,2,16,8.0,8,8,0,2
1.0337808792891876e+18,18,59,3.2777777777777777,2,5,18,0
1.0338240359612133e+18,26,131,5.038461538461538,2,7,26,0
1.0338309257906979e+18,4,28,7.0,6,8,3,1
1.0338904187285688e+18,46,135,2.9347826086956523,1,5,46,0
1.0339046107129763e+18,46,348,7.565217391304348,2,9,18,28
1.0339239991163597e+18,21,46,2.1904761904761907,1,4,21,0
1.0339250558946382e+18,1,2,2.0,2,2,1,0
1.0339821074225317e+18,27,49,1.8148148148148149,1,4,27,0
1.0339888139049125e+18,66,662,10.030303030303031,5,13,2,64
1.0340033360616389e+18,30,86,2.8666666666666667,1,5,30,0
1.0340813451714836e+18,20,42,2.1,1,4,20,0
1.034175757220863e+18,8,17,2.125,1,3,8,0
1.034192026157249e+18,68,150,2.2058823529411766,1,5,68,0
1.0341986495165556e+18,8,61,7.625,6,9,4,4
1.0342035397133691e+18,8,41,5.125,4,6,8,0
1.0344669504638167e+18,2,7,3.5,3,4,2,0
1.0344699662113821e+18,6,64,10.666666666666666,10,11,0,6
1.0344719871899182e+18,4,35,8.75,8,9,0,4
1.0344943693794182e+18,3,7,2.3333333333333335,1,3,3,0
1.034532621451112e+18,11,70,6.363636363636363,5,8,9,2
1.0345473072348497e+18,41,86,2.097560975609756,1,4,41,0
1.0345851004655802e+18,1,4,4.0,4,4,1,0
1.0345857140314068e+18,22,143,6.5,3,8,18,4
1.0345885133319731e+18,4,24,6.0,5,7,4,0
1.0345938846970889e+18,1,7,7.0,7,7,1,0
1.0345953044227404e+18,93,917,9.86021505376344,4,13,6,87
1.0346641687330541e+18,8,61,7.625,6,10,4,4
1.0346695169159373e+18,3,30,10.0,9,11,0,3
1.0346724482289206e+18,9,51,5.666666666666667,4,8,8,1
1.0346785439682056e+18,73,490,6.712328767123288,4,9,60,13
1.0346850225887151e+18,34,75,2.2058823529411766,1,4,34,0
1.034691707805811e+18,13,24,1.8461538461538463,1,3,13,0
1.0346925681689716e+18,31,148,4.774193548387097,3,7,31,0
1.0347286096486418e+18,5,41,8.2,7,9,1,4
1.0347395574749324e+18,1,1,1.0,1,1,1,0
1.0347613830004814e+18,13,49,3.769230769230769,1,6,13,0
1.0347641338616e+18,10,53,5.3,4,6,10,0
1.0347893794092604e+18,6,51,8.5,3,10,1,5
1.0348771631638605e+18,6,49,8.166666666666666,4,10,1,5
1.0348880991333741e+18,10,72,7.2,6,9,7,3
1.0351859405254177e+18,22,111,5.045454545454546,4,6,22,0
1.0352082993739552e+18,2,13,6.5,6,7,2,0
1.0352314699195416e+18,17,39,2.2941176470588234,1,5,17,0
1.0352539077940157e+18,1,4,4.0,4,4,1,0
1.035255592477939e+18,9,55,6.111111111111111,4,8,8,1
1.0352641196070266e+18,47,217,4.617021276595745,2,7,47,0
1.0352873849908353e+18,3,6,2.0,1,3,3,0
1.0353113153487999e+18,1,1,1.0,1,1,1,0
1.0353169481498309e+18,14,121,8.642857142857142,6,12,3,11
1.0353485456477971e+18,72,372,5.166666666666667,2,7,72,0
1.0353533052217612e+18,88,186,2.1136363636363638,1,4,88,0
1.0353698574079197e+18,7,70,10.0,9,12,0,7
1.0353878786003462e+18,5,33,6.6,5,8,3,2
1.035402718763324e+18,43,210,4.883720930232558,2,7,43,0
1.0354055478828063e+18,42,413,9.833333333333334,3,12,1,41
1.0354063578958499e+18,8,34,4.25,4,6,8,0
1.0354216216010988e+18,22,83,3.772727272727273,2,6,22,0
1.0354468069118351e+18,4,30,7.5,7,8,2,2
1.035447620471291e+18,4,11,2.75,2,4,4,0
1.0354510086860385e+18,53,208,3.9245283018867925,1,6,53,0
1.0355398316073393e+18,35,104,2.9714285714285715,1,5,35,0
1.0356159109171109e+18,15,54,3.6,2,5,15,0
1.0356447514780492e+18,21,180,8.571428571428571,4,11,4,17
1.0356782700411026e+18,26,121,4.653846153846154,3,8,25,1
1.0356957119066403e+18,65,374,5.753846153846154,3,8,63,2
1.0357113472674029e+18,16,59,3.6875,2,6,16,0
1.0357220560244713e+18,15,76,5.066666666666666,3,6,15,0
1.0357223110012218e+18,18,142,7.888888888888889,6,10,7,11
1.0359250478966216e+18,11,82,7.454545454545454,2,9,3,8
1.0359332490179849e+18,55,555,10.090909090909092,7,13,2,53
1.0359874184122815e+18,6,58,9.666666666666666,4,13,1,5
1.0360174614521798e+18,29,232,8.0,6,10,11,18
1.036037709851106e+18,44,88,2.0,1,5,44,0
1.0360465918258588e+18,31,222,7.161290322580645,5,10,21,10
1.0360513988883978e+18,2,10,5.0,4,6,2,0
1.0360518975168252e+18,43,291,6.767441860465116,2,9,33,10
1.0360571920725751e+18,17,36,2.1176470588235294,1,3,17,0
1.0360578247108614e+18,15,125,8.333333333333334,3,10,3,12
1.0360602049948782e+18,19,94,4.947368421052632,3,7,19,0
1.0360828720843923e+18,6,32,5.333333333333333,4,7,6,0
1.0360829019308294e+18,6,32,5.333333333333333,4,7,6,0
1.036116624361482e+18,25,162,6.48,3,9,20,5
1.036138260935095e+18,5,14,2.8,2,4,5,0
1.0361520025695548e+18,35,82,2.342857142857143,1,6,35,0
1.0361748844906505e+18,4,37,9.25,9,10,0,4
1.0361848041051342e+18,7,17,2.4285714285714284,1,3,7,0
1.0362196081306936e+18,19,163,8.578947368421053,4,10,1,18
1.036230146418777e+18,1,8,8.0,8,8,0,1
1.0362555719688731e+18,101,600,5.9405940594059405,2,9,95,6
1.0362575706176904e+18,5,25,5.0,4,7,5,0
1.0362633916104191e+18,63,625,9.920634920634921,2,13,2,61
1.0362791239160544e+18,2,5,2.5,2,3,2,0
1.0363028531665677e+18,10,51,5.1,4,6,10,0
1.0363354841009452e+18,10,43,4.3,3,6,10,0
1.0363684537765126e+18,34,318,9.352941176470589,3,11,4,30
1.0364082013849235e+18,10,23,2.3,1,3,10,0
1.0364241175149619e+18,2,4,2.0,2,2,2,0
1.0366578955633057e+18,2,17,8.5,8,9,0,2
1.0366620042014139e+18,14,29,2.0714285714285716,1,4,14,0
1.0367261645530202e+18,5,21,4.2,4,5,5,0
1.0367341344817362e+18,14,56,4.0,3,5,14,0
1.0367361854600429e+18,15,102,6.8,5,8,11,4
1.0367449219660544e+18,27,234,8.666666666666666,7,10,1,26
1.0367615559514854e+18,25,45,1.8,1,3,25,0
1.0367636972651241e+18,2,17,8.5,8,9,0,2
1.0367931629295685e+18,38,69,1.8157894736842106,1,3,38,0
1.0367932547944658e+18,10,79,7.9,6,9,3,7
1.0367940429344735e+18,4,31,7.75,2,10,1,3
1.0368255182080088e+18,12,66,5.5,4,7,12,0
1.0368275743810378e+18,4,27,6.75,4,9,2,2
1.0368358994559828e+18,5,15,3.0,1,4,5,0
1.0368641298426223e+18,1,3,3.0,3,3,1,0
1.0368642327435363e+18,5,35,7.0,4,9,3,2
1.036864297877171e+18,2,7,3.5,2,5,2,0
1.036946231135314e+18,90,864,9.6,4,12,8,82
1.0369470386038757e+18,11,78,7.090909090909091,2,9,4,7
1.0369607377674409e+18,71,678,9.549295774647888,2,13,5,66
1.0369683623372023e+18,3,11,3.6666666666666665,3,4,3,0
1.0369812029640983e+18,50,94,1.88,1,4,50,0
1.0373644253742106e+18,28,268,9.571428571428571,7,12,1,27
1.037366478600308e+18,22,106,4.818181818181818,3,7,22,0
1.0373883514419395e+18,6,12,2.0,1,3,6,0
1.0374783296621766e+18,23,32,1.391304347826087,1,3,23,0
1.0374900084409336e+18,1,1,1.0,1,1,1,0
1.0374971511424628e+18,2,5,2.5,1,4,2,0
1.0375034058140317e+18,28,66,2.357142857142857,1,5,28,0
1.0376537490064486e+18,91,175,1.9230769230769231,1,5,91,0
1.0378351005921567e+18,78,699,8.961538461538462,3,11,8,70
1.0380615101143322e+18,2,12,6.0,5,7,2,0
1.0381754856145111e+18,1,6,6.0,6,6,1,0
1.0382850625108063e+18,22,181,8.227272727272727,6,11,6,16
1.0382924590394867e+18,8,15,1.875,1,3,8,0
1.0382928635044696e+18,29,198,6.827586206896552,4,9,23,6
1.0383176416089617e+18,15,125,8.333333333333334,3,11,2,13
1.0383377791939191e+18,17,116,6.823529411764706,4,8,12,5
1.038367038958376e+18,38,196,5.157894736842105,3,7,38,0
1.0384476330632333e+18,43,405,9.418604651162791,3,12,5,38
1.0384515814125391e+18,1,4,4.0,4,4,1,0
1.038466872934858e+18,8,80,10.0,9,11,0,8
1.0385501501931031e+18,10,39,3.9,2,5,10,0
1.0385609051572248e+18,2,13,6.5,6,7,2,0
1.038661389519679e+18,11,41,3.727272727272727,2,5,11,0
1.0388210899884335e+18,62,618,9.96774193548387,3,12,2,60
1.0388497292792271e+18,19,92,4.842105263157895,3,6,19,0
1.0388538044341217e+18,9,73,8.11111111111111,4,10,2,7
1.0388585282202437e+18,12,26,2.1666666666666665,1,4,12,0
1.0389001234763117e+18,3,6,2.0,1,3,3,0
1.0389060036893522e+18,9,54,6.0,5,7,9,0
1.0389138745641279e+18,1,7,7.0,7,7,1,0
1.0389158576145572e+18,16,115,7.1875,5,9,10,6
1.0389257870327058e+18,84,189,2.25,1,5,84,0
1.0389413655789624e+18,42,169,4.023809523809524,2,6,42,0
1.0389632923662417e+18,15,75,5.0,3,7,15,0
1.03896419034634e+18,2,5,2.5,2,3,2,0
1.0389687295483419e+18,56,537,9.589285714285714,3,13,3,53
1.0389736370160301e+18,27,195,7.222222222222222,6,9,19,8
1.0389887505229588e+18,1,1,1.0,1,1,1,0
1.0389916730274665e+18,4,9,2.25,1,3,4,0
1.0389974909219128e+18,1,3,3.0,3,3,1,0
1.0390025221836014e+18,1,1,1.0,1,1,1,0
1.0390356201764954e+18,4,8,2.0,1,3,4,0
1.0390400365736347e+18,1,3,3.0,3,3,1,0
1.0390485816323726e+18,59,300,5.084745762711864,3,7,59,0
1.0390558361474994e+18,10,49,4.9,2,6,10,0
1.0390590022079084e+18,64,458,7.15625,3,10,40,24
1.0390613113594822e+18,17,32,1.8823529411764706,1,3,17,0
1.0390626224936081e+18,41,150,3.658536585365854,2,5,41,0
1.0390660080245139e+18,44,212,4.818181818181818,3,6,44,0
1.0390786789962386e+18,4,25,6.25,6,7,4,0
1.039103666621686e+18,23,160,6.956521739130435,4,10,14,9
1.0391073471812859e+18,4,22,5.5,5,6,4,0
1.0392001259645418e+18,130,900,6.923076923076923,4,10,89,41
1.0392037059001016e+18,6,59,9.833333333333334,9,10,0,6
1.0392064171818941e+18,23,52,2.260869565217391,1,5,23,0
1.0392385410980262e+18,1,2,2.0,2,2,1,0
1.0392588564756902e+18,102,513,5.029411764705882,2,8,100,2
1.0392964100193339e+18,1,6,6.0,6,6,1,0
1.0393339028412508e+18,15,127,8.466666666666667,7,10,4,11
1.0395889578942168e+18,14,53,3.7857142857142856,2,5,14,0
1.0396023743171731e+18,4,29,7.25,7,8,3,1
1.0396150013942468e+18,21,54,2.5714285714285716,1,4,21,0
1.0396229703054228e+18,51,345,6.764705882352941,2,9,35,16
1.0396416106452271e+18,2,6,3.0,2,4,2,0
1.0396421790214597e+18,1,2,2.0,2,2,1,0
1.0396506172562936e+18,3,22,7.333333333333333,7,8,2,1
1.0396604016029396e+18,46,468,10.173913043478262,9,12,0,46
1.0396703878602022e+18,34,80,2.3529411764705883,1,4,34,0
1.0396813258695406e+18,29,90,3.103448275862069,1,6,29,0
1.0397631766148765e+18,8,14,1.75,1,3,8,0
1.0397810759816584e+18,28,113,4.035714285714286,2,7,28,0
1.0397866882197562e+18,52,209,4.019230769230769,2,6,52,0
1.0397949267551745e+18,17,133,7.823529411764706,2,11,4,13
1.0398089741822445e+18,1,1,1.0,1,1,1,0
1.0398205872646344e+18,2,9,4.5,4,5,2,0
1.0398212467621452e+18,19,158,8.31578947368421,7,10,5,14
1.0398430420526551e+18,2,6,3.0,3,3,2,0
1.0398435163044447e+18,4,4,1.0,1,1,4,0
1.0398654474951757e+18,2,16,8.0,8,8,0,2
1.0399214107876264e+18,65,555,8.538461538461538,2,10,8,57
1.039934174362822e+18,77,154,2.0,1,4,77,0
1.0399650214984138e+18,27,164,6.074074074074074,4,7,27,0
1.0402989450434835e+18,11,104,9.454545454545455,9,11,0,11
1.0403834214899585e+18,48,417,8.6875,2,11,7,41
1.0403962859280806e+18,5,25,5.0,3,7,5,0
1.0404056648861618e+18,69,148,2.1449275362318843,1,4,69,0
1.0404180017045783e+18,51,144,2.823529411764706,1,4,51,0
1.0404729847201756e+18,1,2,2.0,2,2,1,0
1.0405043075571878e+18,4,23,5.75,4,8,3,1
1.0405043141471604e+18,2,8,4.0,2,6,2,0
1.0405073239484279e+18,33,294,8.909090909090908,7,10,1,32
1.040533934951314e+18,17,28,1.6470588235294117,1,3,17,0
1.0406230190121271e+18,21,192,9.142857142857142,2,11,3,18
1.0406453688104714e+18,24,114,4.75,2,7,24,0
1.0406457335149624e+18,27,130,4.814814814814815,2,7,27,0
1.0407471693928648e+18,44,82,1.8636363636363635,1,4,44,0
1.0407971804582336e+18,1,2,2.0,2,2,1,0
1.0410472123461403e+18,28,59,2.107142857142857,1,4,28,0
1.0410956464941243e+18,11,24,2.1818181818181817,1,3,11,0
1.0411005053945581e+18,1,6,6.0,6,6,1,0
1.0411314202846968e+18,4,8,2.0,1,3,4,0
1.0411377352308668e+18,16,79,4.9375,3,7,16,0
1.0411403056063059e+18,8,54,6.75,6,8,7,1
1.0411499439079261e+18,75,665,8.866666666666667,2,12,8,67
1.0411605295945439e+18,12,23,1.9166666666666667,1,5,12,0
1.041163614721077e+18,1,9,9.0,9,9,0,1
1.0411687773675849e+18,10,48,4.8,3,7,10,0
1.0411877389430248e+18,10,48,4.8,3,7,10,0
1.0412174989690595e+18,4,16,4.0,3,5,4,0
1.0412565479427629e+18,4,9,2.25,2,3,4,0
1.0412688915405363e+18,8,17,2.125,1,3,8,0
1.0412909323446177e+18,183,1601,8.748633879781421,2,12,26,157
1.041295996638246e+18,11,61,5.545454545454546,4,7,11,0
1.041302190669732e+18,97,638,6.577319587628866,2,9,73,24
1.0413133577646781e+18,10,24,2.4,1,4,10,0
1.0413192423814177e+18,82,646,7.878048780487805,5,10,27,55
1.0413274879050289e+18,47,455,9.680851063829786,8,12,0,47
1.0413310340322404e+18,37,325,8.783783783783784,3,11,3,34
1.0413634746320027e+18,1,3,3.0,3,3,1,0
1.0413814196980264e+18,57,485,8.508771929824562,2,11,6,51
1.0413818497266385e+18,24,36,1.5,1,3,24,0
1.0417218393203355e+18,21,203,9.666666666666666,3,13,2,19
1.0417494920105403e+18,1,4,4.0,4,4,1,0
1.0418420369203037e+18,2,2,1.0,1,1,2,0
1.041842218258158e+18,2,12,6.0,5,7,2,0
1.041842386349222e+18,1,8,8.0,8,8,0,1
1.041842569863355e+18,3,7,2.3333333333333335,1,4,3,0
1.0418429625535858e+18,3,18,6.0,6,6,3,0
1.0418434595174052e+18,3,20,6.666666666666667,5,8,2,1
1.0418527610939762e+18,2,3,1.5,1,2,2,0
1.041860002069102e+18,2,14,7.0,7,7,2,0
1.0418601696831405e+18,5,30,6.0,4,7,5,0
1.041860316898826e+18,2,12,6.0,6,6,2,0
1.0418631069919907e+18,17,42,2.4705882352941178,1,4,17,0
1.041863288021821e+18,2,16,8.0,8,8,0,2
1.0418634590152017e+18,1,4,4.0,4,4,1,0
1.0418636440168909e+18,1,5,5.0,5,5,1,0
1.0418813257864948e+18,34,226,6.647058823529412,3,9,26,8
1.0418858706393181e+18,18,90,5.0,3,7,18,0
1.0419270615463972e+18,33,69,2.090909090909091,1,4,33,0
1.0419341651391653e+18,5,40,8.0,7,9,1,4
1.041934560320292e+18,6,41,6.833333333333333,5,8,3,3
1.0419547429018034e+18,2,8,4.0,3,5,2,0
1.041960740963536e+18,6,35,5.833333333333333,5,7,6,0
1.0419811605702573e+18,55,271,4.927272727272728,3,7,55,0
1.0419815599374209e+18,31,45,1.4516129032258065,1,3,31,0
1.0419861660549105e+18,48,372,7.75,3,9,18,30
1.042000846383303e+18,6,15,2.5,2,3,6,0
1.0420118321647871e+18,13,92,7.076923076923077,5,9,8,5
1.0420148145434932e+18,3,9,3.0,3,3,3,0
1.042151577304256e+18,3,3,1.0,1,1,3,0
1.0421785950336353e+18,43,301,7.0,5,9,29,14
1.0424512014863259e+18,32,299,9.34375,3,12,3,29
1.0425459404355305e+18,13,96,7.384615384615385,6,9,8,5
1.0425760342595085e+18,19,175,9.210526315789474,2,12,3,16
1.0425944178320268e+18,4,21,5.25,4,6,4,0
1.0426499682897418e+18,3,16,5.333333333333333,2,8,2,1
1.0427347607926607e+18,101,872,8.633663366336634,2,11,16,85
1.0427678030906765e+18,12,46,3.8333333333333335,2,6,12,0
1.0427881246437108e+18,100,591,5.91,3,8,94,6
1.0428304978538555e+18,61,589,9.655737704918034,5,12,5,56
1.0428365023398879e+18,5,14,2.8,1,4,5,0
1.0429443241455564e+18,48,68,1.4166666666666667,1,3,48,0
1.0431118626222085e+18,33,50,1.5151515151515151,1,3,33,0
1.0432209848471112e+18,2,17,8.5,8,9,0,2
1.0432512209453172e+18,1,9,9.0,9,9,0,1
1.043251751741151e+18,5,8,1.6,1,2,5,0
1.043304802730313e+18,96,768,8.0,2,10,22,74
1.0433061610616965e+18,6,6,1.0,1,1,6,0
1.0433135797233764e+18,88,769,8.738636363636363,3,12,8,80
1.0433142068324068e+18,22,178,8.090909090909092,5,11,8,14
1.0433238120688545e+18,3,3,1.0,1,1,3,0
1.0433396440560916e+18,6,21,3.5,2,5,6,0
1.0433862650472316e+18,5,24,4.8,4,6,5,0
1.0433927009349784e+18,13,67,5.153846153846154,4,6,13,0
1.0434248868402095e+18,12,104,8.666666666666666,7,10,1,11
1.0436024032730703e+18,10,19,1.9,1,3,10,0
1.0438613545090769e+18,33,232,7.03030303030303,4,9,21,12
1.0439372551228874e+18,31,62,2.0,1,4,31,0
1.0439927155800234e+18,37,216,5.837837837837838,3,8,33,4
1.0439943313326802e+18,6,10,1.6666666666666667,1,2,6,0
1.0440181361628488e+18,64,449,7.015625,3,10,45,19
1.0440224095903999e+18,50,249,4.98,2,7,50,0
1.0440492330653498e+18,15,142,9.466666666666667,3,12,2,13
1.044050155301313e+18,3,5,1.6666666666666667,1,2,3,0
1.0441073184575739e+18,2,4,2.0,2,2,2,0
1.0441186400058533e+18,4,30,7.5,6,9,2,2
1.0441206937476986e+18,5,39,7.8,7,9,3,2
1.0441219787341674e+18,54,77,1.4259259259259258,1,3,54,0
1.0441380227426472e+18,1,1,1.0,1,1,1,0
1.044166066364157e+18,3,21,7.0,7,7,3,0
1.0442366464352097e+18,4,37,9.25,8,10,0,4
1.0442422249280972e+18,5,15,3.0,1,4,5,0
1.0442712593034528e+18,3,20,6.666666666666667,6,7,3,0
1.0442953653617578e+18,1,4,4.0,4,4,1,0
1.0443186652305247e+18,3,24,8.0,7,9,1,2
1.0444291631162808e+18,1,5,5.0,5,5,1,0
1.0446394355141234e+18,56,285,5.089285714285714,2,7,56,0
1.0446804746090355e+18,53,482,9.09433962264151,4,12,2,51
1.0447298922740372e+18,8,18,2.25,1,4,8,0
1.0447509117902332e+18,2,4,2.0,1,3,2,0
1.044776572808496e+18,8,48,6.0,2,8,7,1
1.0447784401321844e+18,34,230,6.764705882352941,3,9,22,12
1.0447926784154e+18,4,12,3.0,2,4,4,0
1.044837847724609e+18,20,140,7.0,3,9,13,7
1.044843402193808e+18,19,37,1.9473684210526316,1,4,19,0
1.0448540837167238e+18,74,501,6.77027027027027,3,9,55,19
1.0448818528748119e+18,65,619,9.523076923076923,3,13,5,60
1.044891311289164e+18,39,160,4.102564102564102,2,6,39,0
1.0449125975626252e+18,61,193,3.1639344262295084,1,6,61,0
1.044950578814871e+18,2,8,4.0,3,5,2,0
1.0449729785503393e+18,73,498,6.821917808219178,2,9,51,22
1.0449823014213638e+18,53,107,2.018867924528302,1,4,53,0
1.0449836219454513e+18,28,139,4.964285714285714,3,7,28,0
1.0449998067987808e+18,11,25,2.272727272727273,1,5,11,0
1.0450003883465728e+18,16,112,7.0,3,9,11,5
1.0450024604639939e+18,2,11,5.5,4,7,2,0
1.0450252632462732e+18,29,137,4.724137931034483,2,7,29,0
1.0450361975785778e+18,74,501,6.77027027027027,2,10,54,20
1.0450523034119236e+18,62,601,9.693548387096774,2,12,2,60
1.0451517342608243e+18,1,3,3.0,3,3,1,0
1.0454047061711858e+18,2,7,3.5,3,4,2,0
1.0454174533681134e+18,4,6,1.5,1,3,4,0
1.0454527475435553e+18,45,313,6.955555555555556,4,9,29,16
1.0454609200108503e+18,3,3,1.0,1,1,3,0
1.0454755478198856e+18,46,86,1.8695652173913044,1,4,46,0
1.0454903581831922e+18,6,23,3.8333333333333335,3,5,6,0
1.045513235996315e+18,10,18,1.8,1,4,10,0
1.0455161377021955e+18,1,8,8.0,8,8,0,1
1.0455187570443195e+18,7,15,2.142857142857143,1,3,7,0
1.0455191034681434e+18,7,21,3.0,2,4,7,0
1.0455343406642756e+18,1,4,4.0,4,4,1,0
1.0455375789239496e+18,16,79,4.9375,3,7,16,0
1.0455449914041188e+18,2,6,3.0,2,4,2,0
1.0455592627168634e+18,55,364,6.618181818181818,2,9,39,16
1.0455661516381166e+18,1,6,6.0,6,6,1,0
1.045568549177521e+18,1,3,3.0,3,3,1,0
1.0455710765188923e+18,1,1,1.0,1,1,1,0
1.0455844033626932e+18,6,23,3.8333333333333335,3,5,6,0
1.0455924655185637e+18,31,95,3.064516129032258,1,4,31,0
1.045597840968754e+18,2,14,7.0,6,8,1,1
1.0456203714783688e+18,6,12,2.0,1,4,6,0
1.0456239353451325e+18,42,213,5.071428571428571,3,7,42,0
1.0456269480295629e+18,75,297,3.96,2,6,75,0
1.0456368071218845e+18,1,2,2.0,2,2,1,0
1.0456369875445569e+18,1,10,10.0,10,10,0,1
1.0456591889570958e+18,57,117,2.0526315789473686,1,5,57,0
1.0456597270774287e+18,3,23,7.666666666666667,7,9,2,1
1.0456808004586295e+18,44,178,4.045454545454546,2,6,44,0
1.0457712800069059e+18,2,15,7.5,7,8,1,1
1.045797498630292e+18,2,17,8.5,8,9,0,2
1.0457988832831752e+18,39,201,5.153846153846154,3,7,39,0
1.0458920808530472e+18,15,31,2.066666666666667,1,3,15,0
1.0461278070894993e+18,17,148,8.705882352941176,7,11,3,14
1.0461317305283066e+18,24,235,9.791666666666666,2,13,1,23
1.0461378096770267e+18,8,74,9.25,5,11,1,7
1.0461426190608076e+18,13,82,6.3076923076923075,4,8,11,2
1.0462223009862711e+18,2,3,1.5,1,2,2,0
1.046228155376046e+18,29,58,2.0,1,4,29,0
1.0462330056879781e+18,25,76,3.04,1,5,25,0
1.0462371599172598e+18,16,23,1.4375,1,2,16,0
1.0462586083032778e+18,4,44,11.0,10,13,0,4
1.0462746459055364e+18,15,20,1.3333333333333333,1,3,15,0
1.0462827773826894e+18,99,579,5.848484848484849,3,8,98,1
1.0463003207242922e+18,4,9,2.25,1,4,4,0
1.0463030043707616e+18,29,147,5.068965517241379,3,7,29,0
1.0463378211382367e+18,53,260,4.90566037735849,2,7,53,0
1.0463460065833673e+18,62,251,4.048387096774194,2,7,62,0
1.0463490926990964e+18,21,104,4.9523809523809526,4,7,21,0
1.0463871454598648e+18,65,94,1.4461538461538461,1,4,65,0
1.0464479568172861e+18,34,169,4.970588235294118,2,8,33,1
1.0464510174629171e+18,3,11,3.6666666666666665,3,4,3,0
1.0464895263875305e+18,9,19,2.111111111111111,1,3,9,0
1.0465106781171597e+18,4,28,7.0,6,8,3,1
1.0465133947487876e+18,121,832,6.87603305785124,2,10,87,34
1.0468466812605923e+18,33,300,9.090909090909092,7,11,2,31
1.0469089395137074e+18,40,117,2.925,1,6,40,0
1.0469158216832966e+18,67,580,8.656716417910447,2,12,6,61
1.0469160656528986e+18,10,98,9.8,4,12,1,9
1.0469557760542099e+18,2,11,5.5,5,6,2,0
1.0469595608638801e+18,33,86,2.606060606060606,1,4,33,0
1.046959569767197e+18,45,304,6.7555555555555555,2,10,33,12
1.0469873664112608e+18,84,176,2.0952380952380953,1,4,84,0
1.0469876969858929e+18,50,105,2.1,1,5,50,0
1.0469993246810798e+18,33,198,6.0,3,8,27,6
1.0470144285972823e+18,76,363,4.776315789473684,2,7,76,0
1.047043451792363e+18,15,145,9.666666666666666,8,12,0,15
1.0470637481672145e+18,38,120,3.1578947368421053,2,5,38,0
1.0471374574330572e+18,19,39,2.0526315789473686,1,4,19,0
1.0471378820558888e+18,33,165,5.0,2,8,32,1
1.047166192136545e+18,11,21,1.9090909090909092,1,3,11,0
1.0471882769367533e+18,15,21,1.4,1,2,15,0
1.047194567283354e+18,9,67,7.444444444444445,6,9,4,5
1.0472456344966906e+18,4,30,7.5,7,9,3,1
1.0472672230324201e+18,106,522,4.9245283018867925,2,7,106,0
1.0476044906809294e+18,67,462,6.895522388059701,3,10,45,22
1.0476045631819986e+18,13,46,3.5384615384615383,3,5,13,0
1.0476205889953683e+18,59,293,4.966101694915254,3,7,59,0
1.0476409168277719e+18,2,2,1.0,1,1,2,0
1.0476755817004641e+18,42,93,2.2142857142857144,1,5,42,0
1.0477338900281829e+18,1,4,4.0,4,4,1,0
1.047751873763743e+18,17,141,8.294117647058824,6,11,6,11
1.0477587205414834e+18,9,26,2.888888888888889,1,5,9,0
1.0477692706998752e+18,3,8,2.6666666666666665,1,5,3,0
1.0477906150275364e+18,83,117,1.4096385542168675,1,4,83,0
1.047800929620803e+18,54,155,2.8703703703703702,1,5,54,0
1.0478296867557201e+18,6,44,7.333333333333333,4,10,3,3
1.0478513958972778e+18,1,3,3.0,3,3,1,0
1.0478589768379816e+18,1,3,3.0,3,3,1,0
1.0478660596590988e+18,17,140,8.235294117647058,4,11,3,14
1.0478670243200202e+18,1,7,7.0,7,7,1,0
1.0478730961507608e+18,30,41,1.3666666666666667,1,3,30,0
1.0478734733134971e+18,38,216,5.684210526315789,2,9,37,1
1.047881907608752e+18,8,70,8.75,7,10,1,7
1.0478918268431181e+18,40,193,4.825,2,7,40,0
1.0479266147436916e+18,19,90,4.7368421052631575,4,7,19,0
1.0479439578235323e+18,5,6,1.2,1,2,5,0
1.0479496703345382e+18,30,143,4.766666666666667,3,7,30,0
1.0482813678335109e+18,2,9,4.5,2,7,2,0
1.0483986492865807e+18,2,15,7.5,6,9,1,1
1.0484206707722954e+18,5,33,6.6,6,8,4,1
1.0485104974435544e+18,16,37,2.3125,1,4,16,0
1.048552556788501e+18,27,113,4.185185185185185,3,6,27,0
1.0485613610752468e+18,57,548,9.614035087719298,3,12,3,54
1.0486131479839308e+18,35,343,9.8,3,12,1,34
1.04874917811693e+18,58,118,2.0344827586206895,1,4,58,0
1.0487928990144332e+18,4,12,3.0,2,4,4,0
1.0490092885362788e+18,34,245,7.205882352941177,6,10,23,11
1.0490637207584678e+18,1,2,2.0,2,2,1,0
1.0490913145019177e+18,3,5,1.6666666666666667,1,2,3,0
1.0490952442824335e+18,2,4,2.0,2,2,2,0
1.049095645892824e+18,9,13,1.4444444444444444,1,3,9,0
1.0491053427712276e+18,6,43,7.166666666666667,6,9,5,1
1.0491254462950126e+18,1,2,2.0,2,2,1,0
1.0491263316952783e+18,11,52,4.7272727272727275,3,7,11,0
1.0491272152837044e+18,15,65,4.333333333333333,2,6,15,0
1.0491402563871269e+18,3,21,7.0,6,9,2,1
1.049159659747015e+18,34,296,8.705882352941176,6,10,4,30
1.0491683327754294e+18,34,121,3.5588235294117645,1,6,34,0
1.0491723626198257e+18,9,62,6.888888888888889,5,9,6,3
1.0491900416961736e+18,11,79,7.181818181818182,6,9,7,4
1.0491910878832174e+18,4,30,7.5,6,9,2,2
1.0491968427427988e+18,52,107,2.0576923076923075,1,4,52,0
1.0492135318040763e+18,23,202,8.782608695652174,5,11,3,20
1.0492240123540242e+18,4,10,2.5,2,3,4,0
1.0492243372177964e+18,16,151,9.4375,8,11,0,16
1.0492515139246742e+18,22,213,9.681818181818182,4,11,1,21
1.0492955106783036e+18,11,74,6.7272727272727275,4,10,7,4
1.0493063907823739e+18,8,15,1.875,1,3,8,0
1.0493226342505472e+18,12,119,9.916666666666666,8,12,0,12
1.0494125162024865e+18,6,39,6.5,5,8,5,1
1.0494130763157123e+18,3,7,2.3333333333333335,2,3,3,0
1.0494468301322326e+18,4,29,7.25,7,8,3,1
1.049695635748273e+18,33,67,2.0303030303030303,1,5,33,0
1.0497442072836047e+18,20,137,6.85,5,8,14,6
1.0497751369656529e+18,1,2,2.0,2,2,1,0
1.0497795005174612e+18,1,1,1.0,1,1,1,0
1.0497919387128806e+18,30,159,5.3,4,7,30,0
1.0498068571051267e+18,6,18,3.0,2,4,6,0
1.0498181567841121e+18,2,7,3.5,3,4,2,0
1.0498861291611643e+18,8,18,2.25,1,3,8,0
1.0499830063664952e+18,20,41,2.05,1,4,20,0
1.0500482521884492e+18,1,10,10.0,10,10,0,1
1.0501395597285565e+18,2,6,3.0,3,3,2,0
1.0504203174585152e+18,2,15,7.5,7,8,1,1
1.0505085679826217e+18,20,77,3.85,2,6,20,0
1.0505229789018588e+18,10,32,3.2,2,5,10,0
1.0505304118589805e+18,1,1,1.0,1,1,1,0
1.0505515771846834e+18,14,21,1.5,1,3,14,0
1.0506364147747802e+18,6,14,2.3333333333333335,1,4,6,0
1.0506828318400347e+18,18,71,3.9444444444444446,2,6,18,0
1.0506829384113898e+18,7,59,8.428571428571429,7,11,1,6
1.0506907965972511e+18,4,6,1.5,1,2,4,0
1.0506974674592906e+18,3,18,6.0,5,7,3,0
1.0506980646245887e+18,33,104,3.1515151515151514,1,5,33,0
1.0507035594115634e+18,27,146,5.407407407407407,4,8,26,1
1.0507197865561276e+18,5,53,10.6,10,11,0,5
1.0507300093911e+18,9,51,5.666666666666667,3,7,9,0
1.0507435068615256e+18,6,44,7.333333333333333,6,9,3,3
1.0508511503619525e+18,33,43,1.303030303030303,1,4,33,0
1.050907880050071e+18,6,36,6.0,3,8,5,1
1.0512613534514316e+18,16,82,5.125,3,6,16,0
1.0512726621262194e+18,4,11,2.75,2,4,4,0
1.0513106699449961e+18,14,33,2.357142857142857,1,4,14,0
1.0513288076063242e+18,92,125,1.358695652173913,1,3,92,0
1.051366101556176e+18,1,11,11.0,11,11,0,1
1.0514003446507601e+18,32,128,4.0,3,6,32,0
1.0514564625724722e+18,42,377,8.976190476190476,4,11,6,36
1.0514643819460888e+18,7,24,3.4285714285714284,3,4,7,0
1.0514687379011117e+18,1,2,2.0,2,2,1,0
1.0514727970387099e+18,2,3,1.5,1,2,2,0
1.0514803979721332e+18,44,417,9.477272727272727,3,12,5,39
1.051499525392047e+18,31,278,8.96774193548387,4,11,5,26
1.0515049886612645e+18,23,66,2.869565217391304,1,5,23,0
1.0515100054068323e+18,35,331,9.457142857142857,2,12,3,32
1.0515114474568297e+18,15,18,1.2,1,2,15,0
1.0515589882665193e+18,102,795,7.794117647058823,2,10,39,63
1.0519452926489082e+18,16,111,6.9375,5,8,10,6
1.0519535915549068e+18,2,5,2.5,2,3,2,0
1.0519696248084406e+18,32,103,3.21875,1,5,32,0
1.051986247903779e+18,4,6,1.5,1,3,4,0
1.0520271226716672e+18,33,66,2.0,1,4,33,0
1.0520289274856851e+18,28,55,1.9642857142857142,1,4,28,0
1.0520294611705167e+18,39,78,2.0,1,4,39,0
1.0520886386844079e+18,1,4,4.0,4,4,1,0
1.052097375642014e+18,8,17,2.125,1,3,8,0
1.0522282676496236e+18,67,470,7.014925373134329,4,9,44,23
1.0522490879285174e+18,59,575,9.745762711864407,3,13,3,56
1.0522960015218193e+18,83,560,6.746987951807229,3,9,62,21
1.0523662129287299e+18,49,281,5.73469387755102,2,8,47,2
1.052685968044923e+18,3,15,5.0,4,6,3,0
1.0526986181986932e+18,24,118,4.916666666666667,2,6,24,0
1.0527135840834834e+18,4,20,5.0,4,6,4,0
1.0527480774134273e+18,9,85,9.444444444444445,4,11,1,8
1.0528313589619263e+18,2,8,4.0,3,5,2,0
1.0529091586403849e+18,7,14,2.0,1,4,7,0
1.0529406030384983e+18,8,17,2.125,1,4,8,0
1.0529867442791165e+18,3,20,6.666666666666667,6,7,3,0
1.0529880123307613e+18,68,340,5.0,3,7,68,0
1.0533465013405023e+18,2,21,10.5,10,11,0,2
1.054233652682641e+18,1,6,6.0,6,6,1,0
1.0542586134187107e+18,17,30,1.7647058823529411,1,3,17,0
1.054307987753627e+18,64,254,3.96875,1,7,64,0
1.0544137545358726e+18,16,75,4.6875,3,7,16,0
1.0544627619292371e+18,8,57,7.125,6,9,5,3
1.0544916992117503e+18,3,6,2.0,1,3,3,0
1.0546109350701504e+18,46,313,6.804347826086956,2,8,36,10
1.0548627843052014e+18,53,269,5.0754716981132075,3,7,53,0
1.0549003060818836e+18,74,357,4.824324324324325,2,7,74,0
1.0549722994180394e+18,8,66,8.25,7,10,2,6
1.0550564926582921e+18,31,59,1.903225806451613,1,3,31,0
1.0550596042788516e+18,1,3,3.0,3,3,1,0
1.0550659041125353e+18,77,384,4.987012987012987,2,8,76,1
1.0551078113253619e+18,6,13,2.1666666666666665,1,3,6,0
1.055110687528596e+18,62,622,10.03225806451613,3,14,1,61
1.0551132247225343e+18,60,306,5.1,4,7,60,0
1.0551415413188645e+18,68,334,4.911764705882353,2,7,68,0
1.0551932440570993e+18,20,41,2.05,1,3,20,0
1.0552038067449581e+18,15,78,5.2,2,7,15,0
1.0552038280761875e+18,40,186,4.65,2,7,40,0
1.0552042127135324e+18,51,265,5.196078431372549,4,7,51,0
1.0552052844753706e+18,43,206,4.790697674418604,3,7,43,0
1.0552054079509302e+18,29,145,5.0,2,7,29,0
1.055222185514448e+18,55,272,4.945454545454545,2,7,55,0
1.0552876712663144e+18,1,8,8.0,8,8,0,1
1.0554631534050515e+18,4,34,8.5,8,9,0,4
1.0555430147406309e+18,20,116,5.8,4,8,18,2
1.055551506932642e+18,11,32,2.909090909090909,2,5,11,0
1.0555718865278226e+18,3,7,2.3333333333333335,2,3,3,0
1.0555901664266815e+18,3,20,6.666666666666667,6,7,3,0
1.0556103541791075e+18,19,90,4.7368421052631575,3,6,19,0
1.0556104342124776e+18,3,27,9.0,8,11,0,3
1.0556395685625948e+18,19,94,4.947368421052632,2,7,19,0
1.0556866614503772e+18,16,27,1.6875,1,3,16,0
1.055700053451162e+18,25,121,4.84,3,7,25,0
1.0557268940156462e+18,3,11,3.6666666666666665,3,4,3,0
1.0557561936483788e+18,45,348,7.733333333333333,2,10,17,28
1.0557646336424378e+18,38,247,6.5,2,9,26,12
1.0558231104488328e+18,52,149,2.8653846153846154,1,6,52,0
1.0558402931093644e+18,61,585,9.59016393442623,2,12,4,57
1.0558826081194167e+18,53,258,4.867924528301887,3,8,52,1
1.0559369414810657e+18,1,3,3.0,3,3,1,0
1.05598488083092e+18,129,638,4.945736434108527,2,8,128,1
1.0561123975016169e+18,49,108,2.204081632653061,1,4,49,0
1.0562654712762496e+18,12,12,1.0,1,1,12,0
1.0563690685637407e+18,35,324,9.257142857142858,4,11,2,33
1.056380437250182e+18,8,42,5.25,4,7,8,0
1.0563805044001668e+18,42,298,7.095238095238095,5,9,27,15
1.056386884352785e+18,4,9,2.25,1,3,4,0
1.0563999360298132e+18,3,21,7.0,5,9,2,1
1.0564169688768288e+18,9,38,4.222222222222222,2,5,9,0
1.0564221120647593e+18,1,3,3.0,3,3,1,0
1.0564303141503685e+18,6,20,3.3333333333333335,2,5,6,0
1.0565013818270461e+18,96,198,2.0625,1,4,96,0
1.0565312175349652e+18,73,642,8.794520547945206,2,11,6,67
1.0565453364328833e+18,6,26,4.333333333333333,2,7,6,0
1.0565578936981518e+18,63,595,9.444444444444445,2,12,5,58
1.0565601984400754e+18,12,56,4.666666666666667,3,6,12,0
1.0566170253544622e+18,61,570,9.344262295081966,2,12,6,55
1.0569675902586579e+18,87,520,5.977011494252873,2,8,80,7
1.0570306174724786e+18,37,73,1.972972972972973,1,4,37,0
1.0571143307241274e+18,2,19,9.5,9,10,0,2
1.057118998636864e+18,8,52,6.5,5,8,7,1
1.0571310433280623e+18,9,19,2.111111111111111,1,3,9,0
1.057240827701378e+18,1,2,2.0,2,2,1,0
1.0573114583064068e+18,36,132,3.6666666666666665,2,6,36,0
1.0573447053417773e+18,59,390,6.610169491525424,2,9,44,15
1.0573617957985405e+18,1,2,2.0,2,2,1,0
1.0573631010475219e+18,25,95,3.8,1,6,25,0
1.0573792266218017e+18,4,33,8.25,8,9,0,4
1.0573822558881911e+18,41,88,2.1463414634146343,1,4,41,0
1.0574227457713624e+18,24,231,9.625,5,12,2,22
1.0576690595325066e+18,21,39,1.8571428571428572,1,3,21,0
1.0578486224756047e+18,22,108,4.909090909090909,3,7,22,0
1.0578813263178792e+18,7,58,8.285714285714286,7,9,2,5
1.0579518817579913e+18,2,16,8.0,8,8,0,2
1.0580383316240951e+18,3,14,4.666666666666667,4,5,3,0
1.0580731344604073e+18,25,209,8.36,2,11,6,19
1.0581133767696936e+18,3,8,2.6666666666666665,1,4,3,0
1.058321628217845e+18,21,38,1.8095238095238095,1,3,21,0
1.0586485424510342e+18,47,455,9.680851063829786,3,13,3,44
1.0586496353963162e+18,44,413,9.386363636363637,5,11,3,41
1.0593413403277923e+18,73,156,2.136986301369863,1,5,73,0
1.0594002863996428e+18,22,194,8.818181818181818,7,11,1,21
1.0594229832305078e+18,102,218,2.1372549019607843,1,4,102,0
1.0594277990145281e+18,10,48,4.8,4,6,10,0
1.059473363781192e+18,34,101,2.9705882352941178,1,5,34,0
1.0594820515659346e+18,1,7,7.0,7,7,1,0
1.0599011544159327e+18,19,193,10.157894736842104,9,11,0,19
1.0599100225159501e+18,57,114,2.0,1,4,57,0
1.0599482493344681e+18,8,20,2.5,1,4,8,0
1.0599559782363729e+18,5,14,2.8,2,3,5,0
1.059959014093038e+18,13,50,3.8461538461538463,3,6,13,0
1.0599607737837449e+18,12,46,3.8333333333333335,2,6,12,0
1.0599632745565213e+18,13,52,4.0,2,6,13,0
1.0599655553973443e+18,15,61,4.066666666666666,3,6,15,0
1.0599677365712248e+18,43,179,4.162790697674419,2,7,43,0
1.0599682761355284e+18,6,18,3.0,2,4,6,0
1.0599709657347781e+18,8,25,3.125,2,5,8,0
1.0599750440769334e+18,44,224,5.090909090909091,2,8,43,1
1.0599855886597468e+18,12,75,6.25,5,8,10,2
1.0599980349314867e+18,13,78,6.0,2,8,12,1
1.0600025426816388e+18,3,7,2.3333333333333335,1,4,3,0
1.0600074345953791e+18,6,35,5.833333333333333,3,7,6,0
1.0600341069575557e+18,18,166,9.222222222222221,8,12,0,18
1.0600372924662866e+18,1,3,3.0,3,3,1,0
1.060039983857592e+18,48,322,6.708333333333333,2,9,34,14
1.0601730554836355e+18,1,1,1.0,1,1,1,0
1.0602009983872211e+18,39,81,2.076923076923077,1,4,39,0
1.0602057556803535e+18,13,41,3.1538461538461537,2,5,13,0
1.0602207772519237e+18,113,772,6.831858407079646,2,10,86,27
1.0602400309349741e+18,117,1048,8.957264957264957,3,11,12,105
1.0602726579946815e+18,1,3,3.0,3,3,1,0
1.060276046192183e+18,2,6,3.0,2,4,2,0
1.0602762710972832e+18,3,9,3.0,2,4,3,0
1.0603736787459363e+18,31,39,1.2580645161290323,1,3,31,0
1.060377123528647e+18,51,289,5.666666666666667,2,9,48,3
1.060562339719288e+18,1,7,7.0,7,7,1,0
1.0606389633231291e+18,41,274,6.682926829268292,2,10,30,11
1.0606479169966054e+18,21,140,6.666666666666667,2,9,17,4
1.0606711238675954e+18,49,343,7.0,5,10,32,17
1.060686000064092e+18,56,386,6.892857142857143,2,9,37,19
1.0606985209881324e+18,8,64,8.0,6,10,2,6
1.0607073110043889e+18,32,160,5.0,3,7,32,0
1.0607344327588736e+18,7,51,7.285714285714286,6,8,3,4
1.0607481412135464e+18,42,355,8.452380952380953,3,11,5,37
1.0607822877682426e+18,3,4,1.3333333333333333,1,2,3,0
1.0608069417256324e+18,3,11,3.6666666666666665,3,4,3,0
1.0608107867398798e+18,21,195,9.285714285714286,3,11,2,19
1.0608268014269969e+18,55,518,9.418181818181818,3,12,4,51
1.0608291526329217e+18,15,31,2.066666666666667,1,3,15,0
1.0608444088774833e+18,19,61,3.210526315789474,2,5,19,0
1.0608713981891978e+18,9,65,7.222222222222222,6,9,5,4
1.060888798556955e+18,10,66,6.6,4,10,8,2
1.0609366034285075e+18,2,16,8.0,8,8,0,2
1.061326894340416e+18,7,18,2.5714285714285716,1,4,7,0
1.0613370091045569e+18,7,41,5.857142857142857,4,7,7,0
1.0613838422090934e+18,1,7,7.0,7,7,1,0
1.0613990938086038e+18,3,5,1.6666666666666667,1,2,3,0
1.0614074501333188e+18,33,167,5.0606060606060606,3,7,33,0
1.0614596683212207e+18,3,9,3.0,2,4,3,0
1.0614638783512677e+18,1,1,1.0,1,1,1,0
1.0614690435100154e+18,12,120,10.0,9,11,0,12
1.0615051815922043e+18,29,207,7.137931034482759,4,10,18,11
1.0615130136415671e+18,54,112,2.074074074074074,1,4,54,0
1.0615208288422984e+18,7,9,1.2857142857142858,1,2,7,0
1.0615245088495242e+18,60,120,2.0,1,5,60,0
1.0615776100353435e+18,14,26,1.8571428571428572,1,4,14,0
1.0616024953724489e+18,8,25,3.125,2,4,8,0
1.0616076181991946e+18,8,30,3.75,1,5,8,0
1.0616082171613281e+18,35,82,2.342857142857143,1,5,35,0
1.0616466071194833e+18,6,51,8.5,7,9,1,5
1.0618110911755932e+18,4,5,1.25,1,2,4,0
1.061823251151127e+18,10,67,6.7,5,8,8,2
1.0618277309685038e+18,7,13,1.8571428571428572,1,3,7,0
1.0620824936556855e+18,34,262,7.705882352941177,4,9,12,22
1.0620909723087002e+18,41,281,6.853658536585366,2,9,30,11
1.0620970411699675e+18,20,201,10.05,8,12,0,20
1.0621073124729737e+18,47,325,6.914893617021277,3,10,31,16
1.0621337133869757e+18,15,120,8.0,6,9,3,12
1.0622296940341486e+18,72,683,9.48611111111111,2,12,6,66
1.0622912496960403e+18,2,13,6.5,6,7,2,0
1.0623137253102132e+18,42,55,1.3095238095238095,1,3,42,0
1.0623389741725178e+18,32,161,5.03125,3,7,32,0
1.0623935512081197e+18,56,528,9.428571428571429,3,11,5,51
1.0624592732467346e+18,64,607,9.484375,2,13,9,55
1.0625312397207287e+18,35,235,6.714285714285714,3,10,30,5
1.0627048145157443e+18,5,36,7.2,6,8,3,2
1.0627880712571671e+18,21,188,8.952380952380953,4,12,2,19
1.0628221227442341e+18,56,280,5.0,3,7,56,0
1.0628896338492148e+18,1,8,8.0,8,8,0,1
1.0629240167254877e+18,8,43,5.375,3,7,8,0
1.0629475686875186e+18,1,1,1.0,1,1,1,0
1.0629657710140406e+18,16,95,5.9375,4,8,15,1
1.063027411298743e+18,1,3,3.0,3,3,1,0
1.0631810588449466e+18,20,203,10.15,5,13,1,19
1.0632062848909952e+18,17,146,8.588235294117647,3,11,3,14
1.063334836234035e+18,7,54,7.714285714285714,2,9,1,6
1.0634548616948888e+18,22,113,5.136363636363637,3,8,21,1
1.0634873059042554e+18,8,79,9.875,9,11,0,8
1.0636232094471945e+18,26,172,6.615384615384615,3,8,18,8
1.0636336264471848e+18,6,27,4.5,4,6,6,0
1.0637924559309997e+18,7,17,2.4285714285714284,1,4,7,0
1.0638305151452225e+18,21,188,8.952380952380953,8,11,0,21
1.0642405034984584e+18,5,38,7.6,6,9,2,3
1.0643129285637339e+18,16,31,1.9375,1,4,16,0
1.0643537288366971e+18,19,131,6.894736842105263,3,10,13,6
1.0643774091571164e+18,22,24,1.0909090909090908,1,2,22,0
1.0645038805262049e+18,9,80,8.88888888888889,7,11,1,8
1.064511770795912e+18,19,35,1.8421052631578947,1,4,19,0
1.06452433866944e+18,78,733,9.397435897435898,3,13,6,72
1.064560812665506e+18,5,27,5.4,5,6,5,0
1.0645610733818048e+18,32,233,7.28125,6,9,19,13
1.0645945071326369e+18,31,210,6.774193548387097,5,10,22,9
1.0646223901445594e+18,2,5,2.5,2,3,2,0
1.064623150143744e+18,5,39,7.8,7,8,1,4
1.0649492344462298e+18,8,55,6.875,5,8,5,3
1.0649572983499325e+18,64,192,3.0,1,5,64,0
1.0649606401247519e+18,7,16,2.2857142857142856,1,4,7,0
1.0650020698958148e+18,11,16,1.4545454545454546,1,3,11,0
1.0650178981890072e+18,2,2,1.0,1,1,2,0
1.0650194698766195e+18,146,213,1.4589041095890412,1,5,146,0
1.0650278720616398e+18,8,20,2.5,1,4,8,0
1.0650287626280397e+18,13,53,4.076923076923077,3,6,13,0
1.065065703085446e+18,25,73,2.92,1,6,25,0
1.0650852038915252e+18,1,2,2.0,2,2,1,0
1.065104760833882e+18,4,14,3.5,3,4,4,0
1.0651078178612815e+18,1,2,2.0,2,2,1,0
1.0651381494085965e+18,6,20,3.3333333333333335,1,5,6,0
1.0651476617593574e+18,3,19,6.333333333333333,5,7,3,0
1.0651540816058362e+18,1,1,1.0,1,1,1,0
1.0651543827404246e+18,1,4,4.0,4,4,1,0
1.0651568167438707e+18,1,10,10.0,10,10,0,1
1.0651917260001435e+18,58,403,6.948275862068965,3,10,39,19
1.065200133477251e+18,3,4,1.3333333333333333,1,2,3,0
1.0652586993424616e+18,5,38,7.6,7,9,3,2
1.0652750548719251e+18,24,164,6.833333333333333,4,8,14,10
1.065285659473508e+18,1,3,3.0,3,3,1,0
1.0653051584346838e+18,13,38,2.923076923076923,1,4,13,0
1.0654089888057516e+18,20,30,1.5,1,4,20,0
1.065465346698899e+18,69,470,6.811594202898551,2,9,51,18
1.0656461619076833e+18,5,34,6.8,6,7,5,0
1.0656743068779471e+18,24,178,7.416666666666667,5,9,13,11
1.0656784309893023e+18,39,357,9.153846153846153,7,11,3,36
1.0656788352312913e+18,2,3,1.5,1,2,2,0
1.0656973177059809e+18,19,152,8.0,6,10,7,12
1.0657366846007488e+18,27,208,7.703703703703703,5,10,13,14
1.0657382288780105e+18,57,558,9.789473684210526,5,12,4,53
1.0657467632427283e+18,27,187,6.925925925925926,5,8,22,5
1.0657509705315369e+18,11,55,5.0,2,6,11,0
1.065790785837719e+18,56,524,9.357142857142858,2,12,8,48
1.0658151980562945e+18,36,177,4.916666666666667,3,8,35,1
1.065830800946081e+18,43,412,9.581395348837209,2,12,2,41
1.065858915546371e+18,34,71,2.088235294117647,1,4,34,0
1.0658615560308675e+18,4,11,2.75,2,4,4,0
1.065868788427158e+18,50,447,8.94,3,11,5,45
1.0658966464364929e+18,53,481,9.075471698113208,2,12,8,45
1.0659493635334659e+18,15,133,8.866666666666667,7,11,3,12
1.0659580600707515e+18,2,15,7.5,7,8,1,1
1.0659766109122111e+18,1,5,5.0,5,5,1,0
1.065985229090692e+18,6,42,7.0,5,8,4,2
1.0660116121927988e+18,46,97,2.108695652173913,1,4,46,0
1.0660439789927935e+18,71,679,9.56338028169014,2,13,6,65
1.0660447046510616e+18,2,21,10.5,10,11,0,2
1.0660614584325448e+18,32,257,8.03125,3,11,8,24
1.0660984586466945e+18,28,136,4.857142857142857,3,7,28,0
1.0664351761910004e+18,9,19,2.111111111111111,1,3,9,0
1.0665103526108003e+18,26,182,7.0,5,9,16,10
1.0665108390252818e+18,21,48,2.2857142857142856,1,4,21,0
1.0665235660043992e+18,14,45,3.2142857142857144,2,5,14,0
1.0665296454310387e+18,7,20,2.857142857142857,1,5,7,0
1.0665508196973165e+18,1,1,1.0,1,1,1,0
1.0665536333000979e+18,12,37,3.0833333333333335,2,4,12,0
1.066560889956512e+18,7,20,2.857142857142857,1,5,7,0
1.0665628949092681e+18,8,20,2.5,1,4,8,0
1.0665635655630671e+18,40,247,6.175,4,8,34,6
1.066563778287714e+18,117,697,5.957264957264957,3,8,108,9
1.066590414497393e+18,43,364,8.465116279069768,2,12,6,37
1.0666077158029265e+18,128,506,3.953125,1,7,128,0
1.0666316808418153e+18,14,25,1.7857142857142858,1,3,14,0
1.0666811752420467e+18,55,515,9.363636363636363,3,12,4,51
1.0667041008423327e+18,57,382,6.701754385964913,2,9,43,14
1.0667131299729587e+18,95,822,8.652631578947368,3,11,12,83
1.0667152818195437e+18,4,11,2.75,1,4,4,0
1.0667273400057622e+18,6,12,2.0,1,4,6,0
1.0667279198935468e+18,11,23,2.090909090909091,1,4,11,0
1.0667450612412168e+18,4,26,6.5,4,8,3,1
1.0667505435447388e+18,22,87,3.9545454545454546,2,6,22,0
1.066763287221176e+18,59,295,5.0,2,7,59,0
1.0667875505368846e+18,52,441,8.48076923076923,2,11,7,45
1.0668379113625782e+18,67,89,1.328358208955224,1,3,67,0
1.0671788153278189e+18,2,14,7.0,6,8,1,1
1.0671822734362636e+18,4,9,2.25,1,3,4,0
1.0671895605132014e+18,1,2,2.0,2,2,1,0
1.0671916624162405e+18,2,5,2.5,2,3,2,0
1.0671941314508929e+18,1,4,4.0,4,4,1,0
1.0671979300340604e+18,44,96,2.1818181818181817,1,5,44,0
1.0672006259902908e+18,6,38,6.333333333333333,3,9,5,1
1.0672099095162392e+18,29,107,3.689655172413793,1,6,29,0
1.0672490976542532e+18,17,87,5.117647058823529,2,6,17,0
1.067257240705466e+18,62,195,3.1451612903225805,1,6,62,0
1.0672593337646881e+18,21,118,5.619047619047619,4,8,20,1
1.067265817600528e+18,4,30,7.5,7,8,2,2
1.0672659010599404e+18,3,8,2.6666666666666665,2,3,3,0
1.0672659811460937e+18,7,18,2.5714285714285716,1,4,7,0
1.0672661364589682e+18,3,19,6.333333333333333,2,9,1,2
1.0672665508357019e+18,1,3,3.0,3,3,1,0
1.06726668550924e+18,1,2,2.0,2,2,1,0
1.0672670539980458e+18,5,40,8.0,7,9,1,4
1.0672671830690456e+18,2,13,6.5,6,7,2,0
1.0672673369549647e+18,2,5,2.5,1,4,2,0
1.0672688767426426e+18,2,4,2.0,1,3,2,0
1.0672740182821123e+18,3,20,6.666666666666667,6,7,3,0
1.0672786136283062e+18,55,262,4.763636363636364,2,8,54,1
1.0673046640525039e+18,26,261,10.038461538461538,8,12,0,26
1.0673075487828083e+18,12,81,6.75,5,8,9,3
1.0673075811940609e+18,21,150,7.142857142857143,3,9,12,9
1.0673494735480566e+18,16,108,6.75,5,8,12,4
1.0673661609286289e+18,20,43,2.15,1,4,20,0
1.0673737859299505e+18,32,93,2.90625,1,5,32,0
1.0674048143724979e+18,39,364,9.333333333333334,2,13,5,34
1.0674425258270319e+18,16,128,8.0,7,9,5,11
1.0674537082801043e+18,9,34,3.7777777777777777,3,5,9,0
1.067503738525364e+18,41,362,8.829268292682928,6,11,6,35
1.067803844104001e+18,61,365,5.983606557377049,4,9,59,2
1.0678935797759104e+18,18,153,8.5,3,10,2,16
1.06790553550976e+18,5,22,4.4,3,7,5,0
1.0679118160846513e+18,3,5,1.6666666666666667,1,2,3,0
1.0680057821974097e+18,25,127,5.08,3,8,24,1
1.0681049813511986e+18,19,67,3.526315789473684,2,6,19,0
1.068148537186416e+18,15,25,1.6666666666666667,1,3,15,0
1.068184575013452e+18,107,244,2.2803738317757007,1,5,107,0
1.0681938940364827e+18,99,680,6.8686868686868685,3,10,70,29
1.0681966503802633e+18,67,442,6.597014925373134,2,9,49,18
1.0685861664063255e+18,30,296,9.866666666666667,8,12,0,30
1.068629177014269e+18,15,133,8.866666666666667,7,11,2,13
1.0686773855571421e+18,3,25,8.333333333333334,7,10,1,2
1.0686922620239025e+18,6,14,2.3333333333333335,1,3,6,0
1.0686937004546806e+18,26,52,2.0,1,4,26,0
1.0686940739724448e+18,18,36,2.0,1,4,18,0
1.0686973851402267e+18,11,22,2.0,1,4,11,0
1.068859349420915e+18,40,193,4.825,2,7,40,0
1.0688598089192924e+18,23,74,3.217391304347826,2,5,23,0
1.0688712972650966e+18,23,153,6.6521739130434785,3,9,20,3
1.0689142017799018e+18,2,5,2.5,2,3,2,0
1.0689355932303141e+18,22,187,8.5,6,10,4,18
1.0689513107538659e+18,17,124,7.294117647058823,6,9,10,7
1.0689602141197686e+18,61,388,6.360655737704918,2,9,51,10
1.0689899434037002e+18,4,20,5.0,4,7,4,0
1.0690506709526765e+18,216,1078,4.9907407407407405,2,8,211,5
1.0692703023742751e+18,106,208,1.9622641509433962,1,4,106,0
1.0693334751031278e+18,4,41,10.25,9,12,0,4
1.0693335117625417e+18,9,26,2.888888888888889,2,4,9,0
1.0693492697659145e+18,32,217,6.78125,5,9,27,5
1.0693643147288678e+18,5,8,1.6,1,2,5,0
1.069395791054424e+18,1,1,1.0,1,1,1,0
1.0694027209385056e+18,19,97,5.105263157894737,3,7,19,0
1.0694252081247206e+18,27,54,2.0,1,4,27,0
1.0694254109723964e+18,43,430,10.0,7,13,2,41
1.0694907638818715e+18,14,95,6.785714285714286,2,9,11,3
1.0695545284501837e+18,20,36,1.8,1,3,20,0
1.069564215987597e+18,32,166,5.1875,3,7,32,0
1.0695873303242685e+18,6,62,10.333333333333334,10,11,0,6
1.069599918600846e+18,4,11,2.75,1,4,4,0
1.0696018880399057e+18,3,16,5.333333333333333,4,7,3,0
1.0696246655965417e+18,5,35,7.0,3,8,1,4
1.0696459964586088e+18,31,268,8.64516129032258,3,11,3,28
1.0697100129944431e+18,13,57,4.384615384615385,3,7,13,0
1.0697180110177819e+18,30,233,7.766666666666667,6,9,12,18
1.0697265077300607e+18,2,11,5.5,5,6,2,0
1.0699586969371191e+18,67,451,6.731343283582089,2,10,44,23
1.0700299077186281e+18,34,76,2.235294117647059,1,4,34,0
1.0700776718320177e+18,29,223,7.689655172413793,3,10,10,19
1.0701010010906e+18,24,119,4.958333333333333,2,7,24,0
1.0701159173137326e+18,4,10,2.5,2,3,4,0
1.0701203878709421e+18,1,3,3.0,3,3,1,0
1.070132566011308e+18,40,71,1.775,1,4,40,0
1.0701474709903311e+18,22,117,5.318181818181818,4,7,22,0
1.0701508182701999e+18,41,94,2.292682926829268,1,5,41,0
1.0701913670332166e+18,7,15,2.142857142857143,1,3,7,0
1.0701916153994916e+18,1,6,6.0,6,6,1,0
1.0702159828697092e+18,31,66,2.129032258064516,1,4,31,0
1.0702231239895529e+18,33,314,9.515151515151516,4,12,3,30
1.0702233471000911e+18,18,183,10.166666666666666,9,13,0,18
1.0702236362931515e+18,17,155,9.117647058823529,8,10,0,17
1.0702240224485248e+18,14,138,9.857142857142858,8,12,0,14
1.0702250836778653e+18,11,43,3.909090909090909,2,5,11,0
1.0702272501609654e+18,41,348,8.487804878048781,4,11,4,37
1.0702367470970717e+18,31,288,9.290322580645162,2,12,3,28
1.0702487721378372e+18,17,34,2.0,1,4,17,0
1.0702538697979852e+18,7,42,6.0,2,9,4,3
1.070316248368595e+18,5,14,2.8,1,4,5,0
1.0703429450855118e+18,6,19,3.1666666666666665,2,4,6,0
1.0703563023285896e+18,9,33,3.6666666666666665,2,5,9,0
1.0703698104075647e+18,16,24,1.5,1,3,16,0
1.0704062222550118e+18,1,7,7.0,7,7,1,0
1.0704132840119996e+18,66,327,4.954545454545454,2,7,66,0
1.0706934405766972e+18,14,116,8.285714285714286,2,11,2,12
1.0707726762687192e+18,25,46,1.84,1,4,25,0
1.0707936204851479e+18,1,1,1.0,1,1,1,0
1.0708728078125029e+18,22,61,2.772727272727273,1,5,22,0
1.0709110227275423e+18,1,3,3.0,3,3,1,0
1.0709288231199918e+18,1,9,9.0,9,9,0,1
1.070978099661251e+18,21,52,2.4761904761904763,1,4,21,0
1.070986407631449e+18,58,234,4.0344827586206895,1,7,58,0
1.0709939000571724e+18,15,33,2.2,1,4,15,0
1.0710177029047977e+18,9,75,8.333333333333334,5,11,2,7
1.0710430696340858e+18,18,37,2.0555555555555554,1,4,18,0
1.0710720616792655e+18,31,280,9.03225806451613,4,12,5,26
1.071074296399888e+18,10,17,1.7,1,3,10,0
1.0711918563385125e+18,18,125,6.944444444444445,5,8,11,7
1.0712041688837443e+18,14,98,7.0,3,9,8,6
1.07121498751393e+18,1,8,8.0,8,8,0,1
1.0714671294384681e+18,16,130,8.125,4,10,3,13
1.0714778740621234e+18,3,19,6.333333333333333,2,10,2,1
1.0714827591305347e+18,11,19,1.7272727272727273,1,3,11,0
1.0714964258838076e+18,16,52,3.25,1,5,16,0
1.0715232767818771e+18,51,239,4.686274509803922,2,7,51,0
1.071530792583554e+18,6,30,5.0,3,6,6,0
1.0715727874277126e+18,6,51,8.5,5,10,1,5
1.071599027087416e+18,20,58,2.9,1,5,20,0
1.0716001314677884e+18,7,13,1.8571428571428572,1,3,7,0
1.0716036782564814e+18,7,12,1.7142857142857142,1,3,7,0
1.0716050098050802e+18,14,33,2.357142857142857,1,4,14,0
1.0716289332824961e+18,72,426,5.916666666666667,3,8,69,3
1.0716645626358996e+18,36,180,5.0,3,7,36,0
1.0716707195483535e+18,3,8,2.6666666666666665,1,4,3,0
1.0716792742346388e+18,28,34,1.2142857142857142,1,2,28,0
1.0717090269558797e+18,31,276,8.903225806451612,6,11,4,27
1.0717147543172445e+18,1,12,12.0,12,12,0,1
1.07172578869347e+18,9,92,10.222222222222221,9,11,0,9
1.0717335810033306e+18,17,93,5.470588235294118,4,7,17,0
1.0717685116618386e+18,5,18,3.6,2,5,5,0
1.071775595364882e+18,48,325,6.770833333333333,2,9,38,10
1.0719159476212704e+18,14,72,5.142857142857143,4,7,14,0
1.0719323962584736e+18,3,21,7.0,6,9,2,1
1.0722114751257821e+18,2,23,11.5,11,12,0,2
1.072217588093276e+18,48,359,7.479166666666667,4,10,22,26
1.072240551266945e+18,8,13,1.625,1,4,8,0
1.0722689833882437e+18,2,2,1.0,1,1,2,0
1.0722701835158235e+18,29,88,3.0344827586206895,2,5,29,0
1.0722985889064443e+18,56,518,9.25,3,12,8,48
1.0723288637552625e+18,24,232,9.666666666666666,6,12,2,22
1.0723870072780684e+18,84,248,2.9523809523809526,1,5,84,0
1.0724165050124109e+18,1,9,9.0,9,9,0,1
1.0724254260985636e+18,27,179,6.62962962962963,5,9,21,6
1.0724324660430124e+18,7,51,7.285714285714286,5,10,4,3
1.0724485760461855e+18,7,59,8.428571428571429,7,9,1,6
1.07246332504197e+18,3,19,6.333333333333333,6,7,3,0
1.0725933212597487e+18,26,61,2.3461538461538463,1,4,26,0
1.0727769852261029e+18,37,263,7.108108108108108,5,9,25,12
1.0729919627483948e+18,31,69,2.225806451612903,1,4,31,0
1.0729921339317691e+18,12,60,5.0,2,7,12,0
1.0730323079366141e+18,1,3,3.0,3,3,1,0
1.0731568928891425e+18,36,317,8.805555555555555,2,11,3,33
1.0731579350171432e+18,7,13,1.8571428571428572,1,4,7,0
1.0733213897583206e+18,21,103,4.904761904761905,2,7,21,0
1.073339960555039e+18,8,67,8.375,2,10,1,7
1.0733446751703237e+18,8,61,7.625,4,9,3,5
1.0735959639234141e+18,1,7,7.0,7,7,1,0
1.0736089565148038e+18,7,20,2.857142857142857,2,4,7,0
1.0738354034923689e+18,15,46,3.066666666666667,1,5,15,0
1.0738561315786373e+18,4,5,1.25,1,2,4,0
1.0739032880326829e+18,27,255,9.444444444444445,2,12,2,25
1.0739834742245129e+18,1,3,3.0,3,3,1,0
1.0740569425196632e+18,38,259,6.815789473684211,3,10,28,10
1.0740631274095748e+18,60,463,7.716666666666667,2,10,22,38
1.0740948720737853e+18,7,60,8.571428571428571,7,10,1,6
1.0743911713597642e+18,4,17,4.25,3,5,4,0
1.0743960697444468e+18,5,39,7.8,7,9,3,2
1.0744194486857428e+18,51,108,2.1176470588235294,1,5,51,0
1.0744211076280173e+18,6,27,4.5,2,7,6,0
1.0744273962724735e+18,25,122,4.88,3,6,25,0
1.0744581817496493e+18,33,160,4.848484848484849,3,6,33,0
1.0745106388598104e+18,17,161,9.470588235294118,5,12,1,16
1.0745242882890665e+18,24,162,6.75,5,10,18,6
1.0745370258734812e+18,40,396,9.9,3,13,3,37
1.0745408824924603e+18,33,131,3.9696969696969697,1,7,33,0
1.0745484156823561e+18,16,116,7.25,5,10,12,4
1.0745486841863644e+18,3,6,2.0,1,3,3,0
1.074549621312282e+18,18,31,1.7222222222222223,1,4,18,0
1.0745497248563459e+18,12,83,6.916666666666667,6,9,9,3
1.074549780884573e+18,6,40,6.666666666666667,4,8,4,2
1.0745501248413733e+18,3,20,6.666666666666667,6,7,3,0
1.0745514947310373e+18,2,7,3.5,3,4,2,0
1.074551760275299e+18,1,6,6.0,6,6,1,0
1.0745531687414606e+18,2,4,2.0,1,3,2,0
1.0745533313405654e+18,2,13,6.5,6,7,2,0
1.0745539286342422e+18,7,9,1.2857142857142858,1,2,7,0
1.0745541504769784e+18,4,8,2.0,1,3,4,0
1.0745546337972114e+18,21,130,6.190476190476191,3,9,19,2
1.0745612218041582e+18,38,372,9.789473684210526,5,12,2,36
1.0745619065005338e+18,27,210,7.777777777777778,6,10,8,19
1.0745785828342212e+18,14,122,8.714285714285714,5,11,3,11
1.0745848416648987e+18,117,798,6.82051282051282,2,9,79,38
1.0746433147608847e+18,1,8,8.0,8,8,0,1
1.0746864229194619e+18,11,88,8.0,6,10,5,6
1.074734539832245e+18,16,109,6.8125,2,10,11,5
1.0747469296194564e+18,128,983,7.6796875,3,10,50,78
1.0747556461117068e+18,33,198,6.0,3,8,30,3
1.0747669557090113e+18,1,4,4.0,4,4,1,0
1.0748103223720713e+18,6,55,9.166666666666666,8,10,0,6
1.0748290616121745e+18,3,7,2.3333333333333335,2,3,3,0
1.07487706911876e+18,9,62,6.888888888888889,5,8,7,2
1.0750726296276899e+18,2,4,2.0,1,3,2,0
1.0751305941602742e+18,24,113,4.708333333333333,4,6,24,0
1.0751516574933761e+18,50,437,8.74,3,12,6,44
1.0751558509650392e+18,1,1,1.0,1,1,1,0
1.0751694127408397e+18,2,16,8.0,7,9,1,1
1.0751719126942328e+18,2,4,2.0,1,3,2,0
1.0751743122178022e+18,1,8,8.0,8,8,0,1
1.0752284142044759e+18,3,5,1.6666666666666667,1,3,3,0
1.0752584819305376e+18,2,5,2.5,2,3,2,0
1.0752894579100855e+18,14,29,2.0714285714285716,1,5,14,0
1.0753013152260522e+18,85,427,5.023529411764706,3,7,85,0
1.0753137155519647e+18,3,6,2.0,1,3,3,0
1.0753255654803247e+18,1,7,7.0,7,7,1,0
1.0753304274361258e+18,21,185,8.80952380952381,7,10,2,19
1.0753349830724539e+18,21,186,8.857142857142858,3,11,2,19
1.0753394410230696e+18,13,105,8.076923076923077,4,10,3,10
1.0753436407466588e+18,19,125,6.578947368421052,5,8,16,3
1.075351021453859e+18,1,11,11.0,11,11,0,1
1.0753856447999991e+18,2,6,3.0,2,4,2,0
1.0754332557326216e+18,38,114,3.0,1,5,38,0
1.0754571300980851e+18,14,64,4.571428571428571,2,7,14,0
1.0755031480023269e+18,1,1,1.0,1,1,1,0
1.0756820766314647e+18,41,215,5.2439024390243905,3,7,41,0
1.0758756552249519e+18,10,26,2.6,1,5,10,0
1.0758798458757528e+18,1,4,4.0,4,4,1,0
1.0758938618124337e+18,51,256,5.019607843137255,3,7,51,0
1.0758947247182202e+18,21,43,2.0476190476190474,1,4,21,0
1.0758977283327904e+18,2,4,2.0,1,3,2,0
1.0759087534457814e+18,8,68,8.5,6,11,2,6
1.0759155721061036e+18,2,11,5.5,5,6,2,0
1.0759446470789385e+18,43,219,5.093023255813954,3,7,43,0
1.075962073006762e+18,10,87,8.7,3,12,1,9
1.0759817783721933e+18,17,54,3.176470588235294,1,6,17,0
1.0760216047293204e+18,6,40,6.666666666666667,3,9,3,3
1.0760488792991482e+18,1,3,3.0,3,3,1,0
1.0760810768449088e+18,12,123,10.25,8,12,0,12
1.0761168674307181e+18,58,290,5.0,3,7,58,0
1.07614240636446e+18,49,385,7.857142857142857,3,10,11,38
1.0764913037151407e+18,48,411,8.5625,3,11,6,42
1.076520153931703e+18,29,60,2.0689655172413794,1,4,29,0
1.0765815502321759e+18,95,285,3.0,1,5,95,0
1.0765884851119333e+18,1,6,6.0,6,6,1,0
1.0766464928768641e+18,2,12,6.0,5,7,2,0
1.0767323310273236e+18,2,13,6.5,6,7,2,0
1.076739802403372e+18,7,57,8.142857142857142,7,10,2,5
1.0767454274443534e+18,32,307,9.59375,7,11,1,31
1.0767456237956402e+18,2,3,1.5,1,2,2,0
1.0768583025819956e+18,43,203,4.72093023255814,2,7,43,0
1.0768594781307034e+18,11,58,5.2727272727272725,4,6,11,0
1.0768816182020037e+18,2,14,7.0,6,8,1,1
1.0769152219363126e+18,5,30,6.0,5,7,5,0
1.0769152598368508e+18,42,86,2.0476190476190474,1,4,42,0
1.0769204596133276e+18,1,2,2.0,2,2,1,0
1.076953820074922e+18,35,176,5.0285714285714285,2,8,34,1
1.0769646565911958e+18,23,48,2.0869565217391304,1,4,23,0
1.0769725296703667e+18,1,9,9.0,9,9,0,1
1.0772753211524058e+18,49,493,10.061224489795919,8,12,0,49
1.0773002691348147e+18,11,65,5.909090909090909,2,8,9,2
1.0773286735794554e+18,18,128,7.111111111111111,5,9,10,8
1.0773645297297445e+18,8,15,1.875,1,3,8,0
1.0773653600519608e+18,23,164,7.130434782608695,5,9,14,9
1.077376570718345e+18,36,82,2.2777777777777777,1,5,36,0
1.0774102606186647e+18,11,40,3.6363636363636362,2,5,11,0
1.0774270157945492e+18,14,143,10.214285714285714,8,11,0,14
1.0774404835136273e+18,1,6,6.0,6,6,1,0
1.0774493920873939e+18,26,102,3.923076923076923,2,5,26,0
1.0774592372766141e+18,16,142,8.875,3,12,2,14
1.0774789722984607e+18,1,7,7.0,7,7,1,0
1.0775413237558278e+18,42,202,4.809523809523809,3,8,41,1
1.0776099876210474e+18,21,60,2.857142857142857,1,5,21,0
1.077615101788371e+18,59,282,4.779661016949152,3,7,59,0
1.0776180907913756e+18,3,12,4.0,3,5,3,0
1.0777033015653192e+18,45,89,1.9777777777777779,1,4,45,0
1.0777424203700479e+18,1,7,7.0,7,7,1,0
1.0777663928578272e+18,1,10,10.0,10,10,0,1
1.0777749509969217e+18,1,6,6.0,6,6,1,0
1.0779195226810546e+18,38,202,5.315789473684211,3,7,38,0
1.0779907383865651e+18,45,209,4.644444444444445,2,6,45,0
1.0781172618292237e+18,26,228,8.76923076923077,6,11,2,24
1.078126122531495e+18,25,129,5.16,3,7,25,0
1.0781308381105983e+18,19,77,4.052631578947368,2,7,19,0
1.0781579527214024e+18,20,43,2.15,1,5,20,0
1.0781613982402392e+18,9,91,10.11111111111111,9,11,0,9
1.0782519226859887e+18,51,483,9.470588235294118,2,12,3,48
1.0783842934167372e+18,39,195,5.0,3,8,38,1
1.0787901347383425e+18,51,245,4.803921568627451,2,7,51,0
1.0788127026076788e+18,9,50,5.555555555555555,4,7,9,0
1.0788179203792125e+18,62,286,4.612903225806452,2,7,62,0
1.0788523874352815e+18,49,462,9.428571428571429,2,12,5,44
1.0788554160074012e+18,59,294,4.983050847457627,2,7,59,0
1.078885126501333e+18,24,219,9.125,4,12,4,20
1.0789052795060774e+18,66,323,4.893939393939394,3,7,66,0
1.0789159031549798e+18,58,236,4.068965517241379,2,7,58,0
1.0789176647453459e+18,67,325,4.850746268656716,2,7,67,0
1.0789733158563372e+18,36,336,9.333333333333334,2,11,4,32
1.0790009618467156e+18,42,395,9.404761904761905,2,12,4,38
1.0790034207674095e+18,2,16,8.0,8,8,0,2
1.079004594882194e+18,5,32,6.4,5,8,4,1
1.0790070311883562e+18,8,74,9.25,7,11,1,7
1.0790293978838618e+18,44,409,9.295454545454545,3,12,6,38
1.0790504055585578e+18,92,363,3.9456521739130435,2,7,92,0
1.0790505446153185e+18,83,408,4.9156626506024095,2,8,82,1
1.0791373724999899e+18,1,7,7.0,7,7,1,0
1.0794205249579017e+18,6,43,7.166666666666667,3,9,2,4
1.0794358707493542e+18,16,109,6.8125,5,9,12,4
1.0794507799635519e+18,5,32,6.4,6,7,5,0
1.0794750753014995e+18,3,5,1.6666666666666667,1,2,3,0
1.0794835393263365e+18,75,639,8.52,2,11,17,58
1.0795410096128355e+18,10,26,2.6,2,4,10,0
1.0795529210033567e+18,2,3,1.5,1,2,2,0
1.0795637902486276e+18,12,81,6.75,5,8,9,3
1.0796047924336205e+18,30,211,7.033333333333333,5,9,21,9
1.0796157755902824e+18,82,559,6.817073170731708,2,10,57,25
1.079645583175953e+18,3,25,8.333333333333334,7,9,1,2
1.0796499376338725e+18,9,75,8.333333333333334,7,10,2,7
1.0796540710674806e+18,1,8,8.0,8,8,0,1
1.0796908961395574e+18,14,110,7.857142857142857,5,10,5,9
1.0797641859811859e+18,3,22,7.333333333333333,7,8,2,1
1.0798016361255236e+18,4,33,8.25,6,10,2,2
1.0798185282983983e+18,38,179,4.7105263157894735,2,7,38,0
1.0798629097823186e+18,25,167,6.68,4,9,17,8
1.0798874387610428e+18,11,17,1.5454545454545454,1,2,11,0
1.0801216389350767e+18,3,11,3.6666666666666665,3,4,3,0
1.0801365409066848e+18,20,132,6.6,2,9,16,4
1.0801785627021119e+18,4,31,7.75,6,9,2,2
1.0802079656937038e+18,8,20,2.5,1,3,8,0
1.080212062570551e+18,9,39,4.333333333333333,3,8,8,1
1.0802143771872193e+18,30,150,5.0,3,7,30,0
1.080223408330073e+18,9,23,2.5555555555555554,2,4,9,0
1.0802361637920433e+18,2,13,6.5,6,7,2,0
1.080251499056613e+18,38,150,3.9473684210526314,1,7,38,0
1.0802564361882074e+18,24,73,3.0416666666666665,1,4,24,0
1.0802979300541009e+18,6,10,1.6666666666666667,1,4,6,0
1.0802980704131697e+18,8,28,3.5,2,5,8,0
1.0803598001736846e+18,2,5,2.5,2,3,2,0
1.0803754723490111e+18,1,3,3.0,3,3,1,0
1.0804655280398616e+18,53,475,8.962264150943396,4,12,5,48
1.0804726800539547e+18,2,7,3.5,3,4,2,0
1.0804767250232083e+18,4,15,3.75,2,5,4,0
1.0805016242586706e+18,23,157,6.826086956521739,2,8,16,7
1.0805062569000344e+18,4,30,7.5,7,8,2,2
1.0805235469330746e+18,4,25,6.25,5,7,4,0
1.0805328400678332e+18,10,57,5.7,2,8,9,1
1.0805378709869985e+18,3,12,4.0,4,4,3,0
1.0805416123929682e+18,13,94,7.230769230769231,5,9,9,4
1.0805800534908221e+18,8,58,7.25,6,8,5,3
1.0805835033917412e+18,1,3,3.0,3,3,1,0
1.0805853113233955e+18,42,91,2.1666666666666665,1,5,42,0
1.0806366345618076e+18,17,33,1.9411764705882353,1,4,17,0
1.0806388774675786e+18,14,73,5.214285714285714,4,7,14,0
1.0809243842774258e+18,26,58,2.230769230769231,1,4,26,0
1.0809251517547592e+18,59,549,9.305084745762711,2,12,7,52
1.0809745479747222e+18,2,15,7.5,7,8,1,1
1.0809908439164794e+18,38,259,6.815789473684211,5,8,30,8
1.0809960551060045e+18,11,78,7.090909090909091,6,8,6,5
1.0810059891283492e+18,2,7,3.5,3,4,2,0
1.0810474786092178e+18,4,14,3.5,3,5,4,0
1.0810483261947987e+18,14,41,2.9285714285714284,2,4,14,0
1.0810502187084714e+18,2,4,2.0,1,3,2,0
1.081064678393613e+18,1,2,2.0,2,2,1,0
1.0811258927479852e+18,1,4,4.0,4,4,1,0
1.081126149847348e+18,1,1,1.0,1,1,1,0
1.081130781624062e+18,6,11,1.8333333333333333,1,3,6,0
1.081130798000503e+18,37,328,8.864864864864865,6,12,4,33
1.0812013160504718e+18,8,23,2.875,2,4,8,0
1.0812450831649352e+18,38,189,4.973684210526316,2,7,38,0
1.0812712069672246e+18,84,736,8.761904761904763,4,11,5,79
1.0815463671636045e+18,58,407,7.017241379310345,4,9,39,19
1.0816350545932806e+18,8,56,7.0,5,9,5,3
1.0816570232932169e+18,45,136,3.022222222222222,1,5,45,0
1.081671618060489e+18,57,288,5.052631578947368,4,7,57,0
1.0816737109714547e+18,41,311,7.585365853658536,2,9,16,25
1.0816819891541777e+18,14,108,7.714285714285714,6,9,5,9
1.0816869441637587e+18,20,129,6.45,2,9,15,5
1.0816974263954527e+18,3,20,6.666666666666667,4,8,1,2
1.0816987727109074e+18,7,16,2.2857142857142856,1,5,7,0
1.081725962803694e+18,10,25,2.5,1,3,10,0
1.0817418625404969e+18,52,110,2.1153846153846154,1,4,52,0
1.0817477480553389e+18,1,4,4.0,4,4,1,0
1.0817570771476319e+18,44,392,8.909090909090908,5,12,4,40
1.081777324449254e+18,25,251,10.04,5,12,1,24
1.0817878782883165e+18,2,14,7.0,7,7,2,0
1.0818425994092305e+18,19,38,2.0,1,4,19,0
1.0818534368730611e+18,57,173,3.0350877192982457,1,5,57,0
1.0818538078861076e+18,17,104,6.117647058823529,4,7,17,0
1.081865188850464e+18,10,13,1.3,1,2,10,0
1.0818778587230217e+18,53,116,2.188679245283019,1,5,53,0
1.0818793980191212e+18,4,24,6.0,4,8,3,1
1.0818795853532302e+18,7,46,6.571428571428571,5,8,6,1
1.0818798805369435e+18,3,19,6.333333333333333,6,7,3,0
1.0818800895724221e+18,4,6,1.5,1,2,4,0
1.0818861254162378e+18,42,164,3.9047619047619047,2,7,42,0
1.0819085637662426e+18,34,223,6.5588235294117645,3,8,25,9
1.0819203908106819e+18,8,50,6.25,3,8,6,2
1.0819471954749396e+18,15,35,2.3333333333333335,1,5,15,0
1.0819642263966013e+18,16,33,2.0625,1,4,16,0
1.081980300843766e+18,19,36,1.894736842105263,1,3,19,0
1.0819816335750365e+18,6,9,1.5,1,3,6,0
1.0820068411125668e+18,120,243,2.025,1,5,120,0
1.0823530650625631e+18,14,32,2.2857142857142856,1,4,14,0
1.0823766769022038e+18,5,40,8.0,7,9,2,3
1.0824007650156736e+18,10,68,6.8,5,8,7,3
1.0824183806190751e+18,64,126,1.96875,1,4,64,0
1.0824287892437161e+18,10,72,7.2,2,9,6,4
1.0824338683386758e+18,2,14,7.0,6,8,1,1
1.0824417013420266e+18,11,69,6.2727272727272725,4,8,9,2
1.0824441380744031e+18,17,124,7.294117647058823,5,9,8,9
1.0824788083369454e+18,107,216,2.0186915887850465,1,5,107,0
1.0824940084543763e+18,4,4,1.0,1,1,4,0
1.082495607595501e+18,1,2,2.0,2,2,1,0
1.0824980969838249e+18,1,7,7.0,7,7,1,0
1.0824983101331482e+18,6,8,1.3333333333333333,1,2,6,0
1.0824993848864237e+18,2,13,6.5,6,7,2,0
1.0825003352162278e+18,1,1,1.0,1,1,1,0
1.0825014008627535e+18,106,630,5.943396226415095,4,8,98,8
1.0825116189060332e+18,93,896,9.634408602150538,2,12,2,91
1.0825360050836699e+18,7,7,1.0,1,1,7,0
1.0825376570119078e+18,3,25,8.333333333333334,8,9,0,3
1.082555589375417e+18,87,187,2.1494252873563218,1,5,87,0
1.0826199975344023e+18,32,137,4.28125,2,7,32,0
1.0826504848444044e+18,15,141,9.4,2,11,1,14
1.0826704129931708e+18,21,207,9.857142857142858,5,11,2,19
1.0827236519254982e+18,9,45,5.0,3,7,9,0
1.0828664140036982e+18,13,23,1.7692307692307692,1,4,13,0
1.0830120574951981e+18,29,213,7.344827586206897,2,9,14,15
1.0831187704230106e+18,34,298,8.764705882352942,2,12,4,30
1.0831326403444684e+18,65,445,6.846153846153846,3,9,52,13
1.0833196335523395e+18,40,353,8.825,3,11,5,35
1.0833196760470286e+18,6,61,10.166666666666666,9,12,0,6
1.0833666588920182e+18,47,418,8.893617021276595,3,11,7,40
1.0834132413374505e+18,3,5,1.6666666666666667,1,3,3,0
1.0834325338760965e+18,2,6,3.0,3,3,2,0
1.0834352081393262e+18,3,4,1.3333333333333333,1,2,3,0
1.0834629188674442e+18,23,69,3.0,1,4,23,0
1.0838388166533434e+18,25,245,9.8,5,12,1,24
1.0838777957034122e+18,29,142,4.896551724137931,2,7,29,0
1.0840125499667625e+18,18,91,5.055555555555555,3,7,18,0
1.0840546922788799e+18,47,448,9.53191489361702,3,13,4,43
1.0840750844799694e+18,6,14,2.3333333333333335,1,3,6,0
1.084195573075929e+18,4,34,8.5,7,9,1,3
1.0845227661557303e+18,29,200,6.896551724137931,3,9,19,10
1.0845475553555075e+18,6,51,8.5,6,9,1,5
1.0845510762572741e+18,21,82,3.9047619047619047,2,5,21,0
1.0845849824064433e+18,46,448,9.73913043478261,3,12,2,44
1.0846283908966458e+18,21,210,10.0,8,12,0,21
1.0846284848323479e+18,8,58,7.25,6,8,5,3
1.0846289605760365e+18,10,19,1.9,1,3,10,0
1.0846358098755749e+18,27,225,8.333333333333334,2,11,4,23
1.084664144703209e+18,24,123,5.125,3,7,24,0
1.0846660393083203e+18,35,168,4.8,2,7,35,0
1.0846665563137536e+18,17,34,2.0,1,3,17,0
1.0846805036636788e+18,47,322,6.851063829787234,4,9,33,14
1.0846809650446244e+18,34,130,3.823529411764706,2,6,34,0
1.0846994800094257e+18,1,6,6.0,6,6,1,0
1.0847076598128326e+18,109,1050,9.63302752293578,2,13,5,104
1.0847324589551137e+18,2,16,8.0,7,9,1,1
1.0847324856890927e+18,5,34,6.8,5,8,4,1
1.08473252084526e+18,6,48,8.0,4,10,2,4
1.0847325637265143e+18,6,43,7.166666666666667,5,9,4,2
1.0847326388297673e+18,4,33,8.25,8,9,0,4
1.084732664501762e+18,12,86,7.166666666666667,4,9,7,5
1.084732785414543e+18,22,154,7.0,5,10,14,8
1.0847331979463448e+18,1,7,7.0,7,7,1,0
1.0847331979498907e+18,3,11,3.6666666666666665,3,4,3,0
1.0847332526256312e+18,40,267,6.675,4,9,29,11
1.0847332539249507e+18,10,59,5.9,4,7,10,0
1.0847332607621372e+18,11,73,6.636363636363637,6,9,10,1
1.0847332877877321e+18,4,27,6.75,4,8,2,2
1.0847333111705361e+18,2,12,6.0,5,7,2,0
1.0847334935066778e+18,2,14,7.0,7,7,2,0
1.0847334952788644e+18,2,14,7.0,7,7,2,0
1.0847335018454683e+18,2,18,9.0,8,10,0,2
1.084740516715944e+18,7,58,8.285714285714286,7,9,1,6
1.0847444154138853e+18,9,39,4.333333333333333,3,6,9,0
1.0847661431525564e+18,6,33,5.5,4,7,6,0
1.0848064446338086e+18,1,2,2.0,2,2,1,0
1.0848088303434353e+18,45,378,8.4,3,11,8,37
1.0848252167786726e+18,22,107,4.863636363636363,4,6,22,0
1.0848285410900365e+18,9,36,4.0,2,6,9,0
1.0848378760804375e+18,24,237,9.875,5,13,2,22
1.0848400303195439e+18,13,69,5.3076923076923075,3,7,13,0
1.0848627187636589e+18,19,82,4.315789473684211,3,6,19,0
1.0848688554093606e+18,22,106,4.818181818181818,3,7,22,0
1.0848735454511494e+18,12,45,3.75,2,6,12,0
1.0848828319456913e+18,8,33,4.125,3,6,8,0
1.084887394213172e+18,5,31,6.2,5,7,5,0
1.0848903519531089e+18,52,360,6.923076923076923,3,10,35,17
1.0848918780957944e+18,15,74,4.933333333333334,3,7,15,0
1.0848924488687085e+18,23,157,6.826086956521739,5,9,20,3
1.0852505326496859e+18,15,159,10.6,8,12,0,15
1.0852771230139844e+18,8,43,5.375,5,6,8,0
1.0852880814537696e+18,1,3,3.0,3,3,1,0
1.0852932438012041e+18,23,168,7.304347826086956,6,9,12,11
1.0853018451902079e+18,3,8,2.6666666666666665,2,3,3,0
1.0853028546439572e+18,10,39,3.9,2,7,10,0
1.0853045071756704e+18,64,444,6.9375,3,10,42,22
1.085350848975682e+18,1,6,6.0,6,6,1,0
1.0853694370075712e+18,15,39,2.6,1,4,15,0
1.0853862990234413e+18,38,179,4.7105263157894735,2,7,38,0
1.0853865647840731e+18,4,10,2.5,1,4,4,0
1.0853965593867876e+18,21,43,2.0476190476190474,1,4,21,0
1.08542002874242e+18,5,32,6.4,5,8,4,1
1.0854211763451374e+18,20,90,4.5,3,6,20,0
1.0854324659078822e+18,11,41,3.727272727272727,2,5,11,0
1.0854329283888358e+18,39,367,9.41025641025641,3,12,1,38
1.0854329842504364e+18,8,66,8.25,7,10,3,5
1.085438990256696e+18,28,193,6.892857142857143,3,10,22,6
1.0854650351799224e+18,1,2,2.0,2,2,1,0
1.0854651130831852e+18,22,145,6.590909090909091,2,9,18,4
1.0854676505939764e+18,79,376,4.7594936708860756,2,8,78,1
1.0854900857003941e+18,11,23,2.090909090909091,1,4,11,0
1.0854972443955107e+18,14,138,9.857142857142858,8,12,0,14
1.0854991720033815e+18,58,393,6.775862068965517,5,9,48,10
1.0855101119655228e+18,10,17,1.7,1,3,10,0
1.0855295875688207e+18,47,233,4.957446808510638,3,8,46,1
1.0855531096952928e+18,25,53,2.12,1,3,25,0
1.0855737345924134e+18,17,31,1.8235294117647058,1,4,17,0
1.0855742912757313e+18,47,458,9.74468085106383,3,12,2,45
1.0856231621722417e+18,22,190,8.636363636363637,4,10,2,20
1.0857059638316896e+18,8,58,7.25,5,9,5,3
1.085953031553214e+18,8,52,6.5,5,7,8,0
1.085960661280685e+18,4,7,1.75,1,3,4,0
1.085966365680369e+18,16,163,10.1875,9,12,0,16
1.0859707989917047e+18,15,120,8.0,4,10,3,12
1.0860058192876768e+18,17,38,2.235294117647059,1,4,17,0
1.0860130257372389e+18,24,58,2.4166666666666665,1,4,24,0
1.0860426962785393e+18,112,1090,9.732142857142858,2,12,8,104
1.0860664412281756e+18,58,304,5.241379310344827,3,7,58,0
1.0860667949665089e+18,26,182,7.0,5,10,20,6
1.0860689380728124e+18,52,162,3.1153846153846154,1,6,52,0
1.086096878664501e+18,1,3,3.0,3,3,1,0
1.0861323787959421e+18,11,108,9.818181818181818,6,12,1,10
1.0861521370275517e+18,5,6,1.2,1,2,5,0
1.0861702560787681e+18,23,39,1.6956521739130435,1,4,23,0
1.0862226351911521e+18,69,347,5.028985507246377,3,7,69,0
1.0862442457496056e+18,8,14,1.75,1,4,8,0
1.0862507431741536e+18,5,25,5.0,4,6,5,0
1.0862538210038413e+18,1,7,7.0,7,7,1,0
1.0862801114461226e+18,14,27,1.9285714285714286,1,5,14,0
1.0863285900482199e+18,54,165,3.0555555555555554,1,6,54,0
1.0863313205646184e+18,1,7,7.0,7,7,1,0
1.0863990928668666e+18,10,50,5.0,4,8,9,1
1.0864120539171539e+18,4,9,2.25,1,3,4,0
1.0866562441376006e+18,10,67,6.7,5,9,8,2
1.0867049141845046e+18,5,16,3.2,3,4,5,0
1.0867103311317158e+18,3,23,7.666666666666667,7,9,2,1
1.08672964483108e+18,69,347,5.028985507246377,2,8,67,2
1.0867350292589055e+18,14,29,2.0714285714285716,1,5,14,0
1.0867459886048232e+18,27,66,2.4444444444444446,1,5,27,0
1.0867468310035118e+18,29,63,2.1724137931034484,1,5,29,0
1.0867609940017988e+18,47,323,6.872340425531915,4,9,32,15
1.0867691347074149e+18,40,259,6.475,2,9,29,11
1.0867821384770166e+18,69,605,8.768115942028986,2,11,8,61
1.0867949582498355e+18,10,75,7.5,6,9,5,5
1.0868188771473253e+18,2,19,9.5,8,11,0,2
1.086819958588022e+18,12,22,1.8333333333333333,1,4,12,0
1.0868259709120755e+18,25,106,4.24,2,6,25,0
1.0868439896271091e+18,25,74,2.96,1,5,25,0
1.0868542311335508e+18,5,17,3.4,3,4,5,0
1.0869051735278387e+18,2,5,2.5,2,3,2,0
1.0869372486551478e+18,7,15,2.142857142857143,1,3,7,0
1.086947424967305e+18,10,25,2.5,1,4,10,0
1.0869794172981119e+18,4,5,1.25,1,2,4,0
1.0869798056512303e+18,7,12,1.7142857142857142,1,3,7,0
1.0869843654394255e+18,1,3,3.0,3,3,1,0
1.0869985862876266e+18,9,15,1.6666666666666667,1,3,9,0
1.0870032779952844e+18,7,12,1.7142857142857142,1,3,7,0
1.0870069343933047e+18,5,10,2.0,2,2,5,0
1.087064263791724e+18,38,67,1.763157894736842,1,3,38,0
1.0870914331219689e+18,74,508,6.864864864864865,4,9,53,21
1.0871032198999352e+18,29,230,7.931034482758621,5,10,6,23
1.0871354558222842e+18,2,15,7.5,7,8,1,1
1.0873919693541921e+18,42,215,5.119047619047619,3,7,42,0
1.0874415962326609e+18,46,459,9.978260869565217,5,12,2,44
1.0874751302679354e+18,13,84,6.461538461538462,5,8,12,1
1.0874795972529627e+18,1,2,2.0,2,2,1,0
1.0874847504636657e+18,7,43,6.142857142857143,2,8,6,1
1.0875027859563181e+18,16,108,6.75,2,9,11,5
1.0875070752234966e+18,14,32,2.2857142857142856,1,4,14,0
1.0875160063251087e+18,16,123,7.6875,2,10,5,11
1.0875174706868443e+18,90,864,9.6,2,12,7,83
1.0875264219857197e+18,4,27,6.75,6,7,4,0
1.0875289410673842e+18,46,225,4.891304347826087,2,7,46,0
1.0875309910145482e+18,24,40,1.6666666666666667,1,3,24,0
1.0875424315259274e+18,35,348,9.942857142857143,6,12,1,34
1.087551144671789e+18,62,596,9.612903225806452,3,13,4,58
1.0876094633207131e+18,1,9,9.0,9,9,0,1
1.087621162827683e+18,2,4,2.0,1,3,2,0
1.087624067049893e+18,4,34,8.5,8,9,0,4
1.0876721063074601e+18,12,25,2.0833333333333335,1,4,12,0
1.0876817655767484e+18,29,58,2.0,1,4,29,0
1.0876842825333463e+18,18,91,5.055555555555555,4,7,18,0
1.0876853898078611e+18,12,88,7.333333333333333,3,9,4,8
1.0877009813971771e+18,23,51,2.217391304347826,1,4,23,0
1.0877097094103736e+18,32,285,8.90625,5,11,4,28
1.0877157661609254e+18,39,381,9.76923076923077,2,12,4,35
1.0877226905117311e+18,13,64,4.923076923076923,4,6,13,0
1.0877331882983479e+18,61,137,2.2459016393442623,1,4,61,0
1.0881527441193407e+18,17,83,4.882352941176471,3,6,17,0
1.0882602078349565e+18,38,196,5.157894736842105,3,7,38,0
1.0883475356112228e+18,11,112,10.181818181818182,8,11,0,11
1.0884236966885494e+18,29,236,8.137931034482758,6,10,9,20
1.0884817181876966e+18,22,106,4.818181818181818,3,7,22,0
1.0885396805387366e+18,16,105,6.5625,2,8,11,5
1.0886376100496573e+18,31,291,9.387096774193548,3,12,3,28
1.0888929402182003e+18,13,66,5.076923076923077,3,7,13,0
1.088937310072654e+18,35,324,9.257142857142858,2,12,4,31
1.0889528330610948e+18,26,259,9.961538461538462,7,12,1,25
1.088995265949802e+18,4,7,1.75,1,2,4,0
1.0890387870797766e+18,10,103,10.3,8,13,0,10
1.0891577822325486e+18,26,54,2.076923076923077,1,3,26,0
1.0891636519671382e+18,31,120,3.870967741935484,2,6,31,0
1.0891813756398822e+18,28,52,1.8571428571428572,1,3,28,0
1.0891840078665002e+18,1,2,2.0,2,2,1,0
1.0892102046709265e+18,10,66,6.6,4,8,7,3
1.0892193010828572e+18,30,147,4.9,3,6,30,0
1.0896570235836782e+18,18,85,4.722222222222222,4,7,18,0
1.0896702373363043e+18,9,17,1.8888888888888888,1,3,9,0
1.0896781519085347e+18,9,87,9.666666666666666,9,10,0,9
1.0896975383854034e+18,10,67,6.7,4,9,7,3
1.0897169441784902e+18,49,395,8.061224489795919,2,12,11,38
1.0897222312261188e+18,13,121,9.307692307692308,8,10,0,13
1.089730167264854e+18,24,152,6.333333333333333,3,8,20,4
1.0897346295859739e+18,2,2,1.0,1,1,2,0
1.0897415601737171e+18,4,14,3.5,3,4,4,0
1.0897431009157011e+18,63,559,8.873015873015873,2,11,4,59
1.0897473271485804e+18,75,527,7.026666666666666,5,9,55,20
1.0897675803849439e+18,84,727,8.654761904761905,2,11,11,73
1.0898499630226963e+18,2,4,2.0,1,3,2,0
1.0898626710991881e+18,22,194,8.818181818181818,3,11,2,20
1.0899629654744472e+18,81,404,4.987654320987654,3,7,81,0
1.0899831923484416e+18,3,7,2.3333333333333335,1,4,3,0
1.0899926170319284e+18,8,27,3.375,2,5,8,0
1.0900197075603058e+18,22,208,9.454545454545455,2,11,1,21
1.0900285559404376e+18,19,182,9.578947368421053,3,11,1,18
1.0902659132908882e+18,7,55,7.857142857142857,7,9,3,4
1.0903275785346045e+18,3,23,7.666666666666667,7,9,2,1
1.0903276740736014e+18,3,18,6.0,6,6,3,0
1.0903277190934747e+18,2,16,8.0,8,8,0,2
1.090327835331317e+18,5,19,3.8,3,5,5,0
1.0903278908850483e+18,9,67,7.444444444444445,6,9,6,3
1.0903279824697618e+18,14,95,6.785714285714286,3,9,9,5
1.0903280447084847e+18,6,45,7.5,7,8,3,3
1.0903699660959985e+18,35,350,10.0,5,13,2,33
1.0903726473471459e+18,27,189,7.0,3,10,19,8
1.0903851801857734e+18,80,764,9.55,2,12,5,75
1.0903899796945065e+18,10,22,2.2,1,4,10,0
1.0904029204743178e+18,2,5,2.5,2,3,2,0
1.0904081199346122e+18,2,2,1.0,1,1,2,0
1.0904109003772612e+18,27,176,6.518518518518518,5,8,23,4
1.0904260959654611e+18,2,5,2.5,2,3,2,0
1.0904268604453518e+18,1,10,10.0,10,10,0,1
1.0904349096377985e+18,35,246,7.0285714285714285,3,9,21,14
1.0904532045127859e+18,10,48,4.8,3,7,10,0
1.090464226348144e+18,24,164,6.833333333333333,4,9,20,4
1.0904845749734692e+18,4,29,7.25,6,8,2,2
1.0904956139680338e+18,88,836,9.5,3,12,4,84
1.090521538525781e+18,19,136,7.157894736842105,6,10,14,5
1.0905252558882939e+18,8,26,3.25,2,5,8,0
1.0906041643413203e+18,40,393,9.825,7,13,3,37
1.0906803814432481e+18,1,5,5.0,5,5,1,0
1.0906949114469061e+18,54,365,6.7592592592592595,4,9,39,15
1.0907445016770111e+18,1,1,1.0,1,1,1,0
1.0907643473281331e+18,20,125,6.25,5,9,18,2
1.090780070751188e+18,2,12,6.0,6,6,2,0
1.0907874342153061e+18,31,179,5.774193548387097,3,8,29,2
1.0909847808762538e+18,3,5,1.6666666666666667,1,2,3,0
1.0910188589886435e+18,1,5,5.0,5,5,1,0
1.0910480216678423e+18,23,162,7.043478260869565,5,10,15,8
1.0910517366345199e+18,8,40,5.0,4,7,8,0
1.0910537740652744e+18,9,88,9.777777777777779,9,12,0,9
1.0910748198398879e+18,28,56,2.0,1,4,28,0
1.0910780206559999e+18,9,42,4.666666666666667,3,7,9,0
1.091090069515005e+18,27,183,6.777777777777778,2,9,18,9
1.0911128748978839e+18,20,133,6.65,2,10,14,6
1.0911145877266674e+18,8,52,6.5,5,8,7,1
1.0911342666534464e+18,3,5,1.6666666666666667,1,2,3,0
1.0911396107252006e+18,8,21,2.625,1,4,8,0
1.0911459517633213e+18,26,251,9.653846153846153,4,13,4,22
1.091187031953018e+18,32,166,5.1875,2,7,32,0
1.0912139436817298e+18,25,49,1.96,1,3,25,0
1.0912141233904465e+18,15,77,5.133333333333334,4,7,15,0
1.0912556031801957e+18,21,39,1.8571428571428572,1,4,21,0
1.0912673126576705e+18,1,8,8.0,8,8,0,1
1.0913213735494643e+18,5,24,4.8,3,6,5,0
1.0913384871955304e+18,80,695,8.6875,3,12,10,70
1.0914203786658294e+18,33,264,8.0,3,10,8,25
1.0914214636748041e+18,31,152,4.903225806451613,2,7,31,0
1.0914215951033446e+18,22,109,4.954545454545454,2,7,22,0
1.0914219188429029e+18,32,155,4.84375,3,7,32,0
1.0914223114460765e+18,31,155,5.0,3,7,31,0
1.0914224501305019e+18,20,100,5.0,2,7,20,0
1.0914225696387953e+18,26,131,5.038461538461538,2,7,26,0
1.091422724890744e+18,24,126,5.25,3,7,24,0
1.0914229634249983e+18,31,150,4.838709677419355,3,7,31,0
1.0914231166874842e+18,38,193,5.078947368421052,3,7,38,0
1.0914336132436227e+18,11,22,2.0,1,3,11,0
1.091748092041152e+18,19,183,9.631578947368421,2,13,1,18
1.0917691323726003e+18,43,213,4.953488372093023,2,8,42,1
1.0917749905878926e+18,14,124,8.857142857142858,7,11,2,12
1.091784272592938e+18,3,10,3.3333333333333335,3,4,3,0
1.0918459644614277e+18,24,212,8.833333333333334,4,11,2,22
1.0918683054650547e+18,21,48,2.2857142857142856,1,4,21,0
1.0918829265371448e+18,13,53,4.076923076923077,2,7,13,0
1.0919194181018271e+18,1,8,8.0,8,8,0,1
1.0919939317309669e+18,5,29,5.8,5,6,5,0
1.0920045992626e+18,13,23,1.7692307692307692,1,3,13,0
1.0920102779230132e+18,5,11,2.2,1,4,5,0
1.092018293416455e+18,96,468,4.875,2,7,96,0
1.0920187404497825e+18,3,19,6.333333333333333,6,7,3,0
1.0920287112304868e+18,36,48,1.3333333333333333,1,3,36,0
1.0920731288818486e+18,48,276,5.75,3,9,46,2
1.0920797335197878e+18,5,8,1.6,1,3,5,0
1.0921547303630196e+18,6,59,9.833333333333334,9,10,0,6
1.0921667396039784e+18,20,193,9.65,5,12,2,18
1.0921841823394967e+18,4,6,1.5,1,3,4,0
1.0922445423130886e+18,1,3,3.0,3,3,1,0
1.0922529668791689e+18,3,5,1.6666666666666667,1,3,3,0
1.09256187461105e+18,44,167,3.7954545454545454,2,6,44,0
1.0925754904308262e+18,35,48,1.3714285714285714,1,3,35,0
1.092575707702266e+18,1,3,3.0,3,3,1,0
1.0925768221350708e+18,2,3,1.5,1,2,2,0
1.092578085828809e+18,25,130,5.2,3,7,25,0
1.0925854333295387e+18,9,48,5.333333333333333,4,6,9,0
1.0926060295706555e+18,1,8,8.0,8,8,0,1
1.0926353550596724e+18,3,19,6.333333333333333,3,8,1,2
1.092636268282644e+18,17,86,5.0588235294117645,3,7,17,0
1.0926468041339956e+18,15,126,8.4,7,10,2,13
1.0926983216338867e+18,5,53,10.6,10,11,0,5
1.0927193646989971e+18,9,67,7.444444444444445,6,8,4,5
1.0927338028867607e+18,56,274,4.892857142857143,3,8,55,1
1.0927799157476393e+18,22,145,6.590909090909091,5,8,18,4
1.0928050753835656e+18,69,599,8.681159420289855,3,12,6,63
1.092809730171604e+18,13,85,6.538461538461538,5,8,12,1
1.0928125683807282e+18,5,15,3.0,2,4,5,0
1.092858999049476e+18,6,50,8.333333333333334,5,10,1,5
1.092899185717326e+18,8,41,5.125,3,6,8,0
1.0929647930573885e+18,10,20,2.0,1,3,10,0
1.0932661159077676e+18,1,5,5.0,5,5,1,0
1.093296025034806e+18,8,22,2.75,2,5,8,0
1.0933682987637143e+18,4,28,7.0,6,8,3,1
1.0934504161544978e+18,55,533,9.690909090909091,2,13,3,52
1.0934601722689236e+18,10,82,8.2,6,10,2,8
1.0935291094465637e+18,15,76,5.066666666666666,2,7,15,0
1.0935493112055021e+18,67,123,1.835820895522388,1,4,67,0
1.0935685884317632e+18,19,124,6.526315789473684,3,10,16,3
1.093589635881511e+18,9,12,1.3333333333333333,1,2,9,0
1.09360879329141e+18,37,298,8.054054054054054,2,11,11,26
1.0939234556862868e+18,24,124,5.166666666666667,3,8,22,2
1.0939343690177134e+18,17,170,10.0,4,12,1,16
1.0939602426858756e+18,8,50,6.25,2,8,6,2
1.0940272528658621e+18,25,166,6.64,2,9,17,8
1.0940899347287395e+18,41,411,10.024390243902438,8,13,0,41
1.0941176187694998e+18,2,5,2.5,1,4,2,0
1.0941328021272977e+18,22,220,10.0,8,12,0,22
1.0941602270680251e+18,6,17,2.8333333333333335,1,4,6,0
1.0941744597559825e+18,31,151,4.870967741935484,3,7,31,0
1.0942188483820685e+18,1,2,2.0,2,2,1,0
1.0942591882953245e+18,2,3,1.5,1,2,2,0
1.0942638902879012e+18,3,21,7.0,6,8,2,1
1.0942728742695904e+18,31,216,6.967741935483871,2,9,21,10
1.0942765335733138e+18,32,161,5.03125,3,7,32,0
1.0942865867786642e+18,5,38,7.6,6,9,2,3
1.0942922153528193e+18,38,208,5.473684210526316,2,8,36,2
1.0943305315141101e+18,47,280,5.957446808510638,2,8,44,3
1.0943516566688792e+18,52,254,4.884615384615385,2,7,52,0
1.0946625610096755e+18,54,121,2.240740740740741,1,5,54,0
1.0946700253123277e+18,24,51,2.125,1,4,24,0
1.094672342270964e+18,26,59,2.269230769230769,1,4,26,0
1.0946803710567347e+18,5,36,7.2,5,10,3,2
1.0947047401587798e+18,21,106,5.0476190476190474,2,7,21,0
1.0947138654500352e+18,58,562,9.689655172413794,2,12,5,53
1.0947285054068562e+18,7,12,1.7142857142857142,1,2,7,0
1.0947541717723624e+18,3,20,6.666666666666667,6,7,3,0
1.0947581883456632e+18,6,53,8.833333333333334,8,10,0,6
1.0947605936104032e+18,16,121,7.5625,4,9,7,9
1.0947745933744947e+18,12,101,8.416666666666666,6,10,2,10
1.094792750432254e+18,62,438,7.064516129032258,2,9,35,27
1.094798967085431e+18,8,19,2.375,1,3,8,0
1.094822221519876e+18,16,158,9.875,8,12,0,16
1.094822417146247e+18,22,68,3.090909090909091,1,4,22,0
1.0948267678213367e+18,4,27,6.75,6,7,4,0
1.0948761912526072e+18,56,385,6.875,4,9,41,15
1.0948909312399364e+18,7,34,4.857142857142857,3,6,7,0
1.0949002628659841e+18,18,96,5.333333333333333,3,7,18,0
1.094911209241042e+18,31,156,5.032258064516129,2,8,30,1
1.0949113725649001e+18,19,76,4.0,3,5,19,0
1.0949173081911402e+18,34,172,5.0588235294117645,3,7,34,0
1.0949266629781079e+18,10,20,2.0,1,4,10,0
1.094933484152971e+18,39,190,4.871794871794871,3,6,39,0
1.0949678188484026e+18,1,8,8.0,8,8,0,1
1.095002095033295e+18,30,284,9.466666666666667,4,11,2,28
1.0951036830909443e+18,108,520,4.814814814814815,2,8,107,1
1.0952786118155837e+18,2,9,4.5,2,7,2,0
1.0953769561022627e+18,2,16,8.0,8,8,0,2
1.0953860060295172e+18,2,16,8.0,8,8,0,2
1.0953862166667722e+18,2,6,3.0,1,5,2,0
1.0954033522690906e+18,4,8,2.0,1,3,4,0
1.0954095802486688e+18,1,3,3.0,3,3,1,0
1.0954204997343181e+18,16,36,2.25,1,4,16,0
1.0954451054549299e+18,6,11,1.8333333333333333,1,3,6,0
1.095464554271731e+18,5,43,8.6,7,11,2,3
1.0954853837306894e+18,56,171,3.0535714285714284,1,5,56,0
1.0955667607459837e+18,12,76,6.333333333333333,4,8,9,3
1.0955764303128252e+18,1,3,3.0,3,3,1,0
1.0955856623825513e+18,1,8,8.0,8,8,0,1
1.0955955194141793e+18,12,20,1.6666666666666667,1,3,12,0
1.095598270292304e+18,1,5,5.0,5,5,1,0
1.0955993364156319e+18,2,2,1.0,1,1,2,0
1.0956271035845503e+18,5,42,8.4,7,9,1,4
1.0956429435366632e+18,20,48,2.4,1,4,20,0
1.0956492187530701e+18,5,9,1.8,1,2,5,0
1.0956497976747716e+18,3,3,1.0,1,1,3,0
1.0956579285452442e+18,14,19,1.3571428571428572,1,3,14,0
1.095685105446145e+18,4,8,2.0,1,3,4,0
1.0957288504970592e+18,60,530,8.833333333333334,6,11,4,56
1.095736015577429e+18,31,245,7.903225806451613,3,10,9,22
1.0957397915355785e+18,8,50,6.25,5,7,8,0
1.0957679232977636e+18,3,11,3.6666666666666665,3,4,3,0
1.0957779174508605e+18,2,5,2.5,2,3,2,0
1.0957822608260041e+18,2,15,7.5,7,8,1,1
1.0961488779135101e+18,11,74,6.7272727272727275,3,9,8,3
1.0961506140208052e+18,14,102,7.285714285714286,6,9,8,6
1.0961532725816937e+18,29,207,7.137931034482759,4,9,17,12
1.0961677262965244e+18,8,67,8.375,7,11,3,5
1.0961881107291933e+18,3,5,1.6666666666666667,1,3,3,0
1.0961941519855846e+18,25,59,2.36,1,4,25,0
1.0962001885646866e+18,10,22,2.2,1,4,10,0
1.0962075702473179e+18,7,14,2.0,1,4,7,0
1.0962198417746404e+18,7,24,3.4285714285714284,2,5,7,0
1.0962231084674111e+18,10,13,1.3,1,3,10,0
1.0962390633843418e+18,1,4,4.0,4,4,1,0
1.0962440632925432e+18,52,258,4.961538461538462,2,8,51,1
1.0962455531336595e+18,55,217,3.9454545454545453,2,7,55,0
1.0962461360112786e+18,5,34,6.8,6,7,5,0
1.0962467344256387e+18,12,89,7.416666666666667,4,9,5,7
1.09624881767226e+18,2,13,6.5,6,7,2,0
1.0962510555445884e+18,1,4,4.0,4,4,1,0
1.0962595363858508e+18,19,46,2.4210526315789473,1,5,19,0
1.0962828710247853e+18,56,124,2.2142857142857144,1,4,56,0
1.0963067322417102e+18,32,57,1.78125,1,4,32,0
1.096311798373926e+18,26,124,4.769230769230769,2,7,26,0
1.0963141144096407e+18,56,178,3.1785714285714284,1,6,56,0
1.0963626027048566e+18,3,26,8.666666666666666,6,10,1,2
1.0964304581459557e+18,6,46,7.666666666666667,6,9,2,4
1.0964436518482089e+18,5,25,5.0,4,6,5,0
1.0968519423700892e+18,39,88,2.2564102564102564,1,4,39,0
1.0968536963200502e+18,40,388,9.7,4,12,1,39
1.0968692656920109e+18,13,84,6.461538461538462,4,8,11,2
1.0968735705479731e+18,33,161,4.878787878787879,2,7,33,0
1.0968871998147706e+18,62,316,5.096774193548387,2,8,61,1
1.0968923315720753e+18,2,10,5.0,4,6,2,0
1.0969166014935565e+18,16,160,10.0,3,13,1,15
1.0969547480336995e+18,2,16,8.0,7,9,1,1
1.096985108919502e+18,37,287,7.756756756756757,3,11,14,23
1.0969882527830523e+18,2,16,8.0,7,9,1,1
1.0969918271283665e+18,6,58,9.666666666666666,9,11,0,6
1.097009863303343e+18,4,23,5.75,5,6,4,0
1.0970257344793435e+18,28,60,2.142857142857143,1,5,28,0
1.0970375969067886e+18,22,105,4.7727272727272725,3,6,22,0
1.0970424701258115e+18,52,363,6.980769230769231,2,10,33,19
1.0970568492986074e+18,10,23,2.3,1,4,10,0
1.0970591516036547e+18,55,120,2.1818181818181817,1,5,55,0
1.0970695917790637e+18,57,292,5.12280701754386,3,7,57,0
1.0970720890624876e+18,13,70,5.384615384615385,4,6,13,0
1.097073695230268e+18,73,374,5.123287671232877,3,7,73,0
1.0970847714975208e+18,58,136,2.3448275862068964,1,4,58,0
1.097109149539352e+18,17,107,6.294117647058823,2,9,13,4
1.0971166908834437e+18,6,26,4.333333333333333,3,5,6,0
1.0971225980194788e+18,146,876,6.0,3,9,134,12
1.0971831088656737e+18,21,206,9.80952380952381,5,11,1,20
1.0972107168699379e+18,1,2,2.0,2,2,1,0
1.0973873212378947e+18,2,13,6.5,6,7,2,0
1.0975515787715708e+18,35,196,5.6,3,7,35,0
1.097555397660197e+18,16,74,4.625,3,6,16,0
1.097586561423944e+18,30,124,4.133333333333334,2,6,30,0
1.0976118267313138e+18,11,77,7.0,5,9,9,2
1.097612661051521e+18,3,18,6.0,5,7,3,0
1.0976144434794738e+18,19,41,2.1578947368421053,1,3,19,0
1.097615498104178e+18,43,89,2.0697674418604652,1,4,43,0
1.0976345763216724e+18,2,5,2.5,2,3,2,0
1.0976368020096904e+18,10,38,3.8,2,6,10,0
1.0976405062258863e+18,2,13,6.5,6,7,2,0
1.097644536066543e+18,1,7,7.0,7,7,1,0
1.0976488234899711e+18,12,91,7.583333333333333,3,10,4,8
1.097663870766729e+18,12,51,4.25,3,5,12,0
1.0976654356716996e+18,1,2,2.0,2,2,1,0
1.0976673157716915e+18,57,564,9.894736842105264,3,13,2,55
1.0976723736840156e+18,19,120,6.315789473684211,4,9,16,3
1.0976768536952684e+18,1,8,8.0,8,8,0,1
1.0976812354087604e+18,6,11,1.8333333333333333,1,3,6,0
1.0976898391619013e+18,1,3,3.0,3,3,1,0
1.0976993794581143e+18,4,10,2.5,2,3,4,0
1.0976993900814387e+18,3,4,1.3333333333333333,1,2,3,0
1.097702395776035e+18,1,8,8.0,8,8,0,1
1.0977024058230844e+18,6,12,2.0,1,3,6,0
1.0977148720274643e+18,1,1,1.0,1,1,1,0
1.097725397198069e+18,7,21,3.0,2,5,7,0
1.0977296517687494e+18,4,8,2.0,1,3,4,0
1.0977354559917418e+18,2,16,8.0,8,8,0,2
1.0977362864598163e+18,5,9,1.8,1,3,5,0
1.0977368255390952e+18,5,11,2.2,1,4,5,0
1.0977370748356102e+18,5,15,3.0,2,4,5,0
1.0977373471045057e+18,5,34,6.8,2,9,3,2
1.0977782901209565e+18,1,8,8.0,8,8,0,1
1.0977881230663398e+18,5,14,2.8,2,4,5,0
1.0977886445293388e+18,4,11,2.75,2,3,4,0
1.0978142082463096e+18,11,89,8.090909090909092,5,10,3,8
1.0978184080753874e+18,75,533,7.1066666666666665,4,9,47,28
1.0978295399884806e+18,40,264,6.6,2,9,32,8
1.0981804770244091e+18,3,3,1.0,1,1,3,0
1.0982708409229856e+18,1,1,1.0,1,1,1,0
1.0984615786996698e+18,3,31,10.333333333333334,10,11,0,3
1.0985770765187341e+18,24,125,5.208333333333333,4,7,24,0
1.0986630829342433e+18,5,36,7.2,6,9,3,2
1.0986890059656425e+18,49,236,4.816326530612245,2,7,49,0
1.0987177425471823e+18,16,52,3.25,2,6,16,0
1.0987655817370473e+18,16,80,5.0,2,7,16,0
1.0991057441898545e+18,36,78,2.1666666666666665,1,4,36,0
1.0991946368458125e+18,31,285,9.193548387096774,2,12,2,29
1.0992035676675026e+18,6,30,5.0,3,7,6,0
1.0992648969280502e+18,1,3,3.0,3,3,1,0
1.0993165639207334e+18,16,73,4.5625,2,6,16,0
1.0993813259236285e+18,54,160,2.962962962962963,1,6,54,0
1.0993885195275041e+18,5,29,5.8,4,7,5,0
1.0997165048294726e+18,2,21,10.5,10,11,0,2
1.099746366180303e+18,18,88,4.888888888888889,2,7,18,0
1.0997513690747621e+18,63,597,9.476190476190476,2,12,5,58
1.099768030787292e+18,3,19,6.333333333333333,5,7,3,0
1.0997684353356603e+18,4,28,7.0,5,8,2,2
1.0997693938319258e+18,23,166,7.217391304347826,4,9,10,13
1.0998617371631852e+18,40,82,2.05,1,4,40,0
1.099871044055168e+18,3,12,4.0,4,4,3,0
1.099943626455437e+18,2,6,3.0,3,3,2,0
1.0999500607145951e+18,39,93,2.3846153846153846,1,4,39,0
1.099977637296359e+18,65,321,4.938461538461539,2,7,65,0
1.0999928900342694e+18,1,3,3.0,3,3,1,0
1.1000509203001446e+18,65,131,2.0153846153846153,1,4,65,0
1.1001338605883999e+18,18,93,5.166666666666667,4,6,18,0
1.1004494449052013e+18,4,18,4.5,3,6,4,0
1.1004853953059085e+18,37,150,4.054054054054054,2,6,37,0
1.1004909600920739e+18,2,14,7.0,7,7,2,0
1.1005201340442458e+18,38,250,6.578947368421052,2,9,33,5
1.1005302422677171e+18,17,126,7.411764705882353,2,10,6,11
1.1005454835162171e+18,5,38,7.6,7,8,2,3
1.1005578597399904e+18,10,63,6.3,4,8,9,1
1.1005777091931914e+18,45,234,5.2,3,7,45,0
1.1005845923387287e+18,8,69,8.625,6,10,1,7
1.1005911118726103e+18,38,233,6.131578947368421,4,9,35,3
1.1005937949328184e+18,1,6,6.0,6,6,1,0
1.1006458233331686e+18,4,11,2.75,1,4,4,0
1.100718671223582e+18,36,76,2.111111111111111,1,4,36,0
1.1007429482356876e+18,34,336,9.882352941176471,7,12,1,33
1.1007490539076119e+18,13,27,2.076923076923077,1,4,13,0
1.1007798017009229e+18,39,286,7.333333333333333,5,10,23,16
1.1008285673987877e+18,122,852,6.983606557377049,2,9,81,41
1.1008654564669462e+18,1,8,8.0,8,8,0,1
1.100876376900215e+18,2,11,5.5,5,6,2,0
1.1009021486350966e+18,7,16,2.2857142857142856,1,3,7,0
1.1009255458104335e+18,3,21,7.0,7,7,3,0
1.101232364611004e+18,20,85,4.25,2,6,20,0
1.1012427185640786e+18,37,77,2.081081081081081,1,4,37,0
1.1012494721230725e+18,10,29,2.9,1,5,10,0
1.1012536147428458e+18,13,27,2.076923076923077,1,3,13,0
1.101264403993188e+18,35,173,4.942857142857143,2,7,35,0
1.1012879755064676e+18,11,110,10.0,9,11,0,11
1.1012898256698344e+18,29,115,3.9655172413793105,2,5,29,0
1.1012903643984031e+18,61,180,2.9508196721311477,1,6,61,0
1.10129203707327e+18,5,10,2.0,1,3,5,0
1.1013136684805124e+18,25,127,5.08,3,7,25,0
1.1013309728067951e+18,1,3,3.0,3,3,1,0
1.101344184281863e+18,55,497,9.036363636363637,2,12,7,48
1.1013523570572544e+18,13,53,4.076923076923077,2,6,13,0
1.1013531827049111e+18,40,90,2.25,1,4,40,0
1.1013681812130028e+18,70,142,2.0285714285714285,1,4,70,0
1.1013740528803983e+18,7,37,5.285714285714286,5,6,7,0
1.1014111963613261e+18,17,37,2.176470588235294,1,3,17,0
1.1014119057797984e+18,1,2,2.0,2,2,1,0
1.101459308425098e+18,2,6,3.0,2,4,2,0
1.1015484716383617e+18,19,128,6.7368421052631575,5,9,14,5
1.1015516192372836e+18,28,191,6.821428571428571,5,10,20,8
1.1017075705639112e+18,17,113,6.647058823529412,4,9,13,4
1.1018886198815922e+18,31,282,9.096774193548388,8,10,0,31
1.1019112064098454e+18,2,4,2.0,2,2,2,0
1.1019189889160448e+18,55,543,9.872727272727273,2,12,2,53
1.1019248896765486e+18,40,389,9.725,8,12,0,40
1.1019301948335377e+18,2,10,5.0,5,5,2,0
1.1019366901766624e+18,6,11,1.8333333333333333,1,3,6,0
1.1019369215017192e+18,7,18,2.5714285714285716,2,5,7,0
1.1019371235190764e+18,4,7,1.75,1,3,4,0
1.1019375408795104e+18,2,6,3.0,2,4,2,0
1.101937568104166e+18,7,19,2.7142857142857144,1,4,7,0
1.1019730131059735e+18,5,20,4.0,3,5,5,0
1.1019890272797673e+18,14,96,6.857142857142857,5,8,11,3
1.1019991169101727e+18,2,4,2.0,2,2,2,0
1.1020007493252449e+18,7,12,1.7142857142857142,1,3,7,0
1.1020081100245495e+18,5,13,2.6,2,3,5,0
1.1020159314689489e+18,6,14,2.3333333333333335,2,3,6,0
1.1020235924622152e+18,2,2,1.0,1,1,2,0
1.1020419998410716e+18,1,1,1.0,1,1,1,0
1.1020423091500888e+18,14,27,1.9285714285714286,1,4,14,0
1.1020718764333179e+18,37,274,7.405405405405405,6,9,22,15
1.1020743953051835e+18,12,24,2.0,1,5,12,0
1.1020981369516443e+18,3,11,3.6666666666666665,3,4,3,0
1.102100497952034e+18,2,6,3.0,3,3,2,0
1.102105941565596e+18,8,38,4.75,4,6,8,0
1.1021476691040447e+18,15,32,2.1333333333333333,1,4,15,0
1.1021524314376564e+18,6,48,8.0,8,8,0,6
1.102158075446272e+18,7,18,2.5714285714285716,2,4,7,0
1.1021791649490225e+18,2,9,4.5,4,5,2,0
1.102195501621951e+18,24,42,1.75,1,4,24,0
1.1022534114545612e+18,2,17,8.5,8,9,0,2
1.1022601250067242e+18,13,118,9.076923076923077,4,11,2,11
1.1026196162642962e+18,19,93,4.894736842105263,3,8,18,1
1.1026720440255706e+18,9,19,2.111111111111111,1,4,9,0
1.1026730826516105e+18,1,5,5.0,5,5,1,0
1.1026811508700378e+18,19,154,8.105263157894736,5,10,4,15
1.1026848857026872e+18,39,80,2.051282051282051,1,4,39,0
1.1026996938647295e+18,24,165,6.875,5,9,19,5
1.1027088576739772e+18,1,9,9.0,9,9,0,1
1.1027175265194542e+18,29,211,7.275862068965517,5,9,17,12
1.1027348580228891e+18,44,86,1.9545454545454546,1,4,44,0
1.1027365546757553e+18,24,76,3.1666666666666665,1,5,24,0
1.1027516419225987e+18,37,78,2.108108108108108,1,5,37,0
1.1027521072951631e+18,2,3,1.5,1,2,2,0
1.1027647069005189e+18,6,49,8.166666666666666,5,10,1,5
1.1027705408114216e+18,45,397,8.822222222222223,3,11,4,41
1.102772037044582e+18,2,15,7.5,6,9,1,1
1.1027986056493151e+18,20,192,9.6,4,12,2,18
1.1028160504742432e+18,7,38,5.428571428571429,3,7,7,0
1.1028238038026976e+18,1,2,2.0,2,2,1,0
1.1028254304075384e+18,15,28,1.8666666666666667,1,3,15,0
1.1028455169021032e+18,5,16,3.2,3,4,5,0
1.1028654271985884e+18,38,80,2.1052631578947367,1,4,38,0
1.102869504435367e+18,6,21,3.5,2,5,6,0
1.1029011576831918e+18,34,333,9.794117647058824,4,12,2,32
1.1029044634207217e+18,12,24,2.0,1,3,12,0
1.1029382327205565e+18,7,59,8.428571428571429,3,11,1,6
1.1029482502912302e+18,28,246,8.785714285714286,7,11,4,24
1.1029540377647398e+18,85,407,4.788235294117647,3,7,85,0
1.1030275886007176e+18,28,201,7.178571428571429,5,9,17,11
1.1030320100562973e+18,110,760,6.909090909090909,2,9,73,37
1.1032714015071931e+18,57,124,2.175438596491228,1,4,57,0
1.1033131975804556e+18,29,143,4.931034482758621,2,8,28,1
1.1033625062742628e+18,41,414,10.097560975609756,7,12,2,39
1.1033724068336371e+18,30,149,4.966666666666667,3,7,30,0
1.10338115948511e+18,23,86,3.739130434782609,2,6,23,0
1.1033962108769766e+18,1,6,6.0,6,6,1,0
1.1034110510259661e+18,40,398,9.95,5,12,2,38
1.103412793675537e+18,54,189,3.5,1,6,54,0
1.1034312575120641e+18,19,93,4.894736842105263,3,7,19,0
1.103442405978722e+18,37,77,2.081081081081081,1,4,37,0
1.1034444579678621e+18,1,9,9.0,9,9,0,1
1.1034630198972812e+18,34,140,4.117647058823529,3,6,34,0
1.103463128055319e+18,24,123,5.125,3,8,23,1
1.1034711687546932e+18,32,317,9.90625,8,12,0,32
1.1035124154088219e+18,24,32,1.3333333333333333,1,3,24,0
1.1035403256525111e+18,5,41,8.2,7,9,1,4
1.1035437835681603e+18,69,103,1.4927536231884058,1,4,69,0
1.1035627907285929e+18,14,66,4.714285714285714,3,7,14,0
1.1036208343510904e+18,3,8,2.6666666666666665,1,4,3,0
1.1036236538926099e+18,36,242,6.722222222222222,5,9,27,9
1.1036433557076097e+18,32,219,6.84375,4,9,23,9
1.1036577258679565e+18,25,46,1.84,1,4,25,0
1.1037152441725521e+18,4,33,8.25,4,11,1,3
1.1037235060494916e+18,6,49,8.166666666666666,6,10,2,4
1.1037384079332342e+18,50,199,3.98,1,6,50,0
1.1037523459962634e+18,26,104,4.0,1,5,26,0
1.1037803380212116e+18,16,97,6.0625,4,7,16,0
1.1040741318174938e+18,6,60,10.0,8,11,0,6
1.1040769082946286e+18,9,66,7.333333333333333,6,8,5,4
1.1041230175840178e+18,15,96,6.4,2,10,11,4
1.1041711496668317e+18,29,148,5.103448275862069,4,8,28,1
1.104186622347957e+18,4,29,7.25,6,9,2,2
1.1042352932498934e+18,39,282,7.230769230769231,5,10,26,13
1.1042441863721992e+18,15,142,9.466666666666667,3,12,2,13
1.1042761598027005e+18,26,261,10.038461538461538,8,12,0,26
1.1042846347928316e+18,41,207,5.048780487804878,3,7,41,0
1.1043257540892443e+18,21,94,4.476190476190476,2,6,21,0
1.1043260136205797e+18,41,384,9.365853658536585,2,12,5,36
1.1043395289469384e+18,3,11,3.6666666666666665,3,4,3,0
1.1043433478116184e+18,47,239,5.085106382978723,3,8,44,3
1.104388604590367e+18,50,424,8.48,4,11,8,42
1.1043932078787766e+18,30,173,5.766666666666667,3,8,27,3
1.1044038691453614e+18,10,92,9.2,4,11,1,9
1.1045017297852076e+18,26,131,5.038461538461538,3,6,26,0
1.104505397087762e+18,6,54,9.0,8,10,0,6
1.1048206848633588e+18,3,5,1.6666666666666667,1,2,3,0
1.1048338496263624e+18,16,84,5.25,4,7,16,0
1.1048620266407771e+18,20,37,1.85,1,3,20,0
1.1048687402120216e+18,6,29,4.833333333333333,3,6,6,0
1.1048743678187223e+18,2,4,2.0,1,3,2,0
1.1048747220023096e+18,39,193,4.948717948717949,3,7,39,0
1.104882667405991e+18,12,43,3.5833333333333335,2,5,12,0
1.1048873589836028e+18,13,110,8.461538461538462,6,10,1,12
1.1049001663614717e+18,40,371,9.275,3,12,5,35
1.1049002645054621e+18,9,19,2.111111111111111,1,4,9,0
1.104900445996117e+18,6,12,2.0,1,3,6,0
1.1049006291172676e+18,14,32,2.2857142857142856,1,4,14,0
1.1049008838726934e+18,16,39,2.4375,1,4,16,0
1.1049012040859482e+18,3,20,6.666666666666667,6,7,3,0
1.1049012155112762e+18,60,117,1.95,1,4,60,0
1.1049116959043574e+18,35,140,4.0,2,6,35,0
1.1049791946640699e+18,3,4,1.3333333333333333,1,2,3,0
1.1050221508304667e+18,6,20,3.3333333333333335,3,4,6,0
1.1051566978351533e+18,5,11,2.2,1,3,5,0
1.1051950714204067e+18,61,543,8.901639344262295,3,12,7,54
1.1052136851087091e+18,36,182,5.055555555555555,3,8,35,1
1.105221106596897e+18,21,213,10.142857142857142,6,12,1,20
1.1052260500616856e+18,72,625,8.680555555555555,4,11,9,63
1.1052410678413862e+18,39,83,2.128205128205128,1,4,39,0
1.1055398591968261e+18,64,632,9.875,6,13,1,63
1.1055571747942435e+18,4,27,6.75,3,10,2,2
1.1055641163618514e+18,4,26,6.5,6,7,4,0
1.1055643552153496e+18,7,26,3.7142857142857144,3,5,7,0
1.1055772987432696e+18,5,38,7.6,6,9,2,3
1.1056082247568058e+18,2,5,2.5,1,4,2,0
1.1056084133349614e+18,4,32,8.0,7,9,1,3
1.1056128943063448e+18,23,150,6.521739130434782,3,9,18,5
1.1056487933565472e+18,3,9,3.0,2,4,3,0
1.1056562526951919e+18,13,35,2.6923076923076925,1,5,13,0
1.1056694310283373e+18,46,215,4.673913043478261,2,7,46,0
1.105690431908934e+18,21,37,1.7619047619047619,1,4,21,0
1.1056947561988847e+18,1,7,7.0,7,7,1,0
1.1056992885427875e+18,10,20,2.0,1,4,10,0
1.1057250257235796e+18,59,303,5.135593220338983,3,7,59,0
1.105732990836944e+18,3,21,7.0,7,7,3,0
1.1057604577280321e+18,2,15,7.5,7,8,1,1
1.1058054624647237e+18,2,9,4.5,4,5,2,0
1.1058354006630382e+18,8,36,4.5,3,6,8,0
1.1058643251882945e+18,2,2,1.0,1,1,2,0
1.1058965313200143e+18,10,30,3.0,1,5,10,0
1.1058983104595997e+18,87,341,3.9195402298850577,1,6,87,0
1.105910937144092e+18,11,50,4.545454545454546,3,7,11,0
1.1059652128892819e+18,54,504,9.333333333333334,2,12,6,48
1.1059794219113724e+18,4,35,8.75,7,10,1,3
1.1059859650125124e+18,20,189,9.45,4,12,2,18
1.1060056714434363e+18,48,199,4.145833333333333,2,6,48,0
1.1062636826293897e+18,24,96,4.0,2,8,23,1
1.1063042580661862e+18,30,296,9.866666666666667,5,11,1,29
1.1063092437900625e+18,15,40,2.6666666666666665,1,4,15,0
1.1063131553677829e+18,8,65,8.125,6,9,1,7
1.1063138508091212e+18,34,108,3.176470588235294,1,6,34,0
1.1063197923162721e+18,6,11,1.8333333333333333,1,3,6,0
1.106342338988635e+18,13,32,2.4615384615384617,2,3,13,0
1.1063427009201906e+18,9,46,5.111111111111111,4,6,9,0
1.1063629086259617e+18,1,1,1.0,1,1,1,0
1.1063658719628704e+18,28,75,2.6785714285714284,1,4,28,0
1.106379715276368e+18,1,3,3.0,3,3,1,0
1.1063843080871354e+18,42,198,4.714285714285714,3,6,42,0
1.1063916613070898e+18,6,44,7.333333333333333,7,8,4,2
1.106396382010158e+18,18,123,6.833333333333333,4,8,14,4
1.1063979725826527e+18,23,96,4.173913043478261,2,6,23,0
1.1064366708273364e+18,1,10,10.0,10,10,0,1
1.1064504491767808e+18,2,12,6.0,5,7,2,0
1.1064597581104385e+18,53,517,9.754716981132075,4,13,3,50
1.1064664729111378e+18,72,347,4.819444444444445,2,7,72,0
1.106476367797672e+18,25,46,1.84,1,4,25,0
1.1064883318965268e+18,10,23,2.3,1,5,10,0
1.1064965041238267e+18,36,289,8.027777777777779,2,10,11,25
1.1064985089030112e+18,6,14,2.3333333333333335,1,3,6,0
1.1065001176613722e+18,21,191,9.095238095238095,2,11,2,19
1.1065188909242707e+18,31,242,7.806451612903226,3,10,12,19
1.1065200389631372e+18,9,91,10.11111111111111,9,12,0,9
1.1065311791962875e+18,9,29,3.2222222222222223,2,5,9,0
1.10657500798497e+18,1,9,9.0,9,9,0,1
1.1065802861299008e+18,12,79,6.583333333333333,2,8,8,4
1.1065804527465715e+18,13,93,7.153846153846154,5,8,8,5
1.1065811308123939e+18,13,17,1.3076923076923077,1,2,13,0
1.1065815294142988e+18,13,88,6.769230769230769,5,9,11,2
1.1065819223860273e+18,26,202,7.769230769230769,4,10,9,17
1.1065822221198301e+18,15,30,2.0,1,3,15,0
1.1065824642731017e+18,33,295,8.93939393939394,6,11,4,29
1.1065866893762067e+18,70,141,2.0142857142857142,1,4,70,0
1.1066003257701686e+18,10,100,10.0,8,12,0,10
1.1066323251046669e+18,28,179,6.392857142857143,3,9,22,6
1.1066502390580922e+18,6,22,3.6666666666666665,3,5,6,0
1.1066797747125409e+18,21,112,5.333333333333333,2,7,21,0
1.106948958975986e+18,36,177,4.916666666666667,2,7,36,0
1.1069518685618072e+18,18,168,9.333333333333334,5,12,2,16
1.1070079298102943e+18,2,5,2.5,2,3,2,0
1.1070196524266936e+18,1,2,2.0,2,2,1,0
1.1070410457989038e+18,17,147,8.647058823529411,4,10,2,15
1.1070693122911802e+18,18,135,7.5,5,9,8,10
1.1070759719348579e+18,25,165,6.6,2,8,19,6
1.1070894109361326e+18,2,5,2.5,2,3,2,0
1.107099201845476e+18,1,3,3.0,3,3,1,0
1.1071221009100991e+18,2,15,7.5,7,8,1,1
1.1071251708605613e+18,7,48,6.857142857142857,6,8,6,1
1.1071280240487476e+18,41,198,4.829268292682927,3,7,41,0
1.1071502692317523e+18,31,153,4.935483870967742,4,8,30,1
1.107165823583196e+18,1,1,1.0,1,1,1,0
1.1071713345974345e+18,11,25,2.272727272727273,1,4,11,0
1.1071750530902835e+18,9,94,10.444444444444445,9,12,0,9
1.1072352900278907e+18,37,187,5.054054054054054,2,7,37,0
1.107257384158611e+18,86,442,5.1395348837209305,2,8,85,1
1.1073317382339558e+18,2,6,3.0,3,3,2,0
1.1073645116734461e+18,17,37,2.176470588235294,1,4,17,0
1.1073666671685231e+18,5,32,6.4,4,8,3,2
1.1074356503990808e+18,6,47,7.833333333333333,4,10,1,5
1.1076989058712872e+18,25,213,8.52,7,11,1,24
1.1077501174683959e+18,42,207,4.928571428571429,2,7,42,0
1.1077789051011569e+18,31,248,8.0,5,10,10,21
1.1077915596272472e+18,76,748,9.842105263157896,3,13,2,74
1.1078271475411686e+18,4,5,1.25,1,2,4,0
1.1078276577575905e+18,50,354,7.08,2,10,32,18
1.1078300580739028e+18,9,71,7.888888888888889,4,10,3,6
1.107881261219641e+18,23,205,8.91304347826087,5,11,2,21
1.1079348361483551e+18,1,7,7.0,7,7,1,0
1.1079538691688114e+18,3,4,1.3333333333333333,1,2,3,0
1.1079850876653285e+18,12,63,5.25,4,7,12,0
1.1079855599890419e+18,18,86,4.777777777777778,2,6,18,0
1.1079904520561006e+18,62,124,2.0,1,5,62,0
1.1080279486879908e+18,47,415,8.829787234042554,4,11,6,41
1.1080790346092093e+18,15,115,7.666666666666667,5,10,7,8
1.1081044013280675e+18,4,28,7.0,6,8,3,1
1.1081616488773116e+18,26,184,7.076923076923077,5,9,16,10
1.108423643344547e+18,25,243,9.72,5,11,1,24
1.1085048712002168e+18,5,13,2.6,1,4,5,0
1.1085101927606305e+18,32,268,8.375,3,11,5,27
1.1085138883483291e+18,6,9,1.5,1,3,6,0
1.1086372574418596e+18,62,614,9.903225806451612,6,12,1,61
1.1086667652769106e+18,9,15,1.6666666666666667,1,3,9,0
1.1086776381879657e+18,22,149,6.7727272727272725,4,8,18,4
1.1087395736008365e+18,11,50,4.545454545454546,3,6,11,0
1.1087970093246524e+18,13,58,4.461538461538462,3,6,13,0
1.108927006822244e+18,1,2,2.0,2,2,1,0
1.1089534235553884e+18,6,10,1.6666666666666667,1,3,6,0
1.1089971672171514e+18,17,113,6.647058823529412,5,8,14,3
1.1091208043708718e+18,6,50,8.333333333333334,6,10,1,5
1.1091239977513126e+18,3,7,2.3333333333333335,2,3,3,0
1.1091614805637018e+18,23,71,3.0869565217391304,2,5,23,0
1.1092081491143012e+18,77,753,9.779220779220779,2,13,4,73
1.1092196061592978e+18,94,898,9.553191489361701,2,13,5,89
1.1092344424578884e+18,52,393,7.5576923076923075,3,10,22,30
1.1092452575180398e+18,22,190,8.636363636363637,3,12,4,18
1.1092673976744948e+18,14,134,9.571428571428571,3,13,1,13
1.1093140047966364e+18,26,71,2.730769230769231,1,5,26,0
1.1093278241582623e+18,95,138,1.4526315789473685,1,3,95,0
1.1093870844650994e+18,19,95,5.0,3,7,19,0
1.1094386388701431e+18,15,33,2.2,1,4,15,0
1.1094518830357151e+18,1,6,6.0,6,6,1,0
1.1094564675923177e+18,36,353,9.805555555555555,6,12,1,35
1.1094672965271904e+18,51,97,1.9019607843137254,1,4,51,0
1.1094713847406428e+18,14,95,6.785714285714286,4,9,11,3
1.1095241282692788e+18,20,123,6.15,4,9,17,3
1.109531617974819e+18,5,7,1.4,1,2,5,0
1.1095598591267014e+18,32,220,6.875,2,9,20,12
1.1096792589728596e+18,25,117,4.68,2,7,25,0
1.1098792030861866e+18,4,26,6.5,6,8,3,1
1.1099210220773016e+18,25,238,9.52,3,11,3,22
1.1099449363127233e+18,13,20,1.5384615384615385,1,3,13,0
1.1099486613493267e+18,7,9,1.2857142857142858,1,2,7,0
1.1099528920687123e+18,10,18,1.8,1,3,10,0
1.1099717805638839e+18,21,107,5.095238095238095,3,7,21,0
1.1099755663251414e+18,13,41,3.1538461538461537,2,5,13,0
1.1099794983625332e+18,9,69,7.666666666666667,4,10,3,6
1.1099795227370048e+18,11,23,2.090909090909091,1,3,11,0
1.1100237417134848e+18,21,41,1.9523809523809523,1,4,21,0
1.1100244893496003e+18,1,5,5.0,5,5,1,0
1.1100296480025856e+18,2,15,7.5,7,8,1,1
1.1100559392812389e+18,5,15,3.0,1,5,5,0
1.110061935829056e+18,11,112,10.181818181818182,9,12,0,11
1.1100679925998962e+18,12,28,2.3333333333333335,1,4,12,0
1.1100994647309375e+18,16,39,2.4375,1,5,16,0
1.1101044397248833e+18,34,245,7.205882352941177,5,9,18,16
1.1101511056064739e+18,18,86,4.777777777777778,3,6,18,0
1.1102966448842085e+18,43,175,4.069767441860465,2,6,43,0
1.1103046898079992e+18,21,195,9.285714285714286,3,11,1,20
1.110329683939002e+18,72,340,4.722222222222222,2,8,71,1
1.1105848212327405e+18,14,56,4.0,3,6,14,0
1.1106149247916506e+18,44,417,9.477272727272727,5,12,3,41
1.1106258453292268e+18,4,4,1.0,1,1,4,0
1.1106351347024955e+18,23,46,2.0,1,4,23,0
1.1106372117683672e+18,9,66,7.333333333333333,6,10,5,4
1.110652699213208e+18,13,30,2.3076923076923075,1,4,13,0
1.1106578019613777e+18,33,280,8.484848484848484,3,11,7,26
1.1106634821653157e+18,41,318,7.7560975609756095,4,10,14,27
1.1106651387534065e+18,3,13,4.333333333333333,4,5,3,0
1.1106659309813745e+18,30,244,8.133333333333333,6,10,6,24
1.1106676200284454e+18,2,10,5.0,5,5,2,0
1.1106884077490048e+18,73,144,1.9726027397260273,1,4,73,0
1.1107294277635124e+18,28,58,2.0714285714285716,1,4,28,0
1.1107496705913526e+18,43,373,8.674418604651162,4,11,5,38
1.1107669865387724e+18,10,67,6.7,4,8,9,1
1.1107908091051579e+18,2,20,10.0,10,10,0,2
1.110808195595757e+18,12,26,2.1666666666666665,1,4,12,0
1.110822639322109e+18,13,41,3.1538461538461537,2,4,13,0
1.1108492594135237e+18,1,3,3.0,3,3,1,0
1.1109031710936265e+18,62,419,6.758064516129032,3,9,44,18
1.1109041043991932e+18,6,6,1.0,1,1,6,0
1.1109095076958554e+18,8,67,8.375,7,9,1,7
1.1109102201196402e+18,22,148,6.7272727272727275,4,8,17,5
1.1109109446331823e+18,1,3,3.0,3,3,1,0
1.1109166094228599e+18,45,412,9.155555555555555,2,12,7,38
1.1109358739202756e+18,29,88,3.0344827586206895,1,4,29,0
1.1110121259552882e+18,44,315,7.159090909090909,3,9,24,20
1.1110164735862652e+18,27,133,4.925925925925926,3,7,27,0
1.1113320897674687e+18,38,193,5.078947368421052,2,7,38,0
1.1113355337168457e+18,6,8,1.3333333333333333,1,3,6,0
1.1113515214798452e+18,22,151,6.863636363636363,3,9,15,7
1.1113797574115274e+18,33,61,1.8484848484848484,1,4,33,0
1.1113900430258154e+18,5,29,5.8,5,7,5,0
1.111393735001855e+18,19,127,6.684210526315789,2,9,14,5
1.1113942931720613e+18,15,32,2.1333333333333333,1,3,15,0
1.1113943851524643e+18,7,16,2.2857142857142856,1,3,7,0
1.111394752715545e+18,12,27,2.25,1,4,12,0
1.1113949501822561e+18,25,71,2.84,1,4,25,0
1.1113949503946012e+18,6,9,1.5,1,2,6,0
1.111394986973128e+18,4,14,3.5,3,4,4,0
1.1113950347729463e+18,17,41,2.411764705882353,1,4,17,0
1.1113950883113906e+18,13,40,3.076923076923077,2,4,13,0
1.1113951760052607e+18,35,247,7.057142857142857,2,10,23,12
1.1113969272219323e+18,37,117,3.1621621621621623,1,5,37,0
1.1113969520614268e+18,18,37,2.0555555555555554,1,5,18,0
1.1113969526364296e+18,18,39,2.1666666666666665,1,3,18,0
1.1113972680603663e+18,19,187,9.842105263157896,8,12,0,19
1.1113973234011288e+18,25,76,3.04,1,6,25,0
1.111397546569945e+18,25,49,1.96,1,3,25,0
1.1113977927611057e+18,32,153,4.78125,3,6,32,0
1.1114170580254441e+18,33,67,2.0303030303030303,1,4,33,0
1.1114172466524511e+18,29,61,2.103448275862069,1,4,29,0
1.1114214120386036e+18,4,20,5.0,4,6,4,0
1.1114514356955213e+18,19,113,5.947368421052632,4,8,18,1
1.1114894236430226e+18,13,91,7.0,5,9,9,4
1.1115032232481746e+18,31,122,3.935483870967742,2,5,31,0
1.1115077946277147e+18,24,136,5.666666666666667,2,7,24,0
1.1115101613561911e+18,1,4,4.0,4,4,1,0
1.1115227286422751e+18,47,96,2.0425531914893615,1,4,47,0
1.1115228468196524e+18,2,5,2.5,2,3,2,0
1.1115327380746337e+18,13,28,2.1538461538461537,1,3,13,0
1.1115433306662095e+18,1,5,5.0,5,5,1,0
1.1115490721666881e+18,2,9,4.5,4,5,2,0
1.111550199360465e+18,1,5,5.0,5,5,1,0
1.111553426087603e+18,1,4,4.0,4,4,1,0
1.111573781180252e+18,31,43,1.3870967741935485,1,3,31,0
1.1115817187410821e+18,14,30,2.142857142857143,1,4,14,0
1.1115832901044813e+18,3,7,2.3333333333333335,2,3,3,0
1.1116135751519354e+18,11,31,2.8181818181818183,2,4,11,0
1.1117151352545071e+18,1,5,5.0,5,5,1,0
1.1117200580314196e+18,42,167,3.9761904761904763,2,6,42,0
1.1117547475346629e+18,20,30,1.5,1,4,20,0
1.1117903597741505e+18,81,239,2.950617283950617,1,6,81,0
1.1118076176864269e+18,15,132,8.8,5,11,2,13
1.1120951667048287e+18,10,73,7.3,2,11,5,5
1.1120995476112265e+18,12,36,3.0,2,5,12,0
1.1121026042067511e+18,7,19,2.7142857142857144,2,5,7,0
1.1121068281436125e+18,9,63,7.0,2,9,4,5
1.1121126388301608e+18,18,48,2.6666666666666665,1,4,18,0
1.1121393221716083e+18,9,56,6.222222222222222,2,8,8,1
1.1121425143549788e+18,3,9,3.0,2,4,3,0
1.112150758910827e+18,2,4,2.0,2,2,2,0
1.1122015978324588e+18,1,3,3.0,3,3,1,0
1.1122141784327396e+18,28,204,7.285714285714286,6,9,17,11
1.1122453245052748e+18,1,3,3.0,3,3,1,0
1.112245533406272e+18,3,22,7.333333333333333,7,8,2,1
1.112246292373326e+18,35,76,2.1714285714285713,1,4,35,0
1.1122468014092192e+18,15,105,7.0,6,9,11,4
1.1122516904865719e+18,14,120,8.571428571428571,3,10,1,13
1.1122528266429466e+18,1,3,3.0,3,3,1,0
1.1122552436473649e+18,3,12,4.0,3,5,3,0
1.112257270466519e+18,5,25,5.0,4,6,5,0
1.1122819383100387e+18,4,27,6.75,6,7,4,0
1.112282250235341e+18,24,76,3.1666666666666665,2,5,24,0
1.1122831404833029e+18,4,4,1.0,1,1,4,0
1.112286559877198e+18,17,119,7.0,5,9,12,5
1.1122922486735881e+18,5,10,2.0,1,3,5,0
1.112304329609033e+18,41,360,8.78048780487805,2,11,4,37
1.1123299830821073e+18,48,245,5.104166666666667,3,7,48,0
1.1123424645039729e+18,11,106,9.636363636363637,7,11,1,10
1.1123473292430563e+18,10,53,5.3,2,7,10,0
1.1123537099131183e+18,36,366,10.166666666666666,7,12,1,35
1.1123651885157524e+18,13,133,10.23076923076923,7,12,1,12
1.1123865720418468e+18,2,6,3.0,2,4,2,0
1.1124112754826478e+18,8,67,8.375,4,10,2,6
1.1124268416740165e+18,26,56,2.1538461538461537,1,5,26,0
1.1124399033365108e+18,38,356,9.368421052631579,2,12,4,34
1.1124715485000835e+18,25,41,1.64,1,4,25,0
1.112475354402649e+18,3,4,1.3333333333333333,1,2,3,0
1.1125246781521087e+18,40,185,4.625,2,8,39,1
1.1125393411645551e+18,7,17,2.4285714285714284,2,3,7,0
1.1125418917631967e+18,3,7,2.3333333333333335,1,3,3,0
1.1125438993453619e+18,9,15,1.6666666666666667,1,2,9,0
1.1125512316830697e+18,3,4,1.3333333333333333,1,2,3,0
1.1125554188687967e+18,14,27,1.9285714285714286,1,3,14,0
1.1125579904397522e+18,26,51,1.9615384615384615,1,5,26,0
1.1125601031273711e+18,14,23,1.6428571428571428,1,3,14,0
1.1125623882518221e+18,25,51,2.04,1,4,25,0
1.1125646997436096e+18,11,22,2.0,1,5,11,0
1.1125669997772751e+18,3,6,2.0,1,3,3,0
1.1125695805123613e+18,25,54,2.16,1,4,25,0
1.1125700959597901e+18,9,21,2.3333333333333335,1,4,9,0
1.1125726242974874e+18,13,29,2.230769230769231,1,4,13,0
1.1125749292586756e+18,24,53,2.2083333333333335,1,4,24,0
1.1125780973318694e+18,26,52,2.0,1,4,26,0
1.1125829043439753e+18,9,18,2.0,1,3,9,0
1.1125855095670341e+18,35,65,1.8571428571428572,1,4,35,0
1.1125881375957514e+18,38,81,2.1315789473684212,1,5,38,0
1.1125918869846675e+18,4,11,2.75,1,4,4,0
1.1125950461783521e+18,21,48,2.2857142857142856,1,4,21,0
1.1125974716607099e+18,2,2,1.0,1,1,2,0
1.1126077419556741e+18,32,63,1.96875,1,4,32,0
1.1126113480317568e+18,15,29,1.9333333333333333,1,3,15,0
1.1127373667897334e+18,9,73,8.11111111111111,6,10,3,6
1.1127964362248901e+18,43,84,1.9534883720930232,1,4,43,0
1.112846745592833e+18,5,16,3.2,2,4,5,0
1.1128493297649672e+18,2,9,4.5,2,7,2,0
1.1128568336914852e+18,1,9,9.0,9,9,0,1
1.1128600967498496e+18,3,22,7.333333333333333,6,8,1,2
1.1128606608426322e+18,2,14,7.0,7,7,2,0
1.1128650522961906e+18,14,93,6.642857142857143,4,9,11,3
1.1128765036571872e+18,54,206,3.814814814814815,1,6,54,0
1.1128958649831135e+18,1,7,7.0,7,7,1,0
1.1129237683581746e+18,30,61,2.033333333333333,1,4,30,0
1.1129353650602661e+18,12,24,2.0,1,3,12,0
1.1129372165741619e+18,13,23,1.7692307692307692,1,4,13,0
1.112961336426677e+18,16,32,2.0,1,4,16,0
1.1129739702657838e+18,2,6,3.0,2,4,2,0
1.1129760033295597e+18,5,30,6.0,4,7,5,0
1.1129833041790368e+18,43,407,9.465116279069768,2,12,4,39
1.1130321823900064e+18,2,17,8.5,7,10,1,1
1.1130356661705402e+18,6,17,2.8333333333333335,1,4,6,0
1.1131256632170212e+18,12,91,7.583333333333333,3,11,4,8
1.1131398111651583e+18,1,7,7.0,7,7,1,0
1.1131773376015148e+18,78,685,8.782051282051283,2,11,9,69
1.1131865813801061e+18,38,240,6.315789473684211,2,8,33,5
1.1131907763252673e+18,8,18,2.25,1,3,8,0
1.1132195142306337e+18,13,91,7.0,5,8,10,3
1.1132327186700426e+18,3,6,2.0,1,3,3,0
1.1132424395388982e+18,9,17,1.8888888888888888,1,3,9,0
1.1132506017356161e+18,7,21,3.0,2,4,7,0
1.1132660990385292e+18,18,40,2.2222222222222223,1,4,18,0
1.1132700714847398e+18,1,4,4.0,4,4,1,0
1.1132805853595634e+18,3,9,3.0,2,4,3,0
1.1132903728237606e+18,1,3,3.0,3,3,1,0
1.1132975097047433e+18,8,14,1.75,1,4,8,0
1.1133076489189978e+18,3,7,2.3333333333333335,2,3,3,0
1.1133164411610799e+18,3,6,2.0,1,4,3,0
1.1133227840410779e+18,1,2,2.0,2,2,1,0
1.1135188463680216e+18,6,35,5.833333333333333,5,6,6,0
1.1135476144159744e+18,51,454,8.901960784313726,4,12,3,48
1.1135956808044197e+18,3,19,6.333333333333333,5,7,3,0
1.1136058006719786e+18,39,156,4.0,2,6,39,0
1.1136109840339598e+18,14,103,7.357142857142857,2,11,5,9
1.1136154083286943e+18,2,16,8.0,7,9,1,1
1.1136566111195581e+18,27,57,2.111111111111111,1,5,27,0
1.1137090934176169e+18,40,319,7.975,2,12,11,29
1.1137245417975127e+18,38,374,9.842105263157896,2,12,2,36
1.1137425655777051e+18,1,2,2.0,2,2,1,0
1.1137887040437957e+18,19,189,9.947368421052632,8,12,0,19
1.113828513773373e+18,65,491,7.553846153846154,2,10,20,45
1.1138650874158084e+18,33,317,9.606060606060606,2,12,2,31
1.1139405235384447e+18,89,696,7.820224719101123,2,10,28,61
1.1139895324860319e+18,6,14,2.3333333333333335,2,3,6,0
1.1141751076656613e+18,9,64,7.111111111111111,6,8,6,3
1.1142305997866452e+18,33,323,9.787878787878787,3,12,2,31
1.1142417444569937e+18,4,7,1.75,1,2,4,0
1.1142769119809623e+18,7,48,6.857142857142857,5,8,4,3
1.1142873636011214e+18,2,4,2.0,2,2,2,0
1.1142908688477025e+18,2,3,1.5,1,2,2,0
1.1142956669755174e+18,2,6,3.0,3,3,2,0
1.1142984231344764e+18,2,6,3.0,2,4,2,0
1.114301583516667e+18,1,3,3.0,3,3,1,0
1.1143050171514936e+18,1,2,2.0,2,2,1,0
1.1143150037810803e+18,3,3,1.0,1,1,3,0
1.1143185794687357e+18,2,7,3.5,3,4,2,0
1.1143262801841615e+18,3,6,2.0,1,3,3,0
1.1143267692699352e+18,5,21,4.2,4,5,5,0
1.1143427557300132e+18,5,9,1.8,1,3,5,0
1.1143807501861178e+18,33,167,5.0606060606060606,2,7,33,0
1.1144002138228722e+18,30,205,6.833333333333333,5,8,21,9
1.1144050738545659e+18,3,17,5.666666666666667,5,6,3,0
1.114406632913324e+18,19,130,6.842105263157895,4,9,13,6
1.1144238923534894e+18,4,12,3.0,2,4,4,0
1.1144533875121661e+18,4,32,8.0,7,9,1,3
1.1145082649123318e+18,2,11,5.5,2,9,1,1
1.1145282629092076e+18,6,57,9.5,5,13,1,5
1.1145297643620562e+18,30,199,6.633333333333334,4,9,23,7
1.1145429342640808e+18,15,98,6.533333333333333,4,8,11,4
1.1145807624343346e+18,2,16,8.0,8,8,0,2
1.1146002742022268e+18,19,88,4.631578947368421,3,6,19,0
1.1146700196648238e+18,24,127,5.291666666666667,3,8,22,2
1.1146768799269116e+18,88,584,6.636363636363637,3,9,68,20
1.1147358077786143e+18,1,1,1.0,1,1,1,0
1.114941310995217e+18,8,58,7.25,6,9,5,3
1.1149415377164832e+18,20,155,7.75,3,10,7,13
1.1149416177324489e+18,26,211,8.115384615384615,6,10,7,19
1.1149666442469797e+18,1,2,2.0,2,2,1,0
1.114967500760375e+18,5,39,7.8,7,9,2,3
1.1149759029151058e+18,22,171,7.7727272727272725,6,10,11,11
1.1149806967816049e+18,2,9,4.5,4,5,2,0
1.1149821676387327e+18,3,14,4.666666666666667,4,5,3,0
1.1149873857638836e+18,1,6,6.0,6,6,1,0
1.1149894323961405e+18,2,11,5.5,5,6,2,0
1.1149921227186134e+18,2,9,4.5,4,5,2,0
1.1150392989263699e+18,6,41,6.833333333333333,6,8,5,1
1.1150503218006083e+18,5,10,2.0,1,3,5,0
1.1150876117056484e+18,8,50,6.25,2,8,7,1
1.115154814622984e+18,48,191,3.9791666666666665,1,6,48,0
1.115162529318275e+18,4,27,6.75,6,7,4,0
1.1151645815499594e+18,9,89,9.88888888888889,8,12,0,9
1.1151893504885565e+18,5,9,1.8,1,3,5,0
1.1152456488969673e+18,20,187,9.35,3,12,1,19
1.115268052249526e+18,36,179,4.972222222222222,2,7,36,0
1.1152872835580525e+18,6,42,7.0,5,10,4,2
1.115308353503495e+18,58,222,3.8275862068965516,1,6,58,0
1.1153356595904033e+18,20,63,3.15,2,6,20,0
1.1154702909001384e+18,59,514,8.711864406779661,4,10,4,55
1.1156836475951334e+18,9,35,3.888888888888889,2,6,9,0
1.1157124188289088e+18,9,80,8.88888888888889,4,12,1,8
1.1157397077387067e+18,8,23,2.875,2,4,8,0
1.1157440877556328e+18,28,223,7.964285714285714,5,10,10,18
1.1157505202630298e+18,1,6,6.0,6,6,1,0
1.1157528343535383e+18,17,120,7.0588235294117645,2,9,8,9
1.1157632666798164e+18,8,55,6.875,5,8,5,3
1.1157740857929085e+18,26,184,7.076923076923077,5,9,20,6
1.1157900433913129e+18,2,15,7.5,7,8,1,1
1.115801206068834e+18,37,161,4.351351351351352,2,7,37,0
1.1158079359089038e+18,23,51,2.217391304347826,1,5,23,0
1.1158183672984772e+18,31,239,7.709677419354839,3,11,12,19
1.1158202633064068e+18,21,201,9.571428571428571,3,11,1,20
1.1158572553954743e+18,12,81,6.75,4,8,8,4
1.1158657526107338e+18,21,146,6.9523809523809526,4,8,13,8
1.1158760292110819e+18,39,76,1.9487179487179487,1,4,39,0
1.1158773261158696e+18,3,5,1.6666666666666667,1,2,3,0
1.1158830360928198e+18,11,31,2.8181818181818183,1,4,11,0
1.1158877314619369e+18,11,30,2.727272727272727,1,4,11,0
1.1158891180348396e+18,29,146,5.0344827586206895,3,8,28,1
1.1158994549799218e+18,3,5,1.6666666666666667,1,3,3,0
1.1159021124390519e+18,15,31,2.066666666666667,1,3,15,0
1.1159107681813592e+18,3,4,1.3333333333333333,1,2,3,0
1.1159120653064778e+18,8,18,2.25,1,3,8,0
1.1159128523940042e+18,15,42,2.8,1,5,15,0
1.1159226713914604e+18,5,13,2.6,1,4,5,0
1.1159243346458566e+18,8,16,2.0,1,4,8,0
1.1159252271775912e+18,11,17,1.5454545454545454,1,3,11,0
1.1159351848511665e+18,1,9,9.0,9,9,0,1
1.1159354862828777e+18,17,115,6.764705882352941,4,8,13,4
1.1159489935009921e+18,3,21,7.0,5,9,2,1
1.115953561295049e+18,4,34,8.5,8,9,0,4
1.1159811773263226e+18,2,3,1.5,1,2,2,0
1.1160288599670584e+18,14,136,9.714285714285714,3,11,1,13
1.1160306806899652e+18,25,118,4.72,3,6,25,0
1.1160561286339973e+18,23,158,6.869565217391305,5,9,17,6
1.1160566892644657e+18,1,1,1.0,1,1,1,0
1.1160596663891942e+18,8,19,2.375,1,4,8,0
1.1160625074057211e+18,29,81,2.793103448275862,1,5,29,0
1.1160666386773417e+18,15,19,1.2666666666666666,1,2,15,0
1.1160691960562833e+18,44,209,4.75,2,7,44,0
1.1160704724057834e+18,1,1,1.0,1,1,1,0
1.1160886047148431e+18,3,21,7.0,7,7,3,0
1.1160994901882449e+18,11,73,6.636363636363637,3,9,8,3
1.1161873658358419e+18,15,77,5.133333333333334,3,6,15,0
1.1164103454400815e+18,1,10,10.0,10,10,0,1
1.1164345380410153e+18,1,9,9.0,9,9,0,1
1.1164569096514825e+18,6,43,7.166666666666667,6,8,3,3
1.1164847835680157e+18,34,234,6.882352941176471,2,9,22,12
1.1164889300258254e+18,4,13,3.25,2,4,4,0
1.1164930478370798e+18,10,80,8.0,7,9,4,6
1.1164932951446862e+18,6,12,2.0,1,3,6,0
1.116500723249142e+18,18,35,1.9444444444444444,1,3,18,0
1.116512787268506e+18,2,13,6.5,6,7,2,0
1.1165164487868952e+18,14,28,2.0,1,4,14,0
1.1165313732290751e+18,2,8,4.0,4,4,2,0
1.1165357257880586e+18,19,38,2.0,1,3,19,0
1.1165851198178449e+18,7,73,10.428571428571429,9,12,0,7
1.1165922697316225e+18,1,4,4.0,4,4,1,0
1.1166081571259073e+18,24,168,7.0,2,10,13,11
1.1166084671436065e+18,3,5,1.6666666666666667,1,2,3,0
1.1166271541324439e+18,18,123,6.833333333333333,5,9,13,5
1.1166473540510282e+18,2,12,6.0,4,8,1,1
1.1167134789076474e+18,124,1171,9.443548387096774,2,12,11,113
1.1167328522669193e+18,4,40,10.0,9,11,0,4
1.1167532645307251e+18,2,12,6.0,5,7,2,0
1.1167792353693645e+18,30,286,9.533333333333333,3,12,1,29
1.1168561738241613e+18,15,102,6.8,5,8,12,3
1.1170318651649395e+18,7,57,8.142857142857142,7,9,2,5
1.1170958691063127e+18,21,157,7.476190476190476,6,9,11,10
1.117132191981853e+18,4,22,5.5,4,7,4,0
1.1171433443239261e+18,16,49,3.0625,2,5,16,0
1.1171490980242202e+18,21,59,2.8095238095238093,1,5,21,0
1.1171775940675917e+18,3,5,1.6666666666666667,1,2,3,0
1.1171790288370004e+18,33,169,5.121212121212121,3,8,32,1
1.1171852925846813e+18,3,7,2.3333333333333335,1,3,3,0
1.1172087800973591e+18,2,8,4.0,4,4,2,0
1.1172281707232362e+18,38,99,2.6052631578947367,1,5,38,0
1.1172377321366011e+18,2,13,6.5,6,7,2,0
1.1172458723223634e+18,2,3,1.5,1,2,2,0
1.11724871034185e+18,1,2,2.0,2,2,1,0
1.1172566293617412e+18,25,170,6.8,4,9,15,10
1.1172680666375804e+18,1,8,8.0,8,8,0,1
1.1172747342830785e+18,2,17,8.5,8,9,0,2
1.1172759262345687e+18,2,14,7.0,6,8,1,1
1.1173011645475804e+18,35,171,4.885714285714286,2,7,35,0
1.1173070577909284e+18,2,5,2.5,2,3,2,0
1.1173104559326196e+18,16,47,2.9375,1,5,16,0
1.1173433669244628e+18,8,16,2.0,1,3,8,0
1.117345012015733e+18,2,18,9.0,8,10,0,2
1.1173647500666345e+18,5,16,3.2,2,4,5,0
1.1173704013406166e+18,22,206,9.363636363636363,2,13,2,20
1.1173738174338266e+18,27,57,2.111111111111111,1,4,27,0
1.1173742155226025e+18,7,15,2.142857142857143,1,4,7,0
1.1173743254158195e+18,14,29,2.0714285714285716,1,3,14,0
1.1173744477482077e+18,13,30,2.3076923076923075,1,5,13,0
1.117374598443211e+18,6,15,2.5,1,3,6,0
1.1173748078029523e+18,11,35,3.1818181818181817,2,5,11,0
1.1173748454574492e+18,2,5,2.5,2,3,2,0
1.1173812642863608e+18,43,97,2.255813953488372,1,4,43,0
1.117396249361378e+18,3,9,3.0,3,3,3,0
1.1174201005874501e+18,19,194,10.210526315789474,9,12,0,19
1.1174271094888268e+18,4,11,2.75,1,4,4,0
1.1174413307047022e+18,19,38,2.0,1,4,19,0
1.1174559990834525e+18,11,51,4.636363636363637,2,6,11,0
1.1175009164776987e+18,9,47,5.222222222222222,3,6,9,0
1.1175358716937437e+18,10,17,1.7,1,2,10,0
1.1177355608451256e+18,44,190,4.318181818181818,2,6,44,0
1.1178738448222889e+18,18,82,4.555555555555555,2,7,18,0
1.1179063114778409e+18,3,9,3.0,2,5,3,0
1.1179141616033286e+18,7,47,6.714285714285714,6,8,6,1
1.1179176121371608e+18,8,57,7.125,6,8,5,3
1.1179180351889513e+18,2,6,3.0,2,4,2,0
1.1179304528998488e+18,1,3,3.0,3,3,1,0
1.1179331988939004e+18,5,16,3.2,3,4,5,0
1.1179347737865972e+18,4,15,3.75,2,5,4,0
1.1179533126343808e+18,2,7,3.5,2,5,2,0
1.1179602489890833e+18,2,14,7.0,7,7,2,0
1.1179836917341514e+18,2,5,2.5,2,3,2,0
1.1179981303272596e+18,52,265,5.096153846153846,2,8,51,1
1.1180023022112525e+18,58,447,7.706896551724138,2,10,24,34
1.1180084410920497e+18,24,50,2.0833333333333335,1,4,24,0
1.1180369659883917e+18,3,27,9.0,9,9,0,3
1.1180696660563352e+18,6,46,7.666666666666667,5,9,2,4
1.1180931003608777e+18,31,67,2.161290322580645,1,4,31,0
1.1181190844312582e+18,19,37,1.9473684210526316,1,3,19,0
1.1181321302160143e+18,51,249,4.882352941176471,3,7,51,0
1.1181389622417987e+18,31,304,9.806451612903226,4,12,2,29
1.118149109134351e+18,58,282,4.862068965517241,2,7,58,0
1.1181694176480436e+18,11,69,6.2727272727272725,5,8,10,1
1.118188414840129e+18,4,25,6.25,6,7,4,0
1.1182687429501357e+18,3,25,8.333333333333334,8,9,0,3
1.1183191353005435e+18,53,213,4.018867924528302,1,6,53,0
1.1183381061085098e+18,11,21,1.9090909090909092,1,3,11,0
1.1186766108688046e+18,5,37,7.4,6,8,2,3
1.1186835239277079e+18,18,71,3.9444444444444446,2,6,18,0
1.1187004655065375e+18,2,4,2.0,2,2,2,0
1.118712037351055e+18,26,64,2.4615384615384617,1,4,26,0
1.1187225815861902e+18,23,125,5.434782608695652,3,8,21,2
1.118734985898285e+18,2,7,3.5,3,4,2,0
1.118790995731044e+18,7,12,1.7142857142857142,1,3,7,0
1.118862524591676e+18,23,55,2.391304347826087,1,4,23,0
1.1188866536139794e+18,12,57,4.75,3,6,12,0
1.1188959210073164e+18,49,336,6.857142857142857,2,10,35,14
1.1189185946001821e+18,6,9,1.5,1,3,6,0
1.1189239980066001e+18,2,3,1.5,1,2,2,0
1.1189254394185885e+18,44,426,9.681818181818182,3,14,2,42
1.1189317267267268e+18,3,11,3.6666666666666665,3,5,3,0
1.1189479628183306e+18,17,163,9.588235294117647,7,11,1,16
1.118957739309704e+18,60,362,6.033333333333333,3,9,53,7
1.118975693374406e+18,45,103,2.2888888888888888,1,5,45,0
1.1190428786457512e+18,7,35,5.0,4,6,7,0
1.1193024894008712e+18,21,33,1.5714285714285714,1,3,21,0
1.1193281508874207e+18,2,4,2.0,2,2,2,0
1.1193351643782831e+18,5,22,4.4,3,5,5,0
1.1193691245926336e+18,3,22,7.333333333333333,6,9,2,1
1.1194034232210906e+18,25,126,5.04,3,7,25,0
1.1194400726785644e+18,26,125,4.8076923076923075,2,7,26,0
1.1194467363712742e+18,10,26,2.6,1,4,10,0
1.119451864886313e+18,3,14,4.666666666666667,4,5,3,0
1.1195304918239753e+18,57,542,9.508771929824562,2,12,5,52
1.1195340755117924e+18,28,61,2.1785714285714284,1,4,28,0
1.1196127984306008e+18,25,47,1.88,1,3,25,0
1.1196413607927429e+18,19,101,5.315789473684211,4,7,19,0
1.1196888013409011e+18,1,2,2.0,2,2,1,0
1.1197054383427086e+18,4,10,2.5,1,4,4,0
1.1197166170684653e+18,17,85,5.0,4,8,16,1
1.1197216932548906e+18,1,3,3.0,3,3,1,0
1.1197474426480026e+18,25,44,1.76,1,4,25,0
1.1199855591305546e+18,3,24,8.0,7,9,1,2
1.120001012022622e+18,10,83,8.3,7,10,3,7
1.1200311225316808e+18,1,3,3.0,3,3,1,0
1.1200779515678643e+18,1,3,3.0,3,3,1,0
1.1200923872972463e+18,21,66,3.142857142857143,1,6,21,0
1.1200935001146984e+18,16,29,1.8125,1,3,16,0
1.1200965492700794e+18,27,47,1.7407407407407407,1,3,27,0
1.1201231299687909e+18,16,112,7.0,3,8,8,8
1.1201318767404682e+18,1,4,4.0,4,4,1,0
1.1201422449197036e+18,19,49,2.5789473684210527,1,4,19,0
1.1201482707950469e+18,23,167,7.260869565217392,4,10,13,10
1.1201862686147738e+18,23,220,9.565217391304348,4,12,3,20
1.1202148427634007e+18,2,19,9.5,8,11,0,2
1.1202451987381832e+18,48,196,4.083333333333333,2,6,48,0
1.1202492808118574e+18,7,23,3.2857142857142856,2,4,7,0
1.1202518988565551e+18,59,121,2.0508474576271185,1,4,59,0
1.1202760736530341e+18,31,260,8.387096774193548,7,11,7,24
1.1203189709598921e+18,20,38,1.9,1,4,20,0
1.1203362556960282e+18,13,43,3.3076923076923075,2,5,13,0
1.1203420566215556e+18,1,1,1.0,1,1,1,0
1.1203844412091119e+18,13,48,3.6923076923076925,2,6,13,0
1.1203979697474294e+18,50,248,4.96,3,7,50,0
1.1204368579787942e+18,19,185,9.736842105263158,8,12,0,19
1.1204992891385037e+18,38,175,4.605263157894737,2,6,38,0
1.1207337997945492e+18,2,15,7.5,7,8,1,1
1.1207573001842929e+18,3,20,6.666666666666667,2,10,1,2
1.1207637584892991e+18,70,482,6.885714285714286,3,10,48,22
1.1207821727472776e+18,14,28,2.0,1,4,14,0
1.1208046603439301e+18,1,8,8.0,8,8,0,1
1.1208048233672004e+18,3,6,2.0,2,2,3,0
1.1208100813551023e+18,94,827,8.797872340425531,4,11,9,85
1.1208107255274419e+18,25,90,3.6,1,6,25,0
1.1208164940663116e+18,5,34,6.8,6,8,4,1
1.1208405844936366e+18,36,253,7.027777777777778,2,9,25,11
1.1208542806084415e+18,20,93,4.65,2,6,20,0
1.1208648723559543e+18,19,126,6.631578947368421,2,9,12,7
1.1208710423228728e+18,13,28,2.1538461538461537,1,3,13,0
1.1208894170991131e+18,34,135,3.9705882352941178,2,6,34,0
1.1208895060943085e+18,14,33,2.357142857142857,1,5,14,0
1.1208985358233652e+18,14,78,5.571428571428571,4,7,14,0
1.1209054455146557e+18,62,188,3.032258064516129,1,7,62,0
1.120909194237901e+18,10,53,5.3,4,7,10,0
1.1209099983921398e+18,4,7,1.75,1,4,4,0
1.1209137061137791e+18,6,41,6.833333333333333,4,9,4,2
1.1209342839292366e+18,22,49,2.227272727272727,1,5,22,0
1.1209411804654043e+18,37,109,2.945945945945946,1,6,37,0
1.1209875384752174e+18,45,310,6.888888888888889,2,9,30,15
1.1209999048116233e+18,31,69,2.225806451612903,1,5,31,0
1.1210179743368539e+18,5,38,7.6,6,9,2,3
1.1210842811140733e+18,10,20,2.0,1,3,10,0
1.121101620537626e+18,28,253,9.035714285714286,2,12,3,25
1.1211126374489253e+18,1,6,6.0,6,6,1,0
1.1211219659779959e+18,10,100,10.0,4,12,1,9
1.1212287861535263e+18,1,7,7.0,7,7,1,0
1.1214564166681989e+18,5,13,2.6,1,3,5,0
1.1214596204213784e+18,15,118,7.866666666666666,6,10,6,9
1.1215091417922634e+18,1,7,7.0,7,7,1,0
1.121551723226502e+18,6,45,7.5,7,8,3,3
1.121561370224761e+18,17,119,7.0,4,9,8,9
1.1215616120967796e+18,1,7,7.0,7,7,1,0
1.1215721423219482e+18,20,43,2.15,1,4,20,0
1.1215807514517964e+18,18,72,4.0,2,6,18,0
1.1216099850195805e+18,67,131,1.955223880597015,1,4,67,0
1.1216510649602867e+18,1,1,1.0,1,1,1,0
1.1217194546319939e+18,42,278,6.619047619047619,3,9,33,9
1.1217276166521961e+18,25,75,3.0,1,5,25,0
1.1218020862568832e+18,25,95,3.8,2,6,25,0
1.1218556725691657e+18,20,42,2.1,1,4,20,0
1.1218844442267711e+18,1,3,3.0,3,3,1,0
1.1218867965502618e+18,42,404,9.619047619047619,4,12,3,39
1.1218907502923433e+18,80,561,7.0125,5,10,59,21
1.1219119024200343e+18,18,128,7.111111111111111,5,9,11,7
1.1219595612311875e+18,4,13,3.25,2,4,4,0
1.1222091013535112e+18,19,140,7.368421052631579,6,10,11,8
1.1222228843313946e+18,17,81,4.764705882352941,3,7,17,0
1.1222305232040148e+18,6,18,3.0,2,5,6,0
1.1222759861685825e+18,24,113,4.708333333333333,1,6,24,0
1.122284806043998e+18,5,8,1.6,1,2,5,0
1.122293099140276e+18,47,86,1.8297872340425532,1,3,47,0
1.1223012552822057e+18,1,2,2.0,2,2,1,0
1.1223064411260755e+18,24,115,4.791666666666667,3,7,24,0
1.1223306134401051e+18,2,13,6.5,5,8,1,1
1.1223898683557702e+18,11,95,8.636363636363637,2,11,1,10
1.1224299985973981e+18,4,9,2.25,2,3,4,0
1.1224625713924369e+18,32,41,1.28125,1,3,32,0
1.1224644694308991e+18,2,6,3.0,3,3,2,0
1.1224992275329889e+18,1,1,1.0,1,1,1,0
1.1225010581331478e+18,1,3,3.0,3,3,1,0
1.1225463493363948e+18,32,138,4.3125,2,6,32,0
1.122562762409301e+18,38,78,2.0526315789473686,1,4,38,0
1.1226136360157207e+18,21,203,9.666666666666666,2,12,2,19
1.1226148178733231e+18,8,37,4.625,3,6,8,0
1.1226516559893578e+18,89,167,1.8764044943820224,1,4,89,0
1.1229144274100859e+18,31,223,7.193548387096774,3,9,16,15
1.1229828093842711e+18,16,149,9.3125,6,11,3,13
1.1229870322292774e+18,4,34,8.5,8,9,0,4
1.1230020886884826e+18,17,67,3.9411764705882355,2,6,17,0
1.123017381407803e+18,111,651,5.864864864864865,3,8,103,8
1.1230401793638813e+18,111,645,5.8108108108108105,2,8,105,6
1.123060050049211e+18,27,50,1.8518518518518519,1,3,27,0
1.1230730441109138e+18,88,527,5.988636363636363,2,9,82,6
1.1230770537105779e+18,104,605,5.8173076923076925,2,9,98,6
1.123080554584728e+18,15,29,1.9333333333333333,1,3,15,0
1.1230951639684529e+18,6,17,2.8333333333333335,2,4,6,0
1.1231010376199635e+18,26,72,2.769230769230769,1,5,26,0
1.1231138251906383e+18,12,114,9.5,9,11,0,12
1.1231375776324795e+18,17,32,1.8823529411764706,1,3,17,0
1.1232303809406934e+18,4,36,9.0,7,10,1,3
1.1232436238457367e+18,18,77,4.277777777777778,2,6,18,0
1.1234107106956161e+18,66,462,7.0,2,9,47,19
1.1234241626983717e+18,58,570,9.827586206896552,2,13,4,54
1.1236358449889591e+18,19,92,4.842105263157895,2,7,19,0
1.1236419342622008e+18,11,56,5.090909090909091,3,6,11,0
1.1236974601670685e+18,15,19,1.2666666666666666,1,2,15,0
1.1238126339745832e+18,12,107,8.916666666666666,2,12,2,10
1.1238271879313463e+18,1,3,3.0,3,3,1,0
1.1238363164100274e+18,19,129,6.7894736842105265,2,9,14,5
1.1238926893681334e+18,4,29,7.25,7,8,3,1
1.1239346095229944e+18,19,183,9.631578947368421,7,12,2,17
1.123947376456372e+18,33,206,6.242424242424242,4,8,31,2
1.1240140972863867e+18,1,9,9.0,9,9,0,1
1.1243591453084517e+18,57,278,4.87719298245614,3,8,56,1
1.1243838591616132e+18,24,49,2.0416666666666665,1,4,24,0
1.1244061724153307e+18,3,22,7.333333333333333,7,8,2,1
1.1244289158800402e+18,22,116,5.2727272727272725,4,7,22,0
1.1244357899379338e+18,26,133,5.115384615384615,3,8,25,1
1.1244453633202228e+18,3,4,1.3333333333333333,1,2,3,0
1.124445477301754e+18,21,47,2.238095238095238,1,4,21,0
1.1244505050817061e+18,2,14,7.0,7,7,2,0
1.1244649131855747e+18,3,10,3.3333333333333335,3,4,3,0
1.1245474015200667e+18,25,112,4.48,2,5,25,0
1.124620750629574e+18,16,103,6.4375,5,9,14,2
1.1246356661828928e+18,18,76,4.222222222222222,3,6,18,0
1.1246511223631406e+18,2,4,2.0,2,2,2,0
1.1246527819800544e+18,42,307,7.309523809523809,5,9,22,20
1.1246542952485482e+18,21,141,6.714285714285714,2,8,16,5
1.1246809052469129e+18,4,26,6.5,5,8,3,1
1.124700088958655e+18,3,22,7.333333333333333,6,8,1,2
1.1247068997042587e+18,50,244,4.88,2,8,49,1
1.1247277027405894e+18,1,8,8.0,8,8,0,1
1.1251049644526907e+18,30,220,7.333333333333333,6,9,19,11
1.1251478216631327e+18,4,39,9.75,9,10,0,4
1.1251539746259958e+18,5,16,3.2,2,6,5,0
1.1251575944591794e+18,14,31,2.2142857142857144,1,3,14,0
1.1251672299828631e+18,11,58,5.2727272727272725,3,8,10,1
1.1251712552356818e+18,42,217,5.166666666666667,2,7,42,0
1.1251765085266537e+18,3,22,7.333333333333333,6,9,2,1
1.1251797104794515e+18,6,38,6.333333333333333,2,8,4,2
1.1251804390266395e+18,22,112,5.090909090909091,3,7,22,0
1.1251839393756872e+18,17,117,6.882352941176471,3,9,11,6
1.1251861054604617e+18,2,2,1.0,1,1,2,0
1.1251907135685696e+18,32,318,9.9375,5,12,1,31
1.1252037799026561e+18,3,10,3.3333333333333335,3,4,3,0
1.1252094154656522e+18,9,49,5.444444444444445,5,7,9,0
1.1252123563643818e+18,11,113,10.272727272727273,8,12,0,11
1.1252153348504442e+18,1,2,2.0,2,2,1,0
1.1252277557093993e+18,11,50,4.545454545454546,4,5,11,0
1.1252518416234808e+18,24,142,5.916666666666667,3,8,23,1
1.1252669109490755e+18,18,67,3.7222222222222223,2,6,18,0
1.1253090241925696e+18,7,68,9.714285714285714,8,11,0,7
1.125320445088059e+18,1,2,2.0,2,2,1,0
1.1253234095968867e+18,16,110,6.875,4,9,10,6
1.1253532450946751e+18,35,140,4.0,2,6,35,0
1.1253802247515066e+18,1,2,2.0,2,2,1,0
1.1253892826824088e+18,5,15,3.0,2,4,5,0
1.1254072521118351e+18,4,38,9.5,9,10,0,4
1.125413266782272e+18,16,48,3.0,2,4,16,0
1.1254143214629804e+18,8,61,7.625,6,9,3,5
1.125425361628848e+18,15,153,10.2,8,13,0,15
1.1254295573302755e+18,12,98,8.166666666666666,5,9,2,10
1.1254324621802052e+18,24,210,8.75,2,10,2,22
1.125435784696053e+18,8,80,10.0,8,11,0,8
1.1254380247400577e+18,15,73,4.866666666666666,4,6,15,0
1.1254492982656292e+18,50,243,4.86,1,7,50,0
1.1254752816634158e+18,46,230,5.0,2,7,46,0
1.1254933591296897e+18,6,11,1.8333333333333333,1,3,6,0
1.1254947662282367e+18,66,195,2.9545454545454546,1,5,66,0
1.1256753648336413e+18,1,5,5.0,5,5,1,0
1.125748377057422e+18,2,15,7.5,7,8,1,1
1.1258161325478369e+18,1,3,3.0,3,3,1,0
1.1258573346095359e+18,2,4,2.0,1,3,2,0
1.1258604152883798e+18,3,20,6.666666666666667,6,7,3,0
1.1258659816925375e+18,3,20,6.666666666666667,6,7,3,0
1.1258698276811098e+18,2,2,1.0,1,1,2,0
1.1258751065434033e+18,12,114,9.5,2,11,1,11
1.1258760463793573e+18,1,8,8.0,8,8,0,1
1.1258957180174753e+18,1,1,1.0,1,1,1,0
1.1259052480357212e+18,45,176,3.911111111111111,2,6,45,0
1.125915556847112e+18,1,1,1.0,1,1,1,0
1.1259192972497514e+18,21,203,9.666666666666666,5,11,2,19
1.1259223602091377e+18,1,2,2.0,2,2,1,0
1.1259817062095969e+18,18,98,5.444444444444445,4,7,18,0
1.126007697624213e+18,22,204,9.272727272727273,7,11,1,21
1.1260464287677741e+18,14,24,1.7142857142857142,1,3,14,0
1.1260929458274751e+18,47,188,4.0,2,7,47,0
1.1261022873700704e+18,12,96,8.0,7,9,3,9
1.1261205475866508e+18,31,243,7.838709677419355,3,10,11,20
1.1261281039182615e+18,10,102,10.2,9,12,0,10
1.1261628314470067e+18,1,5,5.0,5,5,1,0
1.126170212374682e+18,24,161,6.708333333333333,4,9,17,7
1.1261734852461526e+18,4,8,2.0,1,4,4,0
1.1261769995104471e+18,3,10,3.3333333333333335,3,4,3,0
1.1261863779849423e+18,7,23,3.2857142857142856,1,5,7,0
1.1262751142231885e+18,38,369,9.710526315789474,5,12,1,37
1.1263216892270129e+18,23,110,4.782608695652174,3,7,23,0
1.1264877000184795e+18,1,6,6.0,6,6,1,0
1.1264922087757933e+18,38,374,9.842105263157896,2,12,1,37
1.1265353894883078e+18,38,257,6.7631578947368425,2,10,28,10
1.1265445324873878e+18,25,247,9.88,2,12,1,24
1.1265692584983722e+18,4,29,7.25,7,8,3,1
1.1265808958801267e+18,41,151,3.682926829268293,1,6,41,0
1.1265810374215232e+18,32,297,9.28125,2,12,3,29
1.1265947809714927e+18,1,3,3.0,3,3,1,0
1.1266292073345935e+18,10,21,2.1,1,4,10,0
1.1266320731490504e+18,2,5,2.5,2,3,2,0
1.126634908783413e+18,2,6,3.0,3,3,2,0
1.1266502083617484e+18,14,103,7.357142857142857,2,10,5,9
1.1266526321091177e+18,1,7,7.0,7,7,1,0
1.1266827648262675e+18,8,48,6.0,5,8,7,1
1.1266874503519008e+18,4,23,5.75,5,7,4,0
1.1267120623041004e+18,34,296,8.705882352941176,2,12,4,30
1.1267206543808947e+18,31,63,2.032258064516129,1,3,31,0
1.1267317301038098e+18,2,5,2.5,2,3,2,0
1.1267332520082017e+18,9,21,2.3333333333333335,1,3,9,0
1.1267395617385028e+18,67,338,5.044776119402985,4,7,67,0
1.1267467289077507e+18,24,51,2.125,1,4,24,0
1.1267468722208905e+18,27,52,1.9259259259259258,1,4,27,0
1.1267470236361e+18,9,18,2.0,1,3,9,0
1.1267471628268888e+18,15,38,2.533333333333333,1,4,15,0
1.1267554209660323e+18,6,24,4.0,3,5,6,0
1.1267641123810038e+18,7,15,2.142857142857143,1,4,7,0
1.1267688382008928e+18,39,224,5.743589743589744,2,8,37,2
1.1267718498714884e+18,48,68,1.4166666666666667,1,3,48,0
1.1267739986900897e+18,49,306,6.244897959183674,4,9,42,7
1.1267751037038345e+18,34,316,9.294117647058824,2,12,3,31
1.126778799918951e+18,7,14,2.0,1,4,7,0
1.1267791777769103e+18,48,64,1.3333333333333333,1,3,48,0
1.1268051140635109e+18,5,14,2.8,2,5,5,0
1.1268139664163402e+18,13,91,7.0,5,9,10,3
1.1268212370479607e+18,13,37,2.8461538461538463,2,4,13,0
1.1268272803605475e+18,15,105,7.0,5,8,10,5
1.1268336612634022e+18,9,50,5.555555555555555,5,7,9,0
1.1268693952941944e+18,31,43,1.3870967741935485,1,3,31,0
1.1268727315645884e+18,38,57,1.5,1,3,38,0
1.1268766680101887e+18,48,273,5.6875,4,8,47,1
1.1268846975129882e+18,4,27,6.75,6,8,3,1
1.1269084019314595e+18,64,566,8.84375,5,11,8,56
1.126916574695946e+18,46,318,6.913043478260869,2,9,36,10
1.1269504808591258e+18,18,140,7.777777777777778,5,10,7,11
1.126960469821677e+18,6,8,1.3333333333333333,1,2,6,0
1.126976525009061e+18,2,15,7.5,7,8,1,1
1.1269801559423857e+18,37,262,7.081081081081081,5,9,25,12
1.1269896692474254e+18,18,165,9.166666666666666,7,11,1,17
1.1272902847781812e+18,4,7,1.75,1,2,4,0
1.1272916851957507e+18,17,38,2.235294117647059,1,4,17,0
1.1272963338052454e+18,1,1,1.0,1,1,1,0
1.1272991245068499e+18,2,14,7.0,6,8,1,1
1.1272997529199738e+18,1,2,2.0,2,2,1,0
1.1273012372388525e+18,10,102,10.2,9,12,0,10
1.1273044201204452e+18,2,17,8.5,8,9,0,2
1.1273147494838769e+18,1,3,3.0,3,3,1,0
1.1273180084657007e+18,80,182,2.275,1,4,80,0
1.1273244708104876e+18,17,41,2.411764705882353,1,4,17,0
1.1273316189860763e+18,2,9,4.5,4,5,2,0
1.1273321019206166e+18,229,476,2.078602620087336,1,4,229,0
1.1273496388744641e+18,45,106,2.3555555555555556,1,5,45,0
1.1273612857336984e+18,2,2,1.0,1,1,2,0
1.1273615725908996e+18,180,394,2.188888888888889,1,4,180,0
1.1273616338781725e+18,1,1,1.0,1,1,1,0
1.1273690103076596e+18,2,14,7.0,7,7,2,0
1.1273713225537896e+18,1,2,2.0,2,2,1,0
1.1274038773052218e+18,69,549,7.956521739130435,5,11,24,45
1.1274152393488225e+18,5,13,2.6,1,4,5,0
1.1274162000626418e+18,2,3,1.5,1,2,2,0
1.1274179701363578e+18,37,364,9.837837837837839,3,11,2,35
1.1274453304787099e+18,39,122,3.128205128205128,1,5,39,0
1.1274683162914135e+18,4,9,2.25,1,3,4,0
1.1274815988542811e+18,22,149,6.7727272727272725,2,9,14,8
1.1274890043782584e+18,19,145,7.631578947368421,6,9,8,11
1.1274915942765728e+18,6,23,3.8333333333333335,3,5,6,0
1.127562669610738e+18,24,161,6.708333333333333,2,9,17,7
1.1275723543719987e+18,3,7,2.3333333333333335,1,3,3,0
1.1275822557286516e+18,39,264,6.769230769230769,4,9,34,5
1.127635285653004e+18,8,16,2.0,1,4,8,0
1.1276539638623357e+18,1,7,7.0,7,7,1,0
1.127673126828842e+18,32,125,3.90625,2,6,32,0
1.1279237085957253e+18,45,220,4.888888888888889,3,6,45,0
1.1279964073546578e+18,42,209,4.976190476190476,3,7,42,0
1.1280090676678721e+18,1,6,6.0,6,6,1,0
1.1280305458925636e+18,1,4,4.0,4,4,1,0
1.1280649833380801e+18,55,356,6.472727272727273,2,9,41,14
1.1280764880636191e+18,1,10,10.0,10,10,0,1
1.1280960204439706e+18,3,20,6.666666666666667,6,8,2,1
1.128096876392661e+18,3,6,2.0,2,2,3,0
1.1280969587917933e+18,14,40,2.857142857142857,1,5,14,0
1.1281166725314592e+18,8,72,9.0,4,10,1,7
1.1281299206730685e+18,38,304,8.0,3,10,9,29
1.1281597160749252e+18,41,202,4.926829268292683,3,7,41,0
1.1281763131832385e+18,3,3,1.0,1,1,3,0
1.1281900435406241e+18,1,7,7.0,7,7,1,0
1.1281957715060541e+18,1,4,4.0,4,4,1,0
1.1282101692314177e+18,19,58,3.0526315789473686,1,5,19,0
1.1282191179448842e+18,6,19,3.1666666666666665,3,4,6,0
1.128230154889594e+18,2,12,6.0,6,6,2,0
1.1282386124354661e+18,1,4,4.0,4,4,1,0
1.128243263969808e+18,1,9,9.0,9,9,0,1
1.1282466913193481e+18,49,148,3.020408163265306,1,5,49,0
1.1282498041983668e+18,3,6,2.0,1,3,3,0
1.128255913077647e+18,13,34,2.6153846153846154,1,4,13,0
1.1282862142541005e+18,2,3,1.5,1,2,2,0
1.1283220053140826e+18,74,106,1.4324324324324325,1,4,74,0
1.1283290756996113e+18,41,89,2.1707317073170733,1,4,41,0
1.1283705006717609e+18,7,69,9.857142857142858,9,10,0,7
1.1287344278492019e+18,2,9,4.5,4,5,2,0
1.1287383630962168e+18,1,7,7.0,7,7,1,0
1.1287718109273078e+18,4,31,7.75,7,8,1,3
1.128777264528814e+18,3,19,6.333333333333333,5,7,3,0
1.1287810437926459e+18,1,6,6.0,6,6,1,0
1.1287811702067013e+18,6,44,7.333333333333333,6,8,3,3
1.1287988156215406e+18,96,659,6.864583333333333,2,9,73,23
1.1288350518794561e+18,87,117,1.3448275862068966,1,3,87,0
1.1288457118322597e+18,9,63,7.0,6,8,7,2
1.1288702523932012e+18,8,23,2.875,1,4,8,0
1.1289699507606225e+18,25,119,4.76,2,7,25,0
1.1290192425774615e+18,11,75,6.818181818181818,4,8,7,4
1.1290937807740695e+18,36,179,4.972222222222222,3,7,36,0
1.1291182992502964e+18,33,280,8.484848484848484,2,11,4,29
1.1291493547879945e+18,50,96,1.92,1,5,50,0
1.1293725065067453e+18,6,40,6.666666666666667,6,7,6,0
1.1295920274945536e+18,2,15,7.5,7,8,1,1
1.1296285077265435e+18,1,2,2.0,2,2,1,0
1.129664644841486e+18,1,8,8.0,8,8,0,1
1.1297173864829156e+18,6,30,5.0,4,6,6,0
1.1297272738539617e+18,16,31,1.9375,1,4,16,0
1.1297284867499165e+18,3,20,6.666666666666667,6,7,3,0
1.1297501341087436e+18,3,9,3.0,3,3,3,0
1.1297656505685783e+18,54,519,9.61111111111111,5,12,4,50
1.129782011500586e+18,56,272,4.857142857142857,2,7,56,0
1.1297998706196584e+18,15,140,9.333333333333334,2,11,1,14
1.1298216944852626e+18,23,228,9.91304347826087,8,12,0,23
1.1298361650235791e+18,9,21,2.3333333333333335,1,3,9,0
1.1298880831125325e+18,9,31,3.4444444444444446,2,4,9,0
1.130084501416771e+18,5,12,2.4,1,4,5,0
1.1301465127903981e+18,1,9,9.0,9,9,0,1
1.1301851730232489e+18,62,319,5.145161290322581,3,7,62,0
1.1302488399893271e+18,3,12,4.0,3,5,3,0
1.1302562142304069e+18,7,49,7.0,6,8,4,3
1.1302639546558154e+18,1,6,6.0,6,6,1,0
1.1302644629620963e+18,41,396,9.658536585365853,3,12,4,37
1.1302981440572147e+18,1,10,10.0,10,10,0,1
1.13034620311478e+18,15,144,9.6,4,13,1,14
1.1303508955370149e+18,7,58,8.285714285714286,7,10,1,6
1.1303549699066593e+18,13,114,8.76923076923077,6,11,1,12
1.1303744848173932e+18,3,17,5.666666666666667,5,6,3,0
1.1303937000045765e+18,22,152,6.909090909090909,4,9,15,7
1.1303937230141302e+18,37,251,6.783783783783784,2,9,27,10
1.1304124983944134e+18,4,31,7.75,7,8,1,3
1.130413437280977e+18,64,90,1.40625,1,4,64,0
1.130423010032196e+18,9,72,8.0,6,9,3,6
1.1304431876626819e+18,38,180,4.7368421052631575,2,7,38,0
1.1304501649247473e+18,32,304,9.5,2,12,2,30
1.1304604293095244e+18,5,53,10.6,9,11,0,5
1.1304637790294015e+18,1,4,4.0,4,4,1,0
1.1305086309012334e+18,2,19,9.5,9,10,0,2
1.1305124705603188e+18,23,223,9.695652173913043,4,12,1,22
1.1305552922144814e+18,1,8,8.0,8,8,0,1
1.1305560828248727e+18,8,32,4.0,3,5,8,0
1.1305576657781642e+18,20,100,5.0,2,7,20,0
1.1305705142636617e+18,26,220,8.461538461538462,5,10,4,22
1.1306187245673859e+18,3,6,2.0,2,2,3,0
1.1306926461823935e+18,1,4,4.0,4,4,1,0
1.1308868166376788e+18,17,37,2.176470588235294,1,3,17,0
1.1309043457085094e+18,2,6,3.0,3,3,2,0
1.130908174657507e+18,38,304,8.0,4,11,9,29
1.1309348044091057e+18,12,58,4.833333333333333,3,6,12,0
1.1309350710905583e+18,14,93,6.642857142857143,4,9,12,2
1.1309403329338263e+18,4,16,4.0,3,6,4,0
1.1309621800975796e+18,22,110,5.0,3,7,22,0
1.1309740402444863e+18,1,1,1.0,1,1,1,0
1.1309909085945388e+18,2,4,2.0,2,2,2,0
1.1309970128736393e+18,1,1,1.0,1,1,1,0
1.1309976610018354e+18,2,14,7.0,7,7,2,0
1.1310075214642281e+18,19,190,10.0,8,12,0,19
1.1310120101417686e+18,33,120,3.6363636363636362,1,6,33,0
1.1310136287849517e+18,9,21,2.3333333333333335,1,3,9,0
1.1310174118423763e+18,2,17,8.5,8,9,0,2
1.13107202527816e+18,30,117,3.9,2,6,30,0
1.1310828125660252e+18,22,43,1.9545454545454546,1,4,22,0
1.1310830024557868e+18,38,267,7.026315789473684,5,10,26,12
1.1310866234432229e+18,12,24,2.0,1,4,12,0
1.1311268497341967e+18,3,7,2.3333333333333335,1,3,3,0
1.131142326389958e+18,25,179,7.16,4,10,17,8
1.1311482673556462e+18,24,233,9.708333333333334,2,12,1,23
1.1311574392250365e+18,90,183,2.033333333333333,1,4,90,0
1.1311857379745449e+18,3,7,2.3333333333333335,2,3,3,0
1.1311960129253108e+18,27,40,1.4814814814814814,1,3,27,0
1.131219318932754e+18,14,99,7.071428571428571,5,8,10,4
1.1312358016421409e+18,37,352,9.513513513513514,5,12,2,35
1.1312367140696111e+18,30,153,5.1,4,7,30,0
1.131242919851041e+18,24,165,6.875,5,9,16,8
1.1312443800328717e+18,40,91,2.275,1,4,40,0
1.1313126597325294e+18,11,67,6.090909090909091,5,7,11,0
1.1315033767008701e+18,3,26,8.666666666666666,7,10,1,2
1.131661036084889e+18,9,25,2.7777777777777777,2,4,9,0
1.1316617441264795e+18,15,145,9.666666666666666,6,11,2,13
1.1316646010996064e+18,1,3,3.0,3,3,1,0
1.1316941210518643e+18,10,104,10.4,9,12,0,10
1.1317003687499729e+18,4,29,7.25,6,9,3,1
1.1317026129287846e+18,12,22,1.8333333333333333,1,3,12,0
1.1317422422622922e+18,7,41,5.857142857142857,2,8,5,2
1.131742355519477e+18,43,286,6.651162790697675,3,9,33,10
1.1317478051350266e+18,70,486,6.942857142857143,3,10,48,22
1.1317684780349592e+18,54,264,4.888888888888889,2,8,53,1
1.1317989978841262e+18,17,167,9.823529411764707,8,11,0,17
1.1318266507318659e+18,4,31,7.75,6,9,2,2
1.1318363274390131e+18,19,39,2.0526315789473686,1,3,19,0
1.13185882635376e+18,12,29,2.4166666666666665,1,5,12,0
1.1318698179116225e+18,5,24,4.8,4,6,5,0
1.1319050115316082e+18,20,94,4.7,1,7,20,0
1.1319212282121228e+18,45,209,4.644444444444445,2,7,45,0
1.1319973797685096e+18,3,16,5.333333333333333,5,6,3,0
1.1319976183930712e+18,5,5,1.0,1,1,5,0
1.1323314608260298e+18,21,211,10.047619047619047,4,13,1,20
1.132338120957858e+18,36,224,6.222222222222222,2,8,32,4
1.13234668881745e+18,15,97,6.466666666666667,5,8,14,1
1.1323483974006368e+18,20,190,9.5,3,11,1,19
1.1323985772480883e+18,1,1,1.0,1,1,1,0
1.132400786035947e+18,62,248,4.0,2,6,62,0
1.132440119703834e+18,4,26,6.5,5,8,3,1
1.1324430577093161e+18,48,183,3.8125,1,7,48,0
1.1324536663669093e+18,64,314,4.90625,2,7,64,0
1.1324759676171122e+18,59,345,5.8474576271186445,3,8,56,3
1.1324781686291146e+18,3,21,7.0,6,8,2,1
1.1324824055726643e+18,7,47,6.714285714285714,5,8,6,1
1.1324861445805126e+18,13,53,4.076923076923077,2,7,13,0
1.1325078808213147e+18,20,148,7.4,2,9,10,10
1.13253097040142e+18,5,9,1.8,1,3,5,0
1.1325786293493453e+18,2,6,3.0,3,3,2,0
1.1325895107955318e+18,14,17,1.2142857142857142,1,2,14,0
1.132597898018669e+18,43,251,5.837209302325581,3,8,39,4
1.13260510161557e+18,27,136,5.037037037037037,3,7,27,0
1.132690433219031e+18,1,2,2.0,2,2,1,0
1.1327281686693331e+18,62,304,4.903225806451613,2,8,61,1
1.1327404633336483e+18,19,80,4.2105263157894735,3,6,19,0
1.1329333226479164e+18,50,106,2.12,1,5,50,0
1.1330285823191237e+18,46,175,3.8043478260869565,1,6,46,0
1.1330829262448849e+18,51,466,9.137254901960784,5,11,3,48
1.1331081442985821e+18,21,144,6.857142857142857,3,8,14,7
1.1331111053807018e+18,16,39,2.4375,1,4,16,0
1.133115164123781e+18,33,172,5.212121212121212,3,7,33,0
1.1331226300631544e+18,25,52,2.08,1,4,25,0
1.1331471435780045e+18,72,339,4.708333333333333,2,7,72,0
1.1331519591038893e+18,2,4,2.0,2,2,2,0
1.1331542152131026e+18,2,2,1.0,1,1,2,0
1.1331630754907489e+18,7,37,5.285714285714286,4,8,6,1
1.1331790771129692e+18,8,23,2.875,2,4,8,0
1.133183072648791e+18,1,2,2.0,2,2,1,0
1.1332192657027352e+18,3,21,7.0,6,9,2,1
1.1332254035116722e+18,41,87,2.1219512195121952,1,4,41,0
1.1332613396810396e+18,9,43,4.777777777777778,3,6,9,0
1.1332624134250491e+18,10,75,7.5,6,10,5,5
1.1332702843025006e+18,8,19,2.375,1,3,8,0
1.1332940149693329e+18,4,9,2.25,2,3,4,0
1.1333283037771183e+18,1,3,3.0,3,3,1,0
1.1333473987883194e+18,3,25,8.333333333333334,7,9,1,2
1.1334482880209079e+18,43,222,5.162790697674419,3,7,43,0
1.1337782274585937e+18,71,143,2.0140845070422535,1,4,71,0
1.1338443242310221e+18,37,250,6.756756756756757,2,9,29,8
1.1338570176803432e+18,16,48,3.0,1,5,16,0
1.1338630751182788e+18,5,40,8.0,7,9,1,4
1.1338701824226824e+18,11,23,2.090909090909091,1,3,11,0
1.1338873766607638e+18,3,6,2.0,2,2,3,0
1.1339142455852671e+18,48,319,6.645833333333333,3,8,38,10
1.1339292436926559e+18,6,50,8.333333333333334,7,9,1,5
1.1339637310147529e+18,17,20,1.1764705882352942,1,3,17,0
1.1339672173943772e+18,5,43,8.6,4,12,2,3
1.1339888956352675e+18,1,6,6.0,6,6,1,0
1.1339897072621292e+18,63,357,5.666666666666667,2,8,59,4
1.1339986023081306e+18,4,13,3.25,2,5,4,0
1.134029305265325e+18,75,743,9.906666666666666,5,13,4,71
1.1341181111626586e+18,1,6,6.0,6,6,1,0
1.1345383334595067e+18,65,143,2.2,1,4,65,0
1.1345620443933253e+18,41,281,6.853658536585366,5,9,31,10
1.1345648110382377e+18,9,77,8.555555555555555,3,10,2,7
1.1345665266498726e+18,33,227,6.878787878787879,4,9,24,9
1.1345837109636431e+18,3,7,2.3333333333333335,2,3,3,0
1.1345846068683944e+18,6,42,7.0,6,8,5,1
1.1346197534818349e+18,12,25,2.0833333333333335,1,4,12,0
1.1346542055125989e+18,20,205,10.25,8,12,0,20
1.1346662606639155e+18,15,72,4.8,2,6,15,0
1.1346915979485646e+18,9,88,9.777777777777779,8,11,0,9
1.134715861645471e+18,12,81,6.75,2,9,7,5
1.1347616243905266e+18,26,125,4.8076923076923075,2,6,26,0
1.1347635765983503e+18,41,192,4.682926829268292,3,7,41,0
1.1347646213070019e+18,17,52,3.0588235294117645,1,5,17,0
1.134780665845117e+18,16,161,10.0625,9,12,0,16
1.134785421792566e+18,21,184,8.761904761904763,5,11,3,18
1.1348176102662314e+18,28,192,6.857142857142857,5,8,20,8
1.1348293919214633e+18,26,191,7.346153846153846,5,9,16,10
1.1348566978282099e+18,12,118,9.833333333333334,9,11,0,12
1.1348708255417559e+18,3,28,9.333333333333334,9,10,0,3
1.1348807729778129e+18,41,394,9.609756097560975,6,12,1,40
1.1349501494306862e+18,2,3,1.5,1,2,2,0
1.1352068019512342e+18,90,533,5.9222222222222225,2,8,84,6
1.1352193881566737e+18,6,8,1.3333333333333333,1,2,6,0
1.1352208070037797e+18,26,136,5.230769230769231,3,7,26,0
1.1352314188625188e+18,2,13,6.5,3,10,1,1
1.135247249075289e+18,1,3,3.0,3,3,1,0
1.1352896169379318e+18,15,80,5.333333333333333,4,7,15,0
1.135303092364723e+18,7,49,7.0,6,8,5,2
1.1353311557481695e+18,2,4,2.0,2,2,2,0
1.1353378458433295e+18,12,36,3.0,2,4,12,0
1.1353401667075492e+18,1,2,2.0,2,2,1,0
1.1353536583904684e+18,5,11,2.2,1,3,5,0
1.1353821848319644e+18,2,17,8.5,8,9,0,2
1.1353963468979636e+18,3,4,1.3333333333333333,1,2,3,0
1.135400487552123e+18,5,13,2.6,1,5,5,0
1.1354100588957976e+18,10,74,7.4,6,8,5,5
1.1354301050972298e+18,19,91,4.7894736842105265,4,7,19,0
1.1354485181042368e+18,3,5,1.6666666666666667,1,2,3,0
1.1354559334974063e+18,2,7,3.5,3,4,2,0
1.1354567668831708e+18,5,7,1.4,1,3,5,0
1.1355041432141174e+18,25,121,4.84,3,6,25,0
1.1355533423323686e+18,5,6,1.2,1,2,5,0
1.1355590337681196e+18,3,9,3.0,1,6,3,0
1.1355615213946624e+18,2,4,2.0,1,3,2,0
1.1355635252726056e+18,6,14,2.3333333333333335,1,3,6,0
1.1355656712806234e+18,3,6,2.0,1,3,3,0
1.1355695516532627e+18,2,5,2.5,1,4,2,0
1.1355708892132389e+18,13,26,2.0,1,4,13,0
1.1355710683714328e+18,3,20,6.666666666666667,4,8,1,2
1.1355809637669226e+18,41,124,3.024390243902439,1,5,41,0
1.1355813389391999e+18,23,44,1.9130434782608696,1,4,23,0
1.1355821852763224e+18,5,8,1.6,1,3,5,0
1.1355895290463366e+18,3,21,7.0,5,8,1,2
1.1356009636410963e+18,6,38,6.333333333333333,2,8,3,3
1.1356373784172084e+18,44,299,6.795454545454546,3,9,26,18
1.1359535592783333e+18,6,28,4.666666666666667,3,6,6,0
1.1359856602332338e+18,3,18,6.0,5,7,3,0
1.1359999747225367e+18,42,287,6.833333333333333,4,9,32,10
1.1360003963805844e+18,12,53,4.416666666666667,2,6,12,0
1.1360174482283368e+18,30,213,7.1,5,9,21,9
1.136035927061531e+18,136,171,1.2573529411764706,1,3,136,0
1.1360382512747944e+18,3,9,3.0,2,4,3,0
1.1360707148042432e+18,27,181,6.703703703703703,4,9,21,6
1.1360743224290433e+18,36,247,6.861111111111111,2,9,23,13
1.1360853410636815e+18,59,285,4.830508474576271,3,7,59,0
1.1360976567472964e+18,41,355,8.658536585365853,4,10,4,37
1.1361042441114815e+18,32,296,9.25,3,11,5,27
1.1361126826430959e+18,41,287,7.0,5,10,26,15
1.1361239920251977e+18,13,65,5.0,2,7,13,0
1.1361267484608165e+18,2,9,4.5,3,6,2,0
1.13612686826494e+18,14,82,5.857142857142857,4,7,14,0
1.1361302848210158e+18,27,244,9.037037037037036,3,12,3,24
1.1361307602183034e+18,263,1553,5.904942965779468,3,9,254,9
1.1361535276025001e+18,2,10,5.0,4,6,2,0
1.1361666579606568e+18,2,2,1.0,1,1,2,0
1.1361826743060666e+18,26,54,2.076923076923077,1,5,26,0
1.1362661896393859e+18,51,495,9.705882352941176,4,12,2,49
1.1362695070402527e+18,3,8,2.6666666666666665,2,3,3,0
1.1363177988257485e+18,43,310,7.209302325581396,4,9,25,18
1.1363312197572003e+18,2,6,3.0,2,4,2,0
1.1363920736112547e+18,33,70,2.121212121212121,1,4,33,0
1.1366887012394176e+18,9,61,6.777777777777778,6,8,8,1
1.1367113660672852e+18,5,19,3.8,2,6,5,0
1.136721912862918e+18,1,7,7.0,7,7,1,0
1.1367396296553087e+18,3,23,7.666666666666667,7,8,1,2
1.1367603313098935e+18,37,88,2.3783783783783785,1,5,37,0
1.1367663175102931e+18,55,128,2.327272727272727,1,4,55,0
1.1367687033346277e+18,36,246,6.833333333333333,5,8,28,8
1.1367725278085768e+18,9,27,3.0,2,4,9,0
1.1367733478985563e+18,57,566,9.929824561403509,2,12,1,56
1.1368072589279206e+18,13,28,2.1538461538461537,1,4,13,0
1.1368218677294263e+18,8,64,8.0,5,10,2,6
1.1368793946333171e+18,1,2,2.0,2,2,1,0
1.1368851332605755e+18,47,98,2.0851063829787235,1,5,47,0
1.1368930511213514e+18,1,1,1.0,1,1,1,0
1.1368966030934849e+18,2,16,8.0,8,8,0,2
1.1369013287554815e+18,11,63,5.7272727272727275,4,7,11,0
1.1369170489439708e+18,4,38,9.5,7,12,1,3
1.1369402570697085e+18,12,23,1.9166666666666667,1,4,12,0
1.1369454684964233e+18,26,181,6.961538461538462,5,10,20,6
1.1369753580111135e+18,68,478,7.029411764705882,4,10,46,22
1.1369821594852794e+18,5,18,3.6,3,4,5,0
1.137011949748033e+18,4,22,5.5,5,6,4,0
1.1370126479627345e+18,1,1,1.0,1,1,1,0
1.1370212455778829e+18,24,169,7.041666666666667,5,9,16,8
1.1370439646979601e+18,80,402,5.025,2,7,80,0
1.1370463586067941e+18,30,208,6.933333333333334,5,9,20,10
1.1371148670293101e+18,48,133,2.7708333333333335,1,6,48,0
1.1371813049266568e+18,6,11,1.8333333333333333,1,3,6,0
1.1372972376378607e+18,1,2,2.0,2,2,1,0
1.137396955464347e+18,6,40,6.666666666666667,3,9,5,1
1.1374058830211471e+18,10,51,5.1,3,7,10,0
1.1374347560509288e+18,2,13,6.5,6,7,2,0
1.1374751721963982e+18,5,11,2.2,1,4,5,0
1.1374862980591405e+18,6,53,8.833333333333334,7,11,2,4
1.1374987627028654e+18,2,2,1.0,1,1,2,0
1.1374987730876938e+18,4,13,3.25,2,4,4,0
1.1374987880014738e+18,4,6,1.5,1,3,4,0
1.1374999610944324e+18,67,652,9.73134328358209,6,12,3,64
1.1375097788961924e+18,1,2,2.0,2,2,1,0
1.1375105861921801e+18,17,84,4.9411764705882355,2,8,16,1
1.1375151523914431e+18,14,132,9.428571428571429,4,12,1,13
1.137518194451418e+18,35,173,4.942857142857143,3,7,35,0
1.137526347205933e+18,6,52,8.666666666666666,7,10,2,4
1.1376225516790162e+18,1,1,1.0,1,1,1,0
1.1376282349971804e+18,1,1,1.0,1,1,1,0
1.1376366740706463e+18,3,9,3.0,2,4,3,0
1.1376683150633688e+18,2,16,8.0,7,9,1,1
1.1376792461060868e+18,39,166,4.256410256410256,2,6,39,0
1.1376853991347187e+18,3,18,6.0,5,8,2,1
1.1377262460270184e+18,11,35,3.1818181818181817,1,5,11,0
1.1377417816044975e+18,34,73,2.1470588235294117,1,5,34,0
1.1378128787156844e+18,24,46,1.9166666666666667,1,4,24,0
1.1378277907520998e+18,14,137,9.785714285714286,4,11,1,13
1.1378903744893404e+18,68,636,9.352941176470589,2,12,6,62
1.1379274731111877e+18,51,495,9.705882352941176,5,12,1,50
1.138120913903512e+18,7,45,6.428571428571429,5,8,5,2
1.138123923046645e+18,17,155,9.117647058823529,3,11,1,16
1.1381445010970897e+18,6,42,7.0,3,9,3,3
1.1381632617824739e+18,17,176,10.352941176470589,8,12,0,17
1.1381789797331558e+18,4,27,6.75,6,7,4,0
1.138183716256299e+18,6,49,8.166666666666666,7,10,2,4
1.1381992636750492e+18,42,401,9.547619047619047,4,12,4,38
1.1382070942449847e+18,23,226,9.826086956521738,4,12,1,22
1.1382806190789499e+18,1,3,3.0,3,3,1,0
1.1382852791151366e+18,173,844,4.878612716763006,2,7,173,0
1.138317858489755e+18,4,25,6.25,3,8,3,1
1.1383215108659474e+18,12,28,2.3333333333333335,1,4,12,0
1.1383365811117797e+18,15,32,2.1333333333333333,1,4,15,0
1.1383371102209219e+18,15,142,9.466666666666667,5,12,1,14
1.1383511473309628e+18,83,717,8.63855421686747,4,11,9,74
1.1383926527026193e+18,5,34,6.8,5,9,3,2
1.1383940151355821e+18,125,257,2.056,1,5,125,0
1.1384167381705233e+18,13,26,2.0,1,4,13,0
1.1385359183012968e+18,4,6,1.5,1,2,4,0
1.1385833529801148e+18,17,173,10.176470588235293,7,12,1,16
1.138921119288365e+18,27,182,6.7407407407407405,3,9,17,10
1.1389254733257266e+18,6,39,6.5,5,8,4,2
1.1390099498268593e+18,5,34,6.8,6,8,4,1
1.1390229727265137e+18,3,18,6.0,5,7,3,0
1.1390352478779205e+18,2,17,8.5,8,9,0,2
1.1390435623763867e+18,2,11,5.5,5,6,2,0
1.139049074866258e+18,1,8,8.0,8,8,0,1
1.1390497619969656e+18,1,1,1.0,1,1,1,0
1.1390566843154414e+18,1,7,7.0,7,7,1,0
1.1390568107919156e+18,9,22,2.4444444444444446,1,4,9,0
1.1390727893001978e+18,5,10,2.0,2,2,5,0
1.139078151545751e+18,3,17,5.666666666666667,5,6,3,0
1.1390834601107176e+18,31,152,4.903225806451613,3,7,31,0
1.1391054617640905e+18,32,40,1.25,1,3,32,0
1.1391142872363784e+18,4,28,7.0,5,8,2,2
1.1391148364046103e+18,11,99,9.0,5,11,1,10
1.1391163307813921e+18,44,92,2.090909090909091,1,4,44,0
1.1391202363037458e+18,1,7,7.0,7,7,1,0
1.1391455155693078e+18,10,91,9.1,2,11,1,9
1.1391500957782248e+18,1,5,5.0,5,5,1,0
1.1391512587043676e+18,3,18,6.0,6,6,3,0
1.1391578377720028e+18,7,26,3.7142857142857144,3,4,7,0
1.1391595595888936e+18,3,5,1.6666666666666667,1,2,3,0
1.1391653490834738e+18,3,17,5.666666666666667,4,7,3,0
1.1391729075645066e+18,8,53,6.625,5,9,7,1
1.1392609008028342e+18,7,18,2.5714285714285716,2,4,7,0
1.1395005086941002e+18,6,14,2.3333333333333335,1,4,6,0
1.1396088951645373e+18,1,7,7.0,7,7,1,0
1.1396312835248132e+18,35,103,2.942857142857143,1,6,35,0
1.1396408018248371e+18,57,119,2.087719298245614,1,4,57,0
1.1396420068929876e+18,92,446,4.8478260869565215,2,7,92,0
1.1397387169006898e+18,17,38,2.235294117647059,1,4,17,0
1.1397425070126644e+18,8,56,7.0,6,8,5,3
1.1397786690047354e+18,17,85,5.0,3,7,17,0
1.1397804002733682e+18,38,367,9.657894736842104,3,12,2,36
1.1398185010085202e+18,87,137,1.5747126436781609,1,4,87,0
1.1398259839477665e+18,1,5,5.0,5,5,1,0
1.13982635793145e+18,1,2,2.0,2,2,1,0
1.1398321049520449e+18,30,304,10.133333333333333,4,13,1,29
1.1398665900547383e+18,35,282,8.057142857142857,5,11,11,24
1.1398983174542993e+18,1,2,2.0,2,2,1,0
1.1399155878581247e+18,16,160,10.0,7,12,1,15
1.1399253262620466e+18,60,304,5.066666666666666,2,7,60,0
1.1399374471746877e+18,60,508,8.466666666666667,3,11,8,52
1.1399420092895411e+18,37,189,5.108108108108108,2,7,37,0
1.1399505285763272e+18,19,58,3.0526315789473686,1,5,19,0
1.139959965343505e+18,4,19,4.75,3,6,4,0
1.1399668750547731e+18,37,184,4.972972972972973,3,7,37,0
1.1399683099193839e+18,2,3,1.5,1,2,2,0
1.1399854213729245e+18,3,4,1.3333333333333333,1,2,3,0
1.1402953057835374e+18,24,179,7.458333333333333,4,10,9,15
1.140325140601816e+18,28,260,9.285714285714286,2,12,3,25
1.1403281242017824e+18,1,4,4.0,4,4,1,0
1.1403329730939233e+18,9,66,7.333333333333333,5,9,5,4
1.1403529970149924e+18,5,10,2.0,1,3,5,0
1.1403571288739076e+18,63,426,6.761904761904762,3,9,47,16
1.1403686383373448e+18,48,99,2.0625,1,4,48,0
1.1403760662391789e+18,3,16,5.333333333333333,5,6,3,0
1.1403774794275448e+18,2,4,2.0,1,3,2,0
1.1403779310682189e+18,3,6,2.0,1,3,3,0
1.140389618177299e+18,30,299,9.966666666666667,5,12,1,29
1.1403958334656869e+18,23,234,10.173913043478262,9,12,0,23
1.1403979924797544e+18,1,9,9.0,9,9,0,1
1.1403980429798738e+18,9,59,6.555555555555555,5,8,8,1
1.1404029511670098e+18,15,81,5.4,4,7,15,0
1.1404107276475548e+18,52,157,3.019230769230769,1,5,52,0
1.1404126205717746e+18,15,95,6.333333333333333,4,9,14,1
1.1404482819181158e+18,15,62,4.133333333333334,2,6,15,0
1.1404701357506762e+18,18,89,4.944444444444445,3,7,18,0
1.1404702805135965e+18,9,78,8.666666666666666,8,10,0,9
1.1405138080905166e+18,30,54,1.8,1,4,30,0
1.1405317519402358e+18,8,24,3.0,2,5,8,0
1.140548119784274e+18,13,90,6.923076923076923,5,9,10,3
1.1405644909253612e+18,6,44,7.333333333333333,3,9,2,4
1.1405690384293669e+18,5,36,7.2,6,9,3,2
1.140573842545179e+18,14,93,6.642857142857143,4,8,11,3
1.1405740336173656e+18,31,61,1.967741935483871,1,4,31,0
1.1405744125726152e+18,23,141,6.130434782608695,2,8,22,1
1.1405746777694464e+18,33,64,1.9393939393939394,1,3,33,0
1.1405770921105376e+18,1,7,7.0,7,7,1,0
1.1406613941418281e+18,7,27,3.857142857142857,3,5,7,0
1.1407031371874706e+18,31,154,4.967741935483871,2,8,30,1
1.14073382073534e+18,1,5,5.0,5,5,1,0
1.1409266259345727e+18,71,500,7.042253521126761,4,10,49,22
1.1410243975924673e+18,17,161,9.470588235294118,5,11,1,16
1.1410381900117388e+18,20,190,9.5,6,12,1,19
1.1410509062146355e+18,11,75,6.818181818181818,3,9,5,6
1.1410509882091314e+18,1,1,1.0,1,1,1,0
1.1410973884861944e+18,1,6,6.0,6,6,1,0
1.1411220989287776e+18,43,86,2.0,1,5,43,0
1.1411347497030688e+18,24,140,5.833333333333333,3,8,22,2
1.1411363654796092e+18,13,24,1.8461538461538463,1,3,13,0
1.1411748467607278e+18,6,49,8.166666666666666,7,9,1,5
1.1411816934078565e+18,12,24,2.0,1,3,12,0
1.1411880098544566e+18,4,8,2.0,1,3,4,0
1.1411950204316646e+18,3,23,7.666666666666667,6,9,1,2
1.1412056325567434e+18,14,125,8.928571428571429,3,10,3,11
1.1412062877515087e+18,2,6,3.0,3,3,2,0
1.1412279033085275e+18,44,126,2.8636363636363638,1,5,44,0
1.1412475058723916e+18,15,56,3.7333333333333334,2,6,15,0
1.1412704583942104e+18,26,120,4.615384615384615,3,6,26,0
1.1412800502508777e+18,7,54,7.714285714285714,6,9,3,4
1.1412905387249e+18,7,21,3.0,1,6,7,0
1.1412982616901225e+18,33,156,4.7272727272727275,1,7,33,0
1.1413106027964179e+18,29,289,9.96551724137931,6,12,2,27
1.1413812412209747e+18,14,73,5.214285714285714,4,7,14,0
1.1414858621218392e+18,16,93,5.8125,2,8,15,1
1.1417228959567292e+18,3,25,8.333333333333334,8,9,0,3
1.1417629149623827e+18,7,14,2.0,1,3,7,0
1.1417671130667592e+18,5,36,7.2,5,8,2,3
1.1417675216903448e+18,5,19,3.8,3,4,5,0
1.141770139372768e+18,3,26,8.666666666666666,8,9,0,3
1.1417720626161545e+18,34,171,5.029411764705882,2,7,34,0
1.1417728481397015e+18,1,2,2.0,2,2,1,0
1.1417768263701212e+18,7,21,3.0,1,4,7,0
1.1417943165182546e+18,1,3,3.0,3,3,1,0
1.1417954086397928e+18,4,17,4.25,4,5,4,0
1.1418001614847781e+18,8,21,2.625,2,4,8,0
1.1418110404463757e+18,2,6,3.0,3,3,2,0
1.1418156879852759e+18,13,116,8.923076923076923,4,12,3,10
1.1418170844214008e+18,7,17,2.4285714285714284,2,3,7,0
1.1418298367699567e+18,3,5,1.6666666666666667,1,3,3,0
1.1418351920293992e+18,6,8,1.3333333333333333,1,2,6,0
1.1418370587706723e+18,4,9,2.25,2,3,4,0
1.141837497471426e+18,6,13,2.1666666666666665,1,4,6,0
1.141845294334476e+18,5,23,4.6,3,6,5,0
1.1418510072474732e+18,7,26,3.7142857142857144,3,5,7,0
1.1418538035744175e+18,4,9,2.25,2,3,4,0
1.141859627362309e+18,2,5,2.5,2,3,2,0
1.1418801797900234e+18,3,10,3.3333333333333335,3,4,3,0
1.1418803325362903e+18,6,18,3.0,2,4,6,0
1.141891784969897e+18,6,12,2.0,1,3,6,0
1.1418964761352888e+18,3,11,3.6666666666666665,3,4,3,0
1.1419547177101544e+18,10,69,6.9,6,8,9,1
1.1419572490248425e+18,1,4,4.0,4,4,1,0
1.1419588173119788e+18,4,8,2.0,1,3,4,0
1.1419764374671886e+18,10,24,2.4,1,4,10,0
1.1419788442194454e+18,4,7,1.75,1,2,4,0
1.1419817480929673e+18,1,3,3.0,3,3,1,0
1.1420220759171123e+18,2,5,2.5,1,4,2,0
1.1420863627425605e+18,4,34,8.5,7,10,1,3
1.1420938023217564e+18,1,3,3.0,3,3,1,0
1.1424763069017471e+18,11,46,4.181818181818182,3,6,11,0
1.1424774941666031e+18,38,184,4.842105263157895,2,7,38,0
1.142477522903539e+18,9,63,7.0,5,9,5,4
1.1425342075318812e+18,4,11,2.75,2,4,4,0
1.1425395514958077e+18,55,532,9.672727272727272,2,12,2,53
1.1425547524960195e+18,1,3,3.0,3,3,1,0
1.1425584073264842e+18,29,281,9.689655172413794,6,12,2,27
1.1425656914511631e+18,16,32,2.0,1,3,16,0
1.1425703908722372e+18,11,82,7.454545454545454,6,9,7,4
1.1425816514742468e+18,10,22,2.2,1,3,10,0
1.1425980571936485e+18,58,494,8.517241379310345,2,11,9,49
1.1426463363317021e+18,16,31,1.9375,1,4,16,0
1.1426494102797028e+18,8,79,9.875,6,12,1,7
1.142664114048734e+18,4,10,2.5,2,4,4,0
1.1426832363580645e+18,17,34,2.0,1,4,17,0
1.1426971093156956e+18,4,10,2.5,2,3,4,0
1.1427099092567813e+18,1,4,4.0,4,4,1,0
1.1427170992546865e+18,23,116,5.043478260869565,3,7,23,0
1.1427517453143523e+18,5,23,4.6,3,6,5,0
1.1427779796640355e+18,20,106,5.3,4,8,19,1
1.1428134148563232e+18,11,32,2.909090909090909,1,4,11,0
1.1428168798762707e+18,54,511,9.462962962962964,2,12,4,50
1.1428229671518025e+18,13,42,3.230769230769231,2,5,13,0
1.1428544970974724e+18,19,77,4.052631578947368,1,6,19,0
1.1428572746799711e+18,9,78,8.666666666666666,5,11,2,7
1.1428633696855873e+18,23,117,5.086956521739131,3,8,22,1
1.143155769007182e+18,1,7,7.0,7,7,1,0
1.1432384194837239e+18,2,4,2.0,1,3,2,0
1.1432429439633615e+18,1,9,9.0,9,9,0,1
1.1432450684945727e+18,38,74,1.9473684210526316,1,4,38,0
1.1432463047224543e+18,36,110,3.0555555555555554,2,6,36,0
1.1432521196266579e+18,3,4,1.3333333333333333,1,2,3,0
1.143255431379242e+18,3,7,2.3333333333333335,1,3,3,0
1.1432560462078028e+18,11,112,10.181818181818182,8,12,0,11
1.1432668454622559e+18,55,533,9.690909090909091,3,12,3,52
1.1432940071233896e+18,9,64,7.111111111111111,7,8,8,1
1.143303194919638e+18,1,8,8.0,8,8,0,1
1.1433495882129198e+18,5,42,8.4,4,10,1,4
1.1433635046180764e+18,18,178,9.88888888888889,8,11,0,18
1.1433890469092415e+18,4,38,9.5,7,11,1,3
1.1433892570504164e+18,2,14,7.0,6,8,1,1
1.1433922302526367e+18,16,55,3.4375,2,5,16,0
1.14340922061267e+18,10,98,9.8,8,11,0,10
1.1434186140000879e+18,61,119,1.9508196721311475,1,5,61,0
1.1434317424235057e+18,12,83,6.916666666666667,5,9,9,3
1.1434556995818002e+18,16,31,1.9375,1,3,16,0
1.143477980010899e+18,19,175,9.210526315789474,5,11,2,17
1.143480173956036e+18,1,2,2.0,2,2,1,0
1.1435240095529856e+18,15,61,4.066666666666666,2,6,15,0
1.1435294587337972e+18,2,10,5.0,3,7,2,0
1.143564015506507e+18,6,15,2.5,2,3,6,0
1.1435696203031533e+18,4,14,3.5,2,5,4,0
1.1435747535159372e+18,2,7,3.5,3,4,2,0
1.1435964887306239e+18,28,274,9.785714285714286,4,12,1,27
1.1436993594643333e+18,9,67,7.444444444444445,6,9,5,4
1.1437014991605688e+18,4,21,5.25,4,7,4,0
1.1437170988110702e+18,46,152,3.3043478260869565,1,5,46,0
1.1437557252594665e+18,40,78,1.95,1,4,40,0
1.143896024663604e+18,30,154,5.133333333333334,2,8,29,1
1.1439269002131418e+18,22,195,8.863636363636363,7,11,2,20
1.144050345317928e+18,2,19,9.5,9,10,0,2
1.1440575221130317e+18,9,73,8.11111111111111,3,9,1,8
1.1440711287677134e+18,22,201,9.136363636363637,7,11,1,21
1.1440994946144239e+18,17,91,5.352941176470588,4,7,17,0
1.1441043034444956e+18,48,143,2.9791666666666665,1,5,48,0
1.1441295383904666e+18,38,239,6.2894736842105265,4,8,33,5
1.1441494801484488e+18,1,8,8.0,8,8,0,1
1.1441681055962477e+18,16,34,2.125,1,3,16,0
1.1441780845763951e+18,20,97,4.85,4,7,20,0
1.1442013244502525e+18,6,26,4.333333333333333,4,5,6,0
1.1442053552489162e+18,6,14,2.3333333333333335,1,3,6,0
1.1442096657302209e+18,18,118,6.555555555555555,3,9,14,4
1.1442097332727506e+18,47,190,4.042553191489362,2,7,47,0
1.1442436065434468e+18,8,52,6.5,4,8,7,1
1.1442537794941009e+18,17,131,7.705882352941177,3,10,7,10
1.144290840745223e+18,2,5,2.5,2,3,2,0
1.1443417736553635e+18,26,177,6.8076923076923075,2,8,17,9
1.1446104210213468e+18,1,1,1.0,1,1,1,0
1.1446746984709763e+18,2,19,9.5,9,10,0,2
1.1447168400727863e+18,1,1,1.0,1,1,1,0
1.1447337753396892e+18,24,234,9.75,5,12,1,23
1.1447491338370533e+18,56,114,2.0357142857142856,1,4,56,0
1.1447740176010606e+18,11,115,10.454545454545455,8,12,0,11
1.144787291589233e+18,5,42,8.4,8,9,0,5
1.1448368198953605e+18,77,149,1.9350649350649352,1,4,77,0
1.1448455538656229e+18,34,321,9.441176470588236,2,12,4,30
1.1448649103045809e+18,31,302,9.741935483870968,4,12,2,29
1.1448814056312566e+18,17,39,2.2941176470588234,1,3,17,0
1.1449092503866154e+18,2,6,3.0,3,3,2,0
1.1449526104609766e+18,22,104,4.7272727272727275,3,7,22,0
1.1449560892241199e+18,20,196,9.8,7,12,2,18
1.1450240363664646e+18,17,148,8.705882352941176,6,11,3,14
1.1450422018343251e+18,13,41,3.1538461538461537,1,6,13,0
1.1450523169844298e+18,10,23,2.3,1,4,10,0
1.1453433218320641e+18,11,30,2.727272727272727,2,4,11,0
1.1454149702825362e+18,11,27,2.4545454545454546,1,4,11,0
1.145436080118663e+18,30,70,2.3333333333333335,1,4,30,0
1.1454491786149887e+18,15,147,9.8,8,12,0,15
1.1454571864316413e+18,14,48,3.4285714285714284,2,5,14,0
1.1454610142073466e+18,1,9,9.0,9,9,0,1
1.1454760956431948e+18,2,7,3.5,3,4,2,0
1.1455119414120695e+18,39,184,4.717948717948718,3,7,39,0
1.1455129649713618e+18,17,40,2.3529411764705883,1,4,17,0
1.145563620221919e+18,29,152,5.241379310344827,3,7,29,0
1.1455677797136173e+18,11,28,2.5454545454545454,2,4,11,0
1.145573942552374e+18,32,133,4.15625,2,6,32,0
1.1455789140840387e+18,19,125,6.578947368421052,3,8,15,4
1.145609949951754e+18,63,240,3.8095238095238093,1,6,63,0
1.1456359277342483e+18,32,85,2.65625,1,4,32,0
1.1456417359472307e+18,9,17,1.8888888888888888,1,3,9,0
1.1456520407841373e+18,19,164,8.631578947368421,7,10,1,18
1.1456949945435118e+18,4,28,7.0,6,8,3,1
1.14570357344453e+18,22,205,9.318181818181818,3,11,2,20
1.1457131428960328e+18,18,72,4.0,2,7,18,0
1.1457168434829871e+18,28,134,4.785714285714286,4,6,28,0
1.1457264914409133e+18,6,44,7.333333333333333,2,10,2,4
1.1457333333794509e+18,5,41,8.2,7,9,1,4
1.1457675604449623e+18,3,26,8.666666666666666,7,10,1,2
1.1457777956486198e+18,21,137,6.523809523809524,4,9,17,4
1.1457823419425714e+18,25,70,2.8,1,4,25,0
1.1457982151951796e+18,2,5,2.5,1,4,2,0
1.1458032432751596e+18,4,7,1.75,1,3,4,0
1.1458210158327511e+18,14,33,2.357142857142857,1,4,14,0
1.146087894929253e+18,6,11,1.8333333333333333,1,3,6,0
1.1461226947455086e+18,5,21,4.2,2,5,5,0
1.1461275557280301e+18,14,125,8.928571428571429,7,10,2,12
1.1461668926425261e+18,9,62,6.888888888888889,3,9,4,5
1.146169032702309e+18,24,213,8.875,7,11,3,21
1.1461850272893741e+18,5,20,4.0,3,5,5,0
1.146214585742416e+18,16,49,3.0625,1,6,16,0
1.1462238541135583e+18,42,212,5.0476190476190474,2,7,42,0
1.1462368057079928e+18,5,10,2.0,1,3,5,0
1.1462489424206912e+18,5,33,6.6,3,9,3,2
1.1462651350886733e+18,9,17,1.8888888888888888,1,3,9,0
1.1462713393347446e+18,14,68,4.857142857142857,2,7,14,0
1.1462847374040205e+18,4,30,7.5,6,9,2,2
1.1462984073942394e+18,19,137,7.2105263157894735,3,9,9,10
1.1463191638787269e+18,34,236,6.9411764705882355,4,9,26,8
1.1463388430238104e+18,11,56,5.090909090909091,4,6,11,0
1.1463392899348431e+18,6,30,5.0,4,6,6,0
1.1463466650145512e+18,12,20,1.6666666666666667,1,4,12,0
1.1463487602268321e+18,15,59,3.933333333333333,1,6,15,0
1.1463492614165325e+18,12,65,5.416666666666667,4,7,12,0
1.1463632226000279e+18,44,298,6.7727272727272725,4,10,32,12
1.1463655286434409e+18,2,8,4.0,3,5,2,0
1.1463665098443194e+18,7,28,4.0,2,6,7,0
1.1463669643406405e+18,13,52,4.0,2,5,13,0
1.1463683480537119e+18,24,120,5.0,3,7,24,0
1.1463755310702134e+18,17,67,3.9411764705882355,2,6,17,0
1.146379369766299e+18,4,9,2.25,2,3,4,0
1.1463826351353347e+18,13,69,5.3076923076923075,4,7,13,0
1.1463851271543087e+18,20,80,4.0,3,6,20,0
1.1463877815922839e+18,7,39,5.571428571428571,4,7,7,0
1.1463901736728809e+18,36,302,8.38888888888889,2,10,6,30
1.1464000245199176e+18,18,61,3.388888888888889,2,5,18,0
1.1464001838046962e+18,8,32,4.0,2,5,8,0
1.1464062517926431e+18,5,28,5.6,5,7,5,0
1.1464246524433664e+18,21,185,8.80952380952381,5,10,3,18
1.1464301985420348e+18,30,179,5.966666666666667,4,7,30,0
1.1464337204981167e+18,11,38,3.4545454545454546,2,5,11,0
1.1464637672808978e+18,8,27,3.375,2,5,8,0
1.1465185412187732e+18,34,205,6.029411764705882,3,8,33,1
1.1465667727288822e+18,25,149,5.96,4,8,22,3
1.1468127865214296e+18,17,125,7.352941176470588,5,9,10,7
1.1468474163763524e+18,7,21,3.0,2,4,7,0
1.1468995677459807e+18,33,39,1.1818181818181819,1,2,33,0
1.1469042644423404e+18,13,117,9.0,7,11,3,10
1.1469144647003265e+18,6,39,6.5,5,8,5,1
1.1469429587820567e+18,19,168,8.842105263157896,6,12,2,17
1.1469439000017866e+18,20,43,2.15,1,4,20,0
1.1469523903519485e+18,23,118,5.130434782608695,2,7,23,0
1.1469814019316051e+18,22,115,5.2272727272727275,3,7,22,0
1.1470803982155588e+18,49,344,7.020408163265306,4,10,32,17
1.1471237913270912e+18,34,65,1.911764705882353,1,4,34,0
1.1471290156232006e+18,21,86,4.095238095238095,2,6,21,0
1.147157661062418e+18,38,336,8.842105263157896,3,11,4,34
1.1471771649844861e+18,28,263,9.392857142857142,2,12,3,25
1.1471778349433074e+18,3,14,4.666666666666667,4,6,3,0
1.1471829968683003e+18,3,27,9.0,8,10,0,3
1.1471997326182546e+18,14,54,3.857142857142857,2,6,14,0
1.147281944568122e+18,1,4,4.0,4,4,1,0
1.1475210416740815e+18,2,13,6.5,6,7,2,0
1.1476044443143396e+18,2,19,9.5,9,10,0,2
1.14760499650044e+18,8,81,10.125,8,12,0,8
1.1476075197538874e+18,4,27,6.75,6,8,3,1
1.1476136766799087e+18,27,108,4.0,2,6,27,0
1.1476146400255231e+18,2,9,4.5,4,5,2,0
1.1476453658820801e+18,1,8,8.0,8,8,0,1
1.1476773678269085e+18,42,388,9.238095238095237,2,12,4,38
1.147730961581739e+18,1,4,4.0,4,4,1,0
1.1477345650161704e+18,32,310,9.6875,4,12,2,30
1.1477410965716983e+18,22,152,6.909090909090909,2,9,15,7
1.1477427865991037e+18,7,10,1.4285714285714286,1,2,7,0
1.1477430112837171e+18,36,215,5.972222222222222,3,8,33,3
1.1477498224022922e+18,1,2,2.0,2,2,1,0
1.1477608728456289e+18,31,153,4.935483870967742,2,7,31,0
1.1477618784134533e+18,2,3,1.5,1,2,2,0
1.1477986004909475e+18,8,78,9.75,8,11,0,8
1.1478079880074575e+18,33,201,6.090909090909091,3,8,30,3
1.1478283498784957e+18,24,123,5.125,4,7,24,0
1.147845231141545e+18,8,71,8.875,8,9,0,8
1.1478589904442395e+18,63,446,7.079365079365079,2,9,41,22
1.1478694134125426e+18,38,206,5.421052631578948,2,8,36,2
1.147883730200787e+18,3,21,7.0,6,8,2,1
1.1478890588321272e+18,14,74,5.285714285714286,2,8,13,1
1.1479387033758323e+18,14,117,8.357142857142858,4,10,2,12
1.1479625045101971e+18,29,113,3.896551724137931,2,6,29,0
1.1481977042838395e+18,1,8,8.0,8,8,0,1
1.1482498992258637e+18,12,60,5.0,3,7,12,0
1.1482506742795398e+18,25,240,9.6,7,11,1,24
1.1482767961707548e+18,1,4,4.0,4,4,1,0
1.1482827621959359e+18,12,24,2.0,1,4,12,0
1.1482829282650856e+18,2,5,2.5,1,4,2,0
1.1482829940578476e+18,95,564,5.936842105263158,2,9,88,7
1.1482871911339881e+18,9,82,9.11111111111111,4,11,1,8
1.1483278162367813e+18,18,94,5.222222222222222,3,7,18,0
1.1483361251183583e+18,1,6,6.0,6,6,1,0
1.1483366598750184e+18,1,2,2.0,2,2,1,0
1.1483425860687532e+18,3,3,1.0,1,1,3,0
1.1483482237561989e+18,2,3,1.5,1,2,2,0
1.1483682640807553e+18,3,5,1.6666666666666667,1,2,3,0
1.148378303739514e+18,3,12,4.0,4,4,3,0
1.1483925500781656e+18,42,246,5.857142857142857,4,8,40,2
1.1483927103516922e+18,1,7,7.0,7,7,1,0
1.148427076882061e+18,17,23,1.3529411764705883,1,3,17,0
1.1484534706724493e+18,11,19,1.7272727272727273,1,3,11,0
1.1484667922675213e+18,40,128,3.2,1,5,40,0
1.1484707230964694e+18,14,72,5.142857142857143,3,7,14,0
1.1484879465897939e+18,3,6,2.0,1,3,3,0
1.1485246358824599e+18,4,31,7.75,7,8,1,3
1.1485310472140536e+18,2,16,8.0,7,9,1,1
1.1485809353478045e+18,2,7,3.5,3,4,2,0
1.1485818097166813e+18,2,10,5.0,2,8,1,1
1.1485971941347215e+18,13,67,5.153846153846154,3,7,13,0
1.1485985190174806e+18,40,352,8.8,4,11,5,35
1.1486170817553202e+18,14,98,7.0,5,9,10,4
1.1486636295738904e+18,20,121,6.05,4,8,19,1
1.1486666532214455e+18,34,303,8.911764705882353,5,11,4,30
1.1486739728268795e+18,31,269,8.67741935483871,4,10,3,28
1.1489981371925111e+18,6,41,6.833333333333333,6,7,6,0
1.1490209001874694e+18,20,94,4.7,3,7,20,0
1.1490697049374367e+18,31,231,7.451612903225806,3,9,16,15
1.1491834127614758e+18,22,210,9.545454545454545,5,12,1,21
1.1491944723753632e+18,53,304,5.735849056603773,3,7,53,0
1.149206791440613e+18,26,244,9.384615384615385,2,12,3,23
1.1492331819544063e+18,39,291,7.461538461538462,5,9,18,21
1.1492527014629174e+18,20,136,6.8,5,8,15,5
1.1493288254336024e+18,55,215,3.909090909090909,2,6,55,0
1.1493560224989938e+18,28,136,4.857142857142857,3,6,28,0
1.1494614968796527e+18,28,136,4.857142857142857,3,6,28,0
1.1495257330839519e+18,6,40,6.666666666666667,6,8,5,1
1.1496957532567848e+18,13,20,1.5384615384615385,1,3,13,0
1.1497433894665274e+18,6,42,7.0,6,8,5,1
1.1498370814570656e+18,2,14,7.0,6,8,1,1
1.1499840813727722e+18,11,108,9.818181818181818,7,11,1,10
1.1499940534545912e+18,25,55,2.2,1,5,25,0
1.1500766407987884e+18,3,7,2.3333333333333335,1,4,3,0
1.1500783356660678e+18,4,5,1.25,1,2,4,0
1.1500959885370723e+18,44,294,6.681818181818182,3,9,33,11
1.1500990121692568e+18,15,21,1.4,1,3,15,0
1.1501012174682746e+18,18,163,9.055555555555555,3,11,2,16
1.1501405031953972e+18,14,75,5.357142857142857,4,7,14,0
1.1501661167670322e+18,76,160,2.1052631578947367,1,4,76,0
1.1502232876120077e+18,39,84,2.1538461538461537,1,4,39,0
1.1504839592261906e+18,15,31,2.066666666666667,1,5,15,0
1.1505414756633862e+18,42,283,6.738095238095238,4,9,35,7
1.150556370219793e+18,1,4,4.0,4,4,1,0
1.1505663017187487e+18,1,4,4.0,4,4,1,0
1.1506259958407773e+18,18,126,7.0,5,8,13,5
1.1506921071680803e+18,11,68,6.181818181818182,4,9,9,2
1.1506969530447547e+18,19,107,5.631578947368421,2,7,19,0
1.1507300329032722e+18,17,34,2.0,1,4,17,0
1.1507874786169864e+18,51,205,4.019607843137255,2,7,51,0
1.1507943947204602e+18,7,58,8.285714285714286,7,10,3,4
1.1508038114726248e+18,68,140,2.0588235294117645,1,5,68,0
1.1508243741017548e+18,1,4,4.0,4,4,1,0
1.1508757396075233e+18,63,124,1.9682539682539681,1,5,63,0
1.1508844012613293e+18,89,181,2.033707865168539,1,5,89,0
1.150895182600924e+18,83,160,1.927710843373494,1,4,83,0
1.1511701491612677e+18,14,132,9.428571428571429,3,12,2,12
1.1511806645813105e+18,17,164,9.647058823529411,7,12,1,16
1.1511930727044479e+18,23,159,6.913043478260869,5,9,16,7
1.1512068907796544e+18,1,10,10.0,10,10,0,1
1.1512504965205856e+18,4,39,9.75,9,10,0,4
1.1512590619918747e+18,4,9,2.25,1,3,4,0
1.1512643425477942e+18,29,149,5.137931034482759,2,8,28,1
1.1512866006456037e+18,21,204,9.714285714285714,2,11,1,20
1.1512945578080084e+18,18,38,2.111111111111111,1,5,18,0
1.15129757728243e+18,14,30,2.142857142857143,1,3,14,0
1.151300201987791e+18,1,8,8.0,8,8,0,1
1.1513058390707099e+18,23,49,2.130434782608696,1,4,23,0
1.1513104757076166e+18,14,124,8.857142857142858,4,10,1,13
1.1513205756368788e+18,4,33,8.25,7,9,1,3
1.1513210562005437e+18,34,332,9.764705882352942,6,12,3,31
1.1513233538560474e+18,3,5,1.6666666666666667,1,2,3,0
1.1513249369595293e+18,13,123,9.461538461538462,8,11,0,13
1.151397915712808e+18,1,3,3.0,3,3,1,0
1.1514413194329426e+18,4,29,7.25,6,8,2,2
1.1514458062876316e+18,17,134,7.882352941176471,4,10,6,11
1.1514553167112521e+18,28,134,4.785714285714286,3,7,28,0
1.1514563985506479e+18,53,298,5.622641509433962,2,8,50,3
1.1515983595011965e+18,1,1,1.0,1,1,1,0
1.1516396400058779e+18,1,1,1.0,1,1,1,0
1.151889500827263e+18,5,45,9.0,5,11,1,4
1.1519522312572686e+18,16,34,2.125,1,3,16,0
1.1519644244458696e+18,55,117,2.1272727272727274,1,5,55,0
1.1519670385763092e+18,6,45,7.5,6,9,3,3
1.1519786974851515e+18,1,2,2.0,2,2,1,0
1.1519839672552328e+18,5,8,1.6,1,2,5,0
1.1519885937174584e+18,3,18,6.0,6,6,3,0
1.1520104565739598e+18,8,33,4.125,3,6,8,0
1.1520138545484187e+18,7,26,3.7142857142857144,3,5,7,0
1.1520140336376812e+18,1,1,1.0,1,1,1,0
1.1520251997863037e+18,1,4,4.0,4,4,1,0
1.15203029419533e+18,3,9,3.0,2,4,3,0
1.1520439919775731e+18,9,39,4.333333333333333,3,6,9,0
1.1520457842765341e+18,8,59,7.375,5,10,4,4
1.1520473996583726e+18,2,8,4.0,4,4,2,0
1.1520509506243465e+18,8,33,4.125,2,6,8,0
1.152055691585899e+18,10,37,3.7,2,5,10,0
1.1520818561710391e+18,2,7,3.5,3,4,2,0
1.1521018665795366e+18,1,2,2.0,2,2,1,0
1.1521349542527268e+18,4,35,8.75,8,10,0,4
1.1522386538025527e+18,16,131,8.1875,2,10,4,12
1.15225746474011e+18,11,106,9.636363636363637,6,11,1,10
1.1522871284711082e+18,11,33,3.0,2,4,11,0
1.1526105439427041e+18,11,61,5.545454545454546,3,7,11,0
1.152637941228082e+18,6,51,8.5,7,10,1,5
1.1527023358995118e+18,1,1,1.0,1,1,1,0
1.1527162265042509e+18,9,10,1.1111111111111112,1,2,9,0
1.1527306387183022e+18,3,5,1.6666666666666667,1,3,3,0
1.1527428799178572e+18,48,195,4.0625,2,6,48,0
1.1527441372025062e+18,8,57,7.125,5,9,4,4
1.1527453980477389e+18,1,7,7.0,7,7,1,0
1.1527515246652422e+18,9,65,7.222222222222222,5,9,6,3
1.1527585637335222e+18,3,11,3.6666666666666665,3,5,3,0
1.1527599551024297e+18,3,20,6.666666666666667,5,8,2,1
1.1527614198301252e+18,1,1,1.0,1,1,1,0
1.1527642077471176e+18,3,9,3.0,2,4,3,0
1.1527657125215882e+18,2,2,1.0,1,1,2,0
1.1527800754540513e+18,2,4,2.0,2,2,2,0
1.1527962855952275e+18,1,1,1.0,1,1,1,0
1.152805349207234e+18,6,21,3.5,2,5,6,0
1.1528129387188996e+18,1,1,1.0,1,1,1,0
1.152817149482949e+18,18,151,8.38888888888889,2,10,3,15
1.1528243523085228e+18,1,1,1.0,1,1,1,0
1.1528311048874173e+18,1,3,3.0,3,3,1,0
1.1528367769338499e+18,1,2,2.0,2,2,1,0
1.1528502295215055e+18,50,253,5.06,3,8,49,1
1.1528563650803557e+18,51,353,6.921568627450981,5,10,35,16
1.1528679474941864e+18,8,27,3.375,2,4,8,0
1.1528690567428146e+18,3,8,2.6666666666666665,1,5,3,0
1.1528779399574811e+18,5,11,2.2,1,3,5,0
1.1528905808458903e+18,4,8,2.0,1,3,4,0
1.1528999740897805e+18,10,70,7.0,5,11,6,4
1.1529080507693855e+18,8,19,2.375,1,4,8,0
1.1529451001638845e+18,4,38,9.5,8,10,0,4
1.1529618238510003e+18,25,121,4.84,3,7,25,0
1.1530125402797983e+18,1,7,7.0,7,7,1,0
1.1530282684071514e+18,70,670,9.571428571428571,2,13,4,66
1.1532868063808676e+18,28,60,2.142857142857143,1,5,28,0
1.153342994028411e+18,4,29,7.25,7,8,3,1
1.153389635800318e+18,21,214,10.19047619047619,8,12,0,21
1.153391144019759e+18,8,15,1.875,1,3,8,0
1.1533990696130442e+18,16,34,2.125,1,4,16,0
1.1534019363591032e+18,36,181,5.027777777777778,2,7,36,0
1.1534077214544768e+18,38,115,3.026315789473684,1,6,38,0
1.1534271208999772e+18,11,98,8.909090909090908,7,11,1,10
1.1534475302789716e+18,2,3,1.5,1,2,2,0
1.1534514007777042e+18,1,2,2.0,2,2,1,0
1.1534556242748111e+18,1,1,1.0,1,1,1,0
1.1534608120221998e+18,29,62,2.1379310344827585,1,4,29,0
1.1534612304848174e+18,17,37,2.176470588235294,1,4,17,0
1.1534688503982195e+18,1,2,2.0,2,2,1,0
1.153472054624487e+18,1,1,1.0,1,1,1,0
1.1534762068121825e+18,1,1,1.0,1,1,1,0
1.1534796059342748e+18,1,3,3.0,3,3,1,0
1.15348288531863e+18,3,6,2.0,1,3,3,0
1.153485507819601e+18,6,9,1.5,1,2,6,0
1.1534882349135416e+18,1,1,1.0,1,1,1,0
1.1534916878461292e+18,1,3,3.0,3,3,1,0
1.1535001428127278e+18,34,229,6.735294117647059,3,9,25,9
1.1535060565127296e+18,15,34,2.2666666666666666,1,4,15,0
1.1535133863221294e+18,8,17,2.125,1,3,8,0
1.153548966962128e+18,45,124,2.7555555555555555,1,5,45,0
1.1535835899797307e+18,29,279,9.620689655172415,3,12,2,27
1.1535897257017838e+18,1,6,6.0,6,6,1,0
1.1535905914092518e+18,38,217,5.7105263157894735,4,8,37,1
1.1535945908067735e+18,10,81,8.1,5,10,3,7
1.1536091359494902e+18,6,26,4.333333333333333,3,5,6,0
1.1536173911010652e+18,2,10,5.0,4,6,2,0
1.1536259711893107e+18,38,182,4.7894736842105265,2,7,38,0
1.15368456747956e+18,1,3,3.0,3,3,1,0
1.153698405117291e+18,1,1,1.0,1,1,1,0
1.1537117607521933e+18,1,2,2.0,2,2,1,0
1.15372162111024e+18,1,1,1.0,1,1,1,0
1.1537255585829348e+18,1,3,3.0,3,3,1,0
1.1537287213564024e+18,1,2,2.0,2,2,1,0
1.1537313116557612e+18,2,2,1.0,1,1,2,0
1.1540381194744996e+18,5,47,9.4,8,11,0,5
1.1541284475207444e+18,2,2,1.0,1,1,2,0
1.154136934523752e+18,1,2,2.0,2,2,1,0
1.154141337534013e+18,1,1,1.0,1,1,1,0
1.1541442445045501e+18,17,29,1.7058823529411764,1,3,17,0
1.1541499725953467e+18,20,133,6.65,2,9,16,4
1.1541528670803845e+18,1,2,2.0,2,2,1,0
1.1541550258746708e+18,17,55,3.235294117647059,1,6,17,0
1.154156561468384e+18,1,1,1.0,1,1,1,0
1.1541610150813906e+18,44,91,2.0681818181818183,1,4,44,0
1.1541647461038648e+18,1,1,1.0,1,1,1,0
1.1541662566789786e+18,25,69,2.76,1,5,25,0
1.1541690579242742e+18,1,2,2.0,2,2,1,0
1.1541715642141245e+18,3,22,7.333333333333333,6,8,1,2
1.1541729703099036e+18,2,4,2.0,1,3,2,0
1.1541765041844844e+18,1,1,1.0,1,1,1,0
1.1541803091466532e+18,1,3,3.0,3,3,1,0
1.154194371693353e+18,1,1,1.0,1,1,1,0
1.1541980455718822e+18,1,1,1.0,1,1,1,0
1.1542174851452654e+18,1,2,2.0,2,2,1,0
1.1542195036685432e+18,21,96,4.571428571428571,2,7,21,0
1.1542230117689462e+18,2,3,1.5,1,2,2,0
1.1542275459248676e+18,1,3,3.0,3,3,1,0
1.1542315672425032e+18,38,192,5.052631578947368,3,7,38,0
1.1542344180335667e+18,2,2,1.0,1,1,2,0
1.1542392423398467e+18,2,6,3.0,2,4,2,0
1.15425421562689e+18,32,97,3.03125,1,5,32,0
1.1542653858249544e+18,1,1,1.0,1,1,1,0
1.1542823296457208e+18,31,48,1.5483870967741935,1,3,31,0
1.1543623624273037e+18,14,39,2.7857142857142856,1,5,14,0
1.1543640065211292e+18,12,61,5.083333333333333,4,7,12,0
1.154368807914645e+18,7,33,4.714285714285714,3,6,7,0
1.1543715633983583e+18,37,180,4.864864864864865,2,7,37,0
1.1543722880647037e+18,23,115,5.0,3,7,23,0
1.1548196270924598e+18,1,7,7.0,7,7,1,0
1.1548623359534958e+18,11,97,8.818181818181818,7,10,1,10
1.1548722498101092e+18,24,217,9.041666666666666,8,11,0,24
1.1548766918422863e+18,2,3,1.5,1,2,2,0
1.1549378508671542e+18,2,9,4.5,3,6,2,0
1.155034473099126e+18,4,12,3.0,2,4,4,0
1.1550492219074977e+18,7,13,1.8571428571428572,1,3,7,0
1.1550576822852861e+18,7,56,8.0,7,10,2,5
1.1550921311145024e+18,1,7,7.0,7,7,1,0
1.155138279064482e+18,14,71,5.071428571428571,3,8,13,1
1.155165128960017e+18,5,44,8.8,7,10,1,4
1.1552320740019123e+18,2,20,10.0,10,10,0,2
1.1553092331780232e+18,23,112,4.869565217391305,3,7,23,0
1.1554998302353874e+18,18,42,2.3333333333333335,1,4,18,0
1.1555258600183498e+18,5,13,2.6,2,3,5,0
1.1555263270953203e+18,1,3,3.0,3,3,1,0
1.1555331585113418e+18,1,3,3.0,3,3,1,0
1.1555362218025267e+18,27,135,5.0,2,6,27,0
1.1555362253094943e+18,1,4,4.0,4,4,1,0
1.1555569929895194e+18,40,201,5.025,3,7,40,0
1.1555624726476337e+18,1,1,1.0,1,1,1,0
1.1555723420641987e+18,1,1,1.0,1,1,1,0
1.1555750628157955e+18,1,1,1.0,1,1,1,0
1.155579412445079e+18,1,2,2.0,2,2,1,0
1.1555883139875208e+18,1,1,1.0,1,1,1,0
1.155597848853242e+18,3,25,8.333333333333334,8,9,0,3
1.1555983704292884e+18,21,34,1.619047619047619,1,3,21,0
1.1556054863870026e+18,6,13,2.1666666666666665,1,3,6,0
1.1556073940137216e+18,30,92,3.066666666666667,1,5,30,0
1.1556089456419062e+18,14,31,2.2142857142857144,1,4,14,0
1.1556172854964127e+18,1,1,1.0,1,1,1,0
1.155618175491455e+18,26,52,2.0,1,4,26,0
1.1556307367426604e+18,31,53,1.7096774193548387,1,3,31,0
1.1556502236110106e+18,4,26,6.5,5,8,3,1
1.155651380918241e+18,21,39,1.8571428571428572,1,3,21,0
1.155664952730118e+18,1,2,2.0,2,2,1,0
1.1556972403069056e+18,10,84,8.4,6,10,1,9
1.1557034321537564e+18,8,39,4.875,3,7,8,0
1.1557109546665764e+18,3,19,6.333333333333333,6,7,3,0
1.1557369154392358e+18,5,16,3.2,2,4,5,0
1.1557370434571584e+18,2,4,2.0,2,2,2,0
1.155745616810796e+18,1,3,3.0,3,3,1,0
1.15575413177158e+18,4,8,2.0,1,3,4,0
1.1557578037427722e+18,13,122,9.384615384615385,8,11,0,13
1.1557736659682435e+18,26,56,2.1538461538461537,1,4,26,0
1.1558027082256586e+18,10,53,5.3,4,7,10,0
1.155810008839874e+18,34,234,6.882352941176471,5,9,24,10
1.155812192971866e+18,1,3,3.0,3,3,1,0
1.1558910074147192e+18,21,104,4.9523809523809526,3,7,21,0
1.1561771846263235e+18,36,138,3.8333333333333335,2,7,36,0
1.1562536464959107e+18,13,54,4.153846153846154,2,6,13,0
1.1562585362109102e+18,11,98,8.909090909090908,8,10,0,11
1.1562666340921894e+18,5,10,2.0,2,2,5,0
1.1562869640485315e+18,7,15,2.142857142857143,1,4,7,0
1.156289211265265e+18,10,71,7.1,4,9,5,5
1.156294339494476e+18,7,66,9.428571428571429,5,12,1,6
1.156294535125863e+18,1,2,2.0,2,2,1,0
1.1562968656791055e+18,1,1,1.0,1,1,1,0
1.1562970344005993e+18,25,173,6.92,2,10,16,9
1.1562983181872394e+18,17,173,10.176470588235293,7,12,1,16
1.156303448227712e+18,11,56,5.090909090909091,4,7,11,0
1.1563156939891784e+18,9,89,9.88888888888889,3,12,1,8
1.1563162611621732e+18,1,3,3.0,3,3,1,0
1.156323264950635e+18,11,34,3.090909090909091,2,5,11,0
1.1563265627970276e+18,1,1,1.0,1,1,1,0
1.1563355850147039e+18,31,152,4.903225806451613,2,7,31,0
1.156338592998677e+18,1,2,2.0,2,2,1,0
1.156369358105656e+18,1,2,2.0,2,2,1,0
1.1563811484225244e+18,1,1,1.0,1,1,1,0
1.1563953302987356e+18,11,22,2.0,1,3,11,0
1.1563988422311823e+18,10,18,1.8,1,3,10,0
1.1564201251343365e+18,81,408,5.037037037037037,2,8,80,1
1.1564264307885458e+18,8,29,3.625,2,5,8,0
1.1564281329724413e+18,7,70,10.0,9,12,0,7
1.156446807084344e+18,1,8,8.0,8,8,0,1
1.1564659014114783e+18,2,3,1.5,1,2,2,0
1.1564770310992425e+18,39,377,9.666666666666666,4,12,3,36
1.1564779649529833e+18,12,58,4.833333333333333,3,7,12,0
1.156489876867995e+18,1,1,1.0,1,1,1,0
1.1565070104748209e+18,16,138,8.625,5,10,1,15
1.1565142509909379e+18,1,7,7.0,7,7,1,0
1.1565330689461036e+18,26,186,7.153846153846154,4,9,16,10
1.1565348486864233e+18,24,170,7.083333333333333,5,9,16,8
1.1565513959376236e+18,1,1,1.0,1,1,1,0
1.1565581944583004e+18,42,402,9.571428571428571,4,12,2,40
1.1565627558109005e+18,1,2,2.0,2,2,1,0
1.1565657952857034e+18,1,1,1.0,1,1,1,0
1.156575372293431e+18,10,87,8.7,3,12,2,8
1.156589497322656e+18,17,107,6.294117647058823,2,10,16,1
1.1566195233589612e+18,57,524,9.192982456140351,2,12,10,47
1.1566413804490542e+18,56,214,3.8214285714285716,1,6,56,0
1.1567651856730394e+18,45,178,3.9555555555555557,1,7,45,0
1.1568885939426097e+18,6,24,4.0,3,5,6,0
1.1569422682215142e+18,4,29,7.25,5,8,1,3
1.1569722353294016e+18,9,20,2.2222222222222223,1,3,9,0
1.15697270208653e+18,9,87,9.666666666666666,8,11,0,9
1.1569827497208845e+18,8,42,5.25,4,7,8,0
1.1570196073559613e+18,6,14,2.3333333333333335,1,3,6,0
1.1570261114671588e+18,11,36,3.272727272727273,1,5,11,0
1.1570269499240402e+18,21,64,3.0476190476190474,2,6,21,0
1.1570325164974633e+18,17,133,7.823529411764706,3,11,3,14
1.1570665006317427e+18,35,337,9.628571428571428,4,12,3,32
1.1570756199459205e+18,3,5,1.6666666666666667,1,2,3,0
1.1570896980182157e+18,10,52,5.2,4,7,10,0
1.157120074249914e+18,5,13,2.6,1,4,5,0
1.157128213246765e+18,4,7,1.75,1,2,4,0
1.1571330411080822e+18,3,8,2.6666666666666665,2,3,3,0
1.1571341142253944e+18,54,71,1.3148148148148149,1,4,54,0
1.1571382729097062e+18,4,42,10.5,10,12,0,4
1.1571421833899154e+18,5,23,4.6,3,6,5,0
1.157145987347921e+18,9,78,8.666666666666666,7,10,1,8
1.1571489157238935e+18,44,218,4.954545454545454,3,7,44,0
1.157170122116529e+18,15,141,9.4,5,11,1,14
1.157189091758651e+18,13,114,8.76923076923077,7,10,2,11
1.1572321095254756e+18,17,149,8.764705882352942,6,11,3,14
1.1572666595269292e+18,28,262,9.357142857142858,5,12,3,25
1.1573013476049303e+18,3,14,4.666666666666667,3,7,3,0
1.157318573132962e+18,42,237,5.642857142857143,2,9,39,3
1.1573211906679163e+18,8,51,6.375,5,8,7,1
1.1573627630753802e+18,20,197,9.85,3,11,1,19
1.1574068665430653e+18,48,477,9.9375,4,13,1,47
1.1574300532691284e+18,15,100,6.666666666666667,4,9,11,4
1.1576117601521367e+18,22,89,4.045454545454546,2,5,22,0
1.1577271042474432e+18,18,173,9.61111111111111,4,12,2,16
1.1577290213683912e+18,49,104,2.122448979591837,1,5,49,0
1.1577329483721687e+18,22,69,3.1363636363636362,1,5,22,0
1.1577350907029875e+18,9,62,6.888888888888889,5,9,7,2
1.157736677732909e+18,19,165,8.68421052631579,6,11,2,17
1.1577672300730022e+18,2,3,1.5,1,2,2,0
1.1577881823110943e+18,26,59,2.269230769230769,1,4,26,0
1.1577969868694807e+18,24,90,3.75,2,6,24,0
1.1577975119674534e+18,8,12,1.5,1,3,8,0
1.1578031761833034e+18,3,8,2.6666666666666665,2,3,3,0
1.157815131000306e+18,7,55,7.857142857142857,5,10,2,5
1.157817613316607e+18,18,89,4.944444444444445,3,7,18,0
1.157825339502471e+18,2,4,2.0,2,2,2,0
1.1578327326405138e+18,1,1,1.0,1,1,1,0
1.157833084517812e+18,4,8,2.0,1,3,4,0
1.1578390326693563e+18,3,6,2.0,1,4,3,0
1.1578487103246925e+18,4,7,1.75,1,3,4,0
1.157853999914346e+18,4,10,2.5,2,3,4,0
1.1578618293083392e+18,30,60,2.0,1,4,30,0
1.1578713073125524e+18,1,2,2.0,2,2,1,0
1.1578759460463857e+18,5,10,2.0,1,3,5,0
1.1578808167511352e+18,17,35,2.0588235294117645,1,4,17,0
1.1579072718114714e+18,1,7,7.0,7,7,1,0
1.157921079054526e+18,4,26,6.5,6,8,3,1
1.1579370961773345e+18,3,20,6.666666666666667,5,8,2,1
1.1579553989535683e+18,6,26,4.333333333333333,2,5,6,0
1.1579933784288374e+18,21,123,5.857142857142857,2,8,20,1
1.1579940401948419e+18,13,82,6.3076923076923075,5,8,12,1
1.1579943687039867e+18,3,20,6.666666666666667,6,8,2,1
1.157995031034079e+18,16,109,6.8125,6,8,13,3
1.1579980114903112e+18,9,45,5.0,4,6,9,0
1.1580243804079588e+18,37,160,4.324324324324325,2,7,37,0
1.1580273233479268e+18,15,104,6.933333333333334,5,8,9,6
1.1580420757853066e+18,4,8,2.0,1,3,4,0
1.1580516729975007e+18,26,132,5.076923076923077,3,7,26,0
1.1580887737519017e+18,41,346,8.439024390243903,3,11,6,35
1.1580937902257134e+18,24,53,2.2083333333333335,1,4,24,0
1.1581088655388795e+18,19,118,6.2105263157894735,4,8,17,2
1.1581145201957425e+18,31,221,7.129032258064516,4,9,17,14
1.1581187972388462e+18,7,71,10.142857142857142,9,12,0,7
1.1581253432451643e+18,6,14,2.3333333333333335,1,4,6,0
1.1583692159655053e+18,32,157,4.90625,2,8,31,1
1.158399534443777e+18,33,199,6.03030303030303,4,8,29,4
1.158447346087438e+18,1,4,4.0,4,4,1,0
1.1584481592745114e+18,17,133,7.823529411764706,4,10,6,11
1.1584522697839818e+18,3,31,10.333333333333334,10,11,0,3
1.158458083548995e+18,23,42,1.826086956521739,1,4,23,0
1.158459349635422e+18,2,11,5.5,5,6,2,0
1.1584596919213463e+18,1,4,4.0,4,4,1,0
1.1584839047898345e+18,2,5,2.5,2,3,2,0
1.1584888376229693e+18,1,3,3.0,3,3,1,0
1.158493135410345e+18,3,5,1.6666666666666667,1,3,3,0
1.1584997357818929e+18,3,21,7.0,6,8,2,1
1.1585025733096765e+18,9,18,2.0,1,4,9,0
1.158510264173323e+18,33,299,9.06060606060606,6,11,3,30
1.158514742975953e+18,6,18,3.0,1,4,6,0
1.1585246395378427e+18,3,8,2.6666666666666665,2,3,3,0
1.1585247759586621e+18,3,24,8.0,8,8,0,3
1.1585290468837253e+18,6,39,6.5,4,9,5,1
1.1585357156460792e+18,5,11,2.2,2,3,5,0
1.1585608450950057e+18,3,20,6.666666666666667,5,8,2,1
1.1585726998743204e+18,3,12,4.0,3,5,3,0
1.1585801661071063e+18,2,2,1.0,1,1,2,0
1.1585856420808873e+18,5,11,2.2,1,4,5,0
1.1585911988116828e+18,1,3,3.0,3,3,1,0
1.1586165577990198e+18,34,332,9.764705882352942,8,12,0,34
1.158631332416432e+18,2,15,7.5,7,8,1,1
1.1586334954301926e+18,18,88,4.888888888888889,3,7,18,0
1.1586339470289754e+18,2,4,2.0,2,2,2,0
1.1586461684114317e+18,4,6,1.5,1,2,4,0
1.158666937706564e+18,32,283,8.84375,8,11,0,32
1.1586869334491497e+18,6,29,4.833333333333333,4,5,6,0
1.1587362444715372e+18,2,10,5.0,4,6,2,0
1.1587745673122237e+18,24,92,3.8333333333333335,1,6,24,0
1.1588253587715448e+18,33,280,8.484848484848484,3,11,7,26
1.15884897948295e+18,4,11,2.75,1,4,4,0
1.1588548471774938e+18,14,144,10.285714285714286,9,11,0,14
1.1592021518234452e+18,4,27,6.75,5,8,3,1
1.1592363682648448e+18,38,183,4.815789473684211,3,7,38,0
1.1592787870235886e+18,3,9,3.0,2,4,3,0
1.1593361778096143e+18,1,3,3.0,3,3,1,0
1.1593478129961085e+18,11,22,2.0,1,3,11,0
1.1593644529206618e+18,22,108,4.909090909090909,2,7,22,0
1.1594146060873697e+18,2,6,3.0,2,4,2,0
1.1594226650615196e+18,24,121,5.041666666666667,3,7,24,0
1.159433009704797e+18,9,22,2.4444444444444446,1,4,9,0
1.1594403290242778e+18,24,204,8.5,2,11,6,18
1.1594781336889385e+18,38,371,9.763157894736842,4,12,2,36
1.1595341084767084e+18,27,256,9.481481481481481,7,11,1,26
1.159550370263928e+18,1,2,2.0,2,2,1,0
1.1596299009823455e+18,2,4,2.0,2,2,2,0
1.159831174411407e+18,25,239,9.56,2,12,2,23
1.1598477998967155e+18,18,45,2.5,1,4,18,0
1.1598588185006216e+18,2,13,6.5,6,7,2,0
1.1598824176196221e+18,10,33,3.3,1,4,10,0
1.1599056839004905e+18,18,152,8.444444444444445,4,10,3,15
1.1599555539825408e+18,24,207,8.625,4,11,4,20
1.1599791641520512e+18,14,132,9.428571428571429,9,11,0,14
1.1600462628589338e+18,21,203,9.666666666666666,5,12,2,19
1.1600571494491013e+18,4,29,7.25,7,8,3,1
1.1600783010673126e+18,1,8,8.0,8,8,0,1
1.1601041933440182e+18,14,136,9.714285714285714,8,11,0,14
1.1601234908085737e+18,2,17,8.5,8,9,0,2
1.1601374933208481e+18,52,355,6.826923076923077,2,9,35,17
1.1601982309524e+18,4,17,4.25,4,5,4,0
1.1602006033919457e+18,7,21,3.0,2,4,7,0
1.1602347133131407e+18,30,184,6.133333333333334,4,9,28,2
1.1602410137165207e+18,51,116,2.2745098039215685,1,4,51,0
1.1602910507932628e+18,29,146,5.0344827586206895,3,7,29,0
1.16032599078474e+18,7,33,4.714285714285714,3,6,7,0
1.160340067271243e+18,3,19,6.333333333333333,5,7,3,0
1.1604413694123272e+18,5,13,2.6,1,5,5,0
1.1605912859600947e+18,3,16,5.333333333333333,5,6,3,0
1.160600457910581e+18,1,5,5.0,5,5,1,0
1.1606007908972974e+18,8,58,7.25,5,9,6,2
1.1606167505168082e+18,31,86,2.774193548387097,1,5,31,0
1.1606260149184282e+18,8,23,2.875,2,4,8,0
1.1606304558773993e+18,9,23,2.5555555555555554,1,5,9,0
1.1606413183398175e+18,15,32,2.1333333333333333,1,4,15,0
1.1606443224792333e+18,1,1,1.0,1,1,1,0
1.1606508350111652e+18,5,9,1.8,1,3,5,0
1.1606563519721981e+18,13,28,2.1538461538461537,1,4,13,0
1.1606638019480806e+18,11,21,1.9090909090909092,1,3,11,0
1.1606721264993298e+18,5,37,7.4,6,9,3,2
1.160680712295128e+18,2,6,3.0,3,3,2,0
1.1606815264064955e+18,19,133,7.0,2,9,11,8
1.1606878221660273e+18,1,2,2.0,2,2,1,0
1.160700105189249e+18,2,10,5.0,4,6,2,0
1.1607183659035075e+18,22,151,6.863636363636363,5,9,14,8
1.1607328196875768e+18,6,11,1.8333333333333333,1,3,6,0
1.1607483991695593e+18,17,35,2.0588235294117645,1,3,17,0
1.160806195004865e+18,4,12,3.0,2,4,4,0
1.1608186338555372e+18,18,35,1.9444444444444444,1,3,18,0
1.1608253532225692e+18,8,63,7.875,6,10,2,6
1.1608319538631273e+18,1,8,8.0,8,8,0,1
1.1608324253436275e+18,1,5,5.0,5,5,1,0
1.1608388463154606e+18,3,9,3.0,1,5,3,0
1.1608419771521708e+18,12,22,1.8333333333333333,1,3,12,0
1.1608570749490637e+18,15,35,2.3333333333333335,1,4,15,0
1.1609015188922637e+18,37,147,3.972972972972973,2,6,37,0
1.1609646281473108e+18,24,235,9.791666666666666,7,11,1,23
1.1610160880953398e+18,51,105,2.0588235294117645,1,4,51,0
1.161035893920457e+18,20,61,3.05,1,5,20,0
1.1612322148425748e+18,46,316,6.869565217391305,3,10,33,13
1.1612985214845235e+18,12,118,9.833333333333334,8,11,0,12
1.161324362760467e+18,2,5,2.5,2,3,2,0
1.1613729154969395e+18,3,20,6.666666666666667,6,8,2,1
1.1613874368066312e+18,7,28,4.0,3,5,7,0
1.1613966661221007e+18,47,465,9.893617021276595,2,12,2,45
1.1613983527504484e+18,2,8,4.0,4,4,2,0
1.161400810973639e+18,9,75,8.333333333333334,5,10,2,7
1.1614380944783741e+18,6,36,6.0,5,7,6,0
1.1614391657139098e+18,4,6,1.5,1,3,4,0
1.1614447348226634e+18,9,16,1.7777777777777777,1,2,9,0
1.1614462690418452e+18,3,25,8.333333333333334,8,9,0,3
1.1614486828480745e+18,8,16,2.0,1,3,8,0
1.1614544541804728e+18,3,4,1.3333333333333333,1,2,3,0
1.1614607540541688e+18,2,5,2.5,1,4,2,0
1.1614648439225364e+18,3,5,1.6666666666666667,1,2,3,0
1.1614721781384072e+18,8,16,2.0,1,3,8,0
1.161478229482291e+18,3,7,2.3333333333333335,2,3,3,0
1.1614812349980536e+18,6,14,2.3333333333333335,1,4,6,0
1.1614818991327022e+18,1,1,1.0,1,1,1,0
1.1614860101253263e+18,2,2,1.0,1,1,2,0
1.1614908164547907e+18,1,1,1.0,1,1,1,0
1.161495306012448e+18,13,28,2.1538461538461537,1,4,13,0
1.1615024808676063e+18,1,3,3.0,3,3,1,0
1.1615058597637059e+18,2,3,1.5,1,2,2,0
1.1615163681536635e+18,7,58,8.285714285714286,7,10,2,5
1.1615170089467784e+18,4,28,7.0,4,8,1,3
1.1615435209468342e+18,3,7,2.3333333333333335,1,3,3,0
1.1615473965235674e+18,33,224,6.787878787878788,3,9,26,7
1.1615527450547615e+18,1,4,4.0,4,4,1,0
1.1615681236961395e+18,44,220,5.0,3,7,44,0
1.1615809760422295e+18,6,37,6.166666666666667,5,7,6,0
1.1615875996037627e+18,7,38,5.428571428571429,4,6,7,0
1.16160623631996e+18,17,118,6.9411764705882355,4,10,13,4
1.1616281142731315e+18,1,8,8.0,8,8,0,1
1.1616288314925412e+18,4,25,6.25,6,7,4,0
1.1617081417944381e+18,41,393,9.585365853658537,3,12,4,37
1.1617362973548787e+18,8,48,6.0,4,8,7,1
1.1617484719333107e+18,1,1,1.0,1,1,1,0
1.1617604071793073e+18,2,6,3.0,3,3,2,0
1.1617611583183688e+18,4,9,2.25,1,3,4,0
1.1617618335889592e+18,2,6,3.0,3,3,2,0
1.1617625632754775e+18,6,24,4.0,2,5,6,0
1.1617632663620244e+18,2,7,3.5,3,4,2,0
1.1618232574128732e+18,30,299,9.966666666666667,3,11,1,29
1.1618353033848497e+18,42,194,4.619047619047619,2,7,42,0
1.161989508917626e+18,1,1,1.0,1,1,1,0
1.1620326563875313e+18,7,43,6.142857142857143,5,7,7,0
1.1620637148616579e+18,16,71,4.4375,3,6,16,0
1.1620765984504663e+18,58,157,2.706896551724138,1,5,58,0
1.1620858562393994e+18,40,269,6.725,2,10,29,11
1.1620900431896576e+18,10,19,1.9,1,4,10,0
1.1620908553850783e+18,14,128,9.142857142857142,5,11,2,12
1.162092330510937e+18,10,49,4.9,3,6,10,0
1.162093925964652e+18,38,259,6.815789473684211,3,9,27,11
1.16209734773962e+18,7,11,1.5714285714285714,1,3,7,0
1.1621018104252956e+18,3,7,2.3333333333333335,1,3,3,0
1.1621112657936814e+18,13,26,2.0,1,4,13,0
1.1621330319557693e+18,11,23,2.090909090909091,1,4,11,0
1.162139854276548e+18,5,11,2.2,1,3,5,0
1.1621478074487498e+18,3,18,6.0,6,6,3,0
1.1621501443437809e+18,3,6,2.0,2,2,3,0
1.1621506057402906e+18,10,90,9.0,4,11,1,9
1.1621523421101996e+18,5,43,8.6,7,10,1,4
1.1621569872263885e+18,18,36,2.0,1,4,18,0
1.162173659333366e+18,5,26,5.2,4,7,5,0
1.162190018919335e+18,15,41,2.7333333333333334,2,4,15,0
1.1621983111331958e+18,3,18,6.0,5,7,3,0
1.1621992159353915e+18,35,170,4.857142857142857,3,6,35,0
1.1622097147826332e+18,4,19,4.75,4,6,4,0
1.1622198842810365e+18,3,23,7.666666666666667,7,8,1,2
1.1622318167804252e+18,1,9,9.0,9,9,0,1
1.162235296111274e+18,14,69,4.928571428571429,3,7,14,0
1.1622412035338678e+18,4,7,1.75,1,3,4,0
1.1622478220277304e+18,12,18,1.5,1,4,12,0
1.162250487149908e+18,10,68,6.8,6,8,8,2
1.162254678836716e+18,26,78,3.0,1,5,26,0
1.1622678744942267e+18,1,6,6.0,6,6,1,0
1.1622736069040973e+18,25,168,6.72,5,8,18,7
1.1622737725901043e+18,15,22,1.4666666666666666,1,3,15,0
1.1622925739839442e+18,5,47,9.4,8,11,0,5
1.162293772550502e+18,1,5,5.0,5,5,1,0
1.1622957401140552e+18,3,17,5.666666666666667,5,6,3,0
1.1622989053313628e+18,47,196,4.170212765957447,2,6,47,0
1.162338718376503e+18,9,40,4.444444444444445,3,6,9,0
1.162352679272334e+18,18,84,4.666666666666667,2,6,18,0
1.1623530011994196e+18,4,28,7.0,6,8,2,2
1.162393468500711e+18,7,10,1.4285714285714286,1,2,7,0
1.1624246482997274e+18,1,9,9.0,9,9,0,1
1.1624594263317071e+18,27,53,1.962962962962963,1,4,27,0
1.162464072745011e+18,31,57,1.8387096774193548,1,3,31,0
1.162575857648616e+18,1,2,2.0,2,2,1,0
1.1627607265987894e+18,17,44,2.588235294117647,1,4,17,0
1.1627777375445281e+18,2,2,1.0,1,1,2,0
1.162820446956382e+18,18,85,4.722222222222222,2,6,18,0
1.1628313260737042e+18,3,6,2.0,2,2,3,0
1.1628481707326152e+18,2,2,1.0,1,1,2,0
1.162860445651249e+18,17,119,7.0,3,9,11,6
1.1628685959198536e+18,6,20,3.3333333333333335,3,5,6,0
1.162888400492301e+18,42,291,6.928571428571429,4,10,29,13
1.162907269912826e+18,2,14,7.0,7,7,2,0
1.1629133837461123e+18,35,351,10.028571428571428,9,12,0,35
1.1629369358551043e+18,68,315,4.632352941176471,3,8,67,1
1.1629413757414682e+18,74,360,4.864864864864865,3,7,74,0
1.1629632705500252e+18,38,80,2.1052631578947367,1,5,38,0
1.1629647273124892e+18,1,1,1.0,1,1,1,0
1.163003370186671e+18,12,111,9.25,7,11,1,11
1.1630059443094134e+18,67,463,6.91044776119403,5,9,49,18
1.1630240186804037e+18,3,3,1.0,1,1,3,0
1.163033977110279e+18,15,153,10.2,9,12,0,15
1.1630689337792445e+18,1,3,3.0,3,3,1,0
1.1630701389153344e+18,1,3,3.0,3,3,1,0
1.1630833697710323e+18,2,15,7.5,7,8,1,1
1.163143909121098e+18,25,54,2.16,1,4,25,0
1.1631896081406548e+18,1,9,9.0,9,9,0,1
1.1631928116538916e+18,40,276,6.9,2,9,29,11
1.163214689830392e+18,26,249,9.576923076923077,2,13,2,24
1.1634978668558973e+18,20,162,8.1,6,10,6,14
1.1635173701234245e+18,31,91,2.935483870967742,1,5,31,0
1.1635189166482135e+18,9,61,6.777777777777778,5,8,7,2
1.1635288206578125e+18,6,16,2.6666666666666665,1,3,6,0
1.163556005334142e+18,31,156,5.032258064516129,3,7,31,0
1.1635606880311926e+18,4,11,2.75,2,3,4,0
1.163571720940543e+18,1,1,1.0,1,1,1,0
1.1635757045054282e+18,10,69,6.9,5,9,7,3
1.163584997865139e+18,5,35,7.0,6,8,4,1
1.163597832936846e+18,3,5,1.6666666666666667,1,2,3,0
1.1635998905389071e+18,12,73,6.083333333333333,3,9,10,2
1.1636001815771802e+18,5,30,6.0,5,7,5,0
1.1636324032138022e+18,30,263,8.766666666666667,7,11,4,26
1.16363397949959e+18,40,314,7.85,5,10,13,27
1.1636411256174408e+18,1,1,1.0,1,1,1,0
1.1636440499319311e+18,6,21,3.5,3,5,6,0
1.1636514307045286e+18,19,95,5.0,3,7,19,0
1.163656981123552e+18,6,59,9.833333333333334,9,11,0,6
1.1636660534151014e+18,4,26,6.5,3,9,3,1
1.163686314763933e+18,4,7,1.75,1,3,4,0
1.1636885169352535e+18,2,16,8.0,8,8,0,2
1.163738967958508e+18,10,27,2.7,1,5,10,0
1.163822170400252e+18,4,21,5.25,2,7,4,0
1.1642329468031826e+18,27,222,8.222222222222221,7,10,7,20
1.1642626362687493e+18,53,269,5.0754716981132075,2,8,52,1
1.1642631850315512e+18,2,4,2.0,1,3,2,0
1.1642850144257441e+18,39,80,2.051282051282051,1,4,39,0
1.164303393431811e+18,41,255,6.219512195121951,4,8,39,2
1.1643585835278943e+18,1,8,8.0,8,8,0,1
1.1643690692528612e+18,13,104,8.0,7,9,3,10
1.164411797442727e+18,17,22,1.2941176470588236,1,3,17,0
1.1645298558049603e+18,5,8,1.6,1,3,5,0
1.1645323263941668e+18,3,16,5.333333333333333,3,7,3,0
1.16456219503356e+18,1,2,2.0,2,2,1,0
1.164575771488218e+18,27,170,6.296296296296297,5,9,25,2
1.164853219339459e+18,22,203,9.227272727272727,6,12,2,20
1.1649448981262938e+18,12,19,1.5833333333333333,1,4,12,0
1.164957994350716e+18,2,14,7.0,6,8,1,1
1.1649742999519032e+18,5,23,4.6,3,6,5,0
1.164976462901544e+18,28,265,9.464285714285714,2,12,2,26
1.1649997395535892e+18,4,10,2.5,2,4,4,0
1.1650187333508593e+18,16,121,7.5625,4,9,6,10
1.1650548936162929e+18,10,60,6.0,4,8,9,1
1.1650557983110638e+18,2,3,1.5,1,2,2,0
1.1650962390188882e+18,73,727,9.95890410958904,5,12,1,72
1.165102087906792e+18,4,6,1.5,1,2,4,0
1.1651446805562104e+18,24,92,3.8333333333333335,2,6,24,0
1.165165908488734e+18,2,4,2.0,2,2,2,0
1.1651683476612544e+18,1,8,8.0,8,8,0,1
1.1652389166930132e+18,5,40,8.0,7,10,2,3
1.165243879289717e+18,1,8,8.0,8,8,0,1
1.1653024259224474e+18,38,366,9.631578947368421,5,11,2,36
1.1653040788692803e+18,6,44,7.333333333333333,6,9,4,2
1.1653173027436022e+18,66,642,9.727272727272727,2,12,2,64
1.1653580763957437e+18,8,83,10.375,9,12,0,8
1.1653971495925645e+18,61,83,1.360655737704918,1,4,61,0
1.1656601946646351e+18,5,36,7.2,6,8,3,2
1.1656702786597752e+18,18,91,5.055555555555555,3,7,18,0
1.1656962329351844e+18,27,255,9.444444444444445,2,12,2,25
1.1657093350848645e+18,3,4,1.3333333333333333,1,2,3,0
1.1657257054258122e+18,2,3,1.5,1,2,2,0
1.1657442695372836e+18,46,435,9.456521739130435,5,12,2,44
1.1657782678619233e+18,7,32,4.571428571428571,3,6,7,0
1.165790231622362e+18,25,130,5.2,3,7,25,0
1.1657924675402872e+18,18,47,2.611111111111111,1,5,18,0
1.1658034711508134e+18,1,2,2.0,2,2,1,0
1.1658120939966687e+18,13,105,8.076923076923077,2,10,4,9
1.16581697918123e+18,1,2,2.0,2,2,1,0
1.1658422987019354e+18,1,7,7.0,7,7,1,0
1.1658433753958838e+18,3,24,8.0,7,9,1,2
1.165844021912502e+18,18,40,2.2222222222222223,1,4,18,0
1.1658499141299203e+18,1,5,5.0,5,5,1,0
1.165858488640101e+18,21,208,9.904761904761905,8,11,0,21
1.1658726629786798e+18,45,88,1.9555555555555555,1,5,45,0
1.1658902699673428e+18,24,230,9.583333333333334,2,11,2,22
1.1658910770106063e+18,25,81,3.24,2,6,25,0
1.1658984471773494e+18,24,127,5.291666666666667,4,7,24,0
1.1659140552951414e+18,1,8,8.0,8,8,0,1
1.1659155043343414e+18,22,185,8.409090909090908,3,12,4,18
1.1659228541554737e+18,2,5,2.5,2,3,2,0
1.165943838906377e+18,31,209,6.741935483870968,5,9,24,7
1.165944647092573e+18,21,212,10.095238095238095,8,12,0,21
1.1659467045226934e+18,2,16,8.0,8,8,0,2
1.1659613145029253e+18,54,117,2.1666666666666665,1,4,54,0
1.1659669716403868e+18,26,36,1.3846153846153846,1,3,26,0
1.1659708413633577e+18,35,48,1.3714285714285714,1,3,35,0
1.1659736680627062e+18,32,193,6.03125,4,7,32,0
1.1660018008227062e+18,13,27,2.076923076923077,1,3,13,0
1.1660036758987735e+18,28,189,6.75,3,8,23,5
1.1660079877630405e+18,23,156,6.782608695652174,5,9,17,6
1.1660110270624522e+18,2,14,7.0,6,8,1,1
1.1660300375252337e+18,35,73,2.085714285714286,1,4,35,0
1.1660520638096653e+18,22,197,8.954545454545455,3,11,2,20
1.1660944557530913e+18,10,94,9.4,7,12,1,9
1.1660969091856187e+18,26,246,9.461538461538462,3,11,2,24
1.166109311049143e+18,21,138,6.571428571428571,2,9,14,7
1.1663406739103276e+18,4,7,1.75,1,3,4,0
1.166351737993679e+18,38,191,5.026315789473684,3,8,37,1
1.1663673269915784e+18,2,18,9.0,8,10,0,2
1.1664041850597752e+18,2,4,2.0,2,2,2,0
1.1664160483857083e+18,4,10,2.5,2,4,4,0
1.1664310508202314e+18,17,50,2.9411764705882355,1,5,17,0
1.1664481033806518e+18,36,55,1.5277777777777777,1,3,36,0
1.1664578617672376e+18,5,35,7.0,6,8,3,2
1.1664630793873e+18,2,7,3.5,3,4,2,0
1.1664932072643594e+18,3,15,5.0,2,8,2,1
1.166502749414761e+18,23,224,9.73913043478261,7,12,1,22
1.1665196463644698e+18,16,148,9.25,7,11,1,15
1.1665202479249341e+18,23,44,1.9130434782608696,1,3,23,0
1.166526655598472e+18,4,10,2.5,2,3,4,0
1.166531061935652e+18,30,44,1.4666666666666666,1,3,30,0
1.166538609769626e+18,2,14,7.0,7,7,2,0
1.166542590877069e+18,15,31,2.066666666666667,1,3,15,0
1.16654709412848e+18,2,14,7.0,7,7,2,0
1.1665565259265987e+18,3,8,2.6666666666666665,2,3,3,0
1.166559194973279e+18,3,14,4.666666666666667,4,6,3,0
1.1665664073960614e+18,3,9,3.0,2,4,3,0
1.1665695794144266e+18,5,13,2.6,1,4,5,0
1.166570838913357e+18,3,7,2.3333333333333335,2,3,3,0
1.1665752004154463e+18,3,4,1.3333333333333333,1,2,3,0
1.1665839732403866e+18,3,9,3.0,2,4,3,0
1.1666058364247265e+18,1,8,8.0,8,8,0,1
1.1666171829498824e+18,3,5,1.6666666666666667,1,2,3,0
1.1666212437843354e+18,37,152,4.108108108108108,2,8,36,1
1.1666268304727314e+18,1,2,2.0,2,2,1,0
1.1666272709556111e+18,1,1,1.0,1,1,1,0
1.1666419109422927e+18,21,43,2.0476190476190474,1,4,21,0
1.1666519607984745e+18,19,140,7.368421052631579,6,9,9,10
1.166666477473007e+18,1,8,8.0,8,8,0,1
1.1666781999807334e+18,3,17,5.666666666666667,5,6,3,0
1.1667448628692895e+18,23,70,3.0434782608695654,1,5,23,0
1.1667593487485158e+18,5,16,3.2,3,4,5,0
1.1667729760625677e+18,12,116,9.666666666666666,6,11,1,11
1.1667899008205105e+18,22,221,10.045454545454545,8,12,0,22
1.1671053114682696e+18,2,2,1.0,1,1,2,0
1.167110497688949e+18,1,1,1.0,1,1,1,0
1.1671109672721254e+18,11,115,10.454545454545455,9,13,0,11
1.1671302596242698e+18,13,61,4.6923076923076925,3,6,13,0
1.167138746630645e+18,1,8,8.0,8,8,0,1
1.1671562339179697e+18,7,22,3.142857142857143,2,4,7,0
1.1671653232211443e+18,5,27,5.4,5,6,5,0
1.1671792364110792e+18,45,323,7.177777777777778,5,9,26,19
1.1671834496927974e+18,1,4,4.0,4,4,1,0
1.1672072600497344e+18,36,262,7.277777777777778,5,10,22,14
1.167210263859526e+18,29,153,5.275862068965517,4,7,29,0
1.1672107819895526e+18,5,40,8.0,7,9,2,3
1.1672190000590881e+18,15,106,7.066666666666666,4,9,9,6
1.167270239533677e+18,19,97,5.105263157894737,4,7,19,0
1.1673049458758057e+18,1,1,1.0,1,1,1,0
1.167305881335868e+18,4,28,7.0,6,8,3,1
1.167309019783851e+18,2,4,2.0,2,2,2,0
1.1673122553711352e+18,17,34,2.0,1,3,17,0
1.1673396595304658e+18,5,7,1.4,1,2,5,0
1.1673428550612467e+18,9,12,1.3333333333333333,1,3,9,0
1.1673457888328266e+18,3,5,1.6666666666666667,1,2,3,0
1.1673663971045916e+18,41,82,2.0,1,4,41,0
1.1673725873422973e+18,2,7,3.5,3,4,2,0
1.167377194032618e+18,15,87,5.8,4,7,15,0
1.167393547506291e+18,12,30,2.5,1,4,12,0
1.1673937299895485e+18,67,265,3.955223880597015,2,6,67,0
1.167411266984459e+18,20,139,6.95,5,8,14,6
1.167411614514401e+18,15,57,3.8,3,5,15,0
1.1674132419048417e+18,14,136,9.714285714285714,7,12,1,13
1.1674487533115264e+18,8,16,2.0,1,4,8,0
1.167465772960424e+18,8,10,1.25,1,3,8,0
1.1674744907067433e+18,23,210,9.130434782608695,3,12,3,20
1.167519028661657e+18,2,19,9.5,9,10,0,2
1.1675260277061896e+18,36,242,6.722222222222222,4,8,29,7
1.167529981722095e+18,11,75,6.818181818181818,6,8,8,3
1.1675403716553185e+18,10,68,6.8,5,9,9,1
1.1675634322167613e+18,5,26,5.2,5,6,5,0
1.1675812885241572e+18,4,20,5.0,4,6,4,0
1.1678372765425807e+18,3,7,2.3333333333333335,2,3,3,0
1.1678444908691261e+18,5,10,2.0,1,3,5,0
1.1678466645838385e+18,21,59,2.8095238095238093,1,5,21,0
1.1678490622779574e+18,1,3,3.0,3,3,1,0
1.1678784612683558e+18,1,2,2.0,2,2,1,0
1.16790009975409e+18,30,143,4.766666666666667,3,7,30,0
1.16790803791447e+18,1,1,1.0,1,1,1,0
1.167908898382654e+18,2,15,7.5,7,8,1,1
1.1679092221914324e+18,1,6,6.0,6,6,1,0
1.1679184472914104e+18,3,18,6.0,5,7,3,0
1.167946461531353e+18,2,16,8.0,8,8,0,2
1.1679469742789642e+18,2,4,2.0,2,2,2,0
1.1679770657308078e+18,3,7,2.3333333333333335,1,3,3,0
1.1679870862064627e+18,35,69,1.9714285714285715,1,4,35,0
1.1680218273830185e+18,7,21,3.0,2,4,7,0
1.1680413159071137e+18,5,35,7.0,6,8,3,2
1.1680481953846193e+18,1,7,7.0,7,7,1,0
1.1680536879283476e+18,2,9,4.5,4,5,2,0
1.1680538615201157e+18,1,3,3.0,3,3,1,0
1.168056141501646e+18,6,11,1.8333333333333333,1,3,6,0
1.1680648063463923e+18,2,2,1.0,1,1,2,0
1.1680846418924897e+18,2,7,3.5,3,4,2,0
1.1680848671086764e+18,9,43,4.777777777777778,4,6,9,0
1.168084937761243e+18,2,8,4.0,4,4,2,0
1.1680863908735148e+18,3,12,4.0,4,4,3,0
1.1680864437620052e+18,31,163,5.258064516129032,3,7,31,0
1.1680884237479094e+18,1,4,4.0,4,4,1,0
1.168091060099678e+18,44,94,2.1363636363636362,1,4,44,0
1.1680929176700716e+18,27,222,8.222222222222221,6,10,5,22
1.16810095367541e+18,6,15,2.5,1,5,6,0
1.1681109204095636e+18,13,105,8.076923076923077,2,10,3,10
1.1681494983726136e+18,10,25,2.5,2,4,10,0
1.1682050645128899e+18,27,233,8.62962962962963,5,10,2,25
1.1682070701283236e+18,2,9,4.5,2,7,2,0
1.168264099022196e+18,6,14,2.3333333333333335,1,4,6,0
1.1682760218233078e+18,8,18,2.25,1,3,8,0
1.1682870096662292e+18,32,189,5.90625,2,8,31,1
1.168311081318481e+18,13,17,1.3076923076923077,1,3,13,0
1.1684674500101916e+18,3,7,2.3333333333333335,1,3,3,0
1.1685217851451973e+18,14,106,7.571428571428571,6,9,7,7
1.1685643131580739e+18,25,181,7.24,6,9,15,10
1.1685748086984637e+18,14,129,9.214285714285714,3,12,2,12
1.16865272107115e+18,49,71,1.4489795918367347,1,3,49,0
1.168687047912306e+18,14,135,9.642857142857142,7,12,1,13
1.1687187899713946e+18,2,16,8.0,7,9,1,1
1.1687285540793805e+18,18,171,9.5,3,12,2,16
1.1687363273663078e+18,17,165,9.705882352941176,6,12,1,16
1.1687410974403517e+18,1,2,2.0,2,2,1,0
1.1687772242786081e+18,44,303,6.886363636363637,5,9,34,10
1.168782475041436e+18,1,3,3.0,3,3,1,0
1.168805162489489e+18,35,177,5.057142857142857,2,7,35,0
1.168811729403091e+18,20,100,5.0,3,7,20,0
1.168820533815007e+18,23,88,3.8260869565217392,2,6,23,0
1.168823287501245e+18,1,8,8.0,8,8,0,1
1.1688262930751355e+18,11,89,8.090909090909092,7,10,3,8
1.1688521629168297e+18,30,122,4.066666666666666,2,8,29,1
1.1688896213531443e+18,12,58,4.833333333333333,3,8,11,1
1.1689184402569618e+18,10,20,2.0,1,4,10,0
1.1689807898090483e+18,5,42,8.4,7,11,2,3
1.1690050541334326e+18,13,125,9.615384615384615,7,11,1,12
1.1693502669832525e+18,2,2,1.0,1,1,2,0
1.1694029833320837e+18,6,14,2.3333333333333335,1,4,6,0
1.1694333472309105e+18,11,37,3.3636363636363638,1,6,11,0
1.169452756524498e+18,9,64,7.111111111111111,5,8,5,4
1.1695035987677253e+18,22,148,6.7272727272727275,5,8,18,4
1.1695651013592494e+18,9,20,2.2222222222222223,1,5,9,0
1.170016826247118e+18,26,127,4.884615384615385,4,7,26,0
1.1700386340168376e+18,11,27,2.4545454545454546,1,4,11,0
1.17007068996746e+18,3,18,6.0,3,8,2,1
1.1701036946511183e+18,35,173,4.942857142857143,3,7,35,0
1.1701196660019945e+18,42,170,4.0476190476190474,2,7,42,0
1.1701206648752653e+18,4,24,6.0,5,7,4,0
1.1701218234376635e+18,10,52,5.2,3,6,10,0
1.170135358881327e+18,10,70,7.0,3,9,5,5
1.1701461027709742e+18,20,155,7.75,5,9,5,15
1.1701501721012598e+18,51,360,7.0588235294117645,3,9,31,20
1.170153975522406e+18,3,15,5.0,3,7,3,0
1.1702156967913516e+18,27,245,9.074074074074074,4,11,3,24
1.1702184587048146e+18,2,16,8.0,7,9,1,1
1.1702263357850324e+18,8,59,7.375,3,10,5,3
1.1702288050530304e+18,76,745,9.802631578947368,4,12,2,74
1.1702512020425713e+18,2,15,7.5,7,8,1,1
1.170296439276283e+18,1,9,9.0,9,9,0,1
1.170318789263634e+18,11,88,8.0,7,9,2,9
1.1704122495762007e+18,40,364,9.1,4,12,2,38
1.1704383210778378e+18,20,81,4.05,3,6,20,0
1.1707275358484372e+18,21,49,2.3333333333333335,1,4,21,0
1.1707410159069806e+18,21,40,1.9047619047619047,1,3,21,0
1.1707435520405699e+18,1,4,4.0,4,4,1,0
1.170787394670194e+18,14,51,3.642857142857143,2,5,14,0
1.17079703640696e+18,1,3,3.0,3,3,1,0
1.1708129516355356e+18,4,28,7.0,6,8,3,1
1.1708258421690706e+18,10,65,6.5,3,8,9,1
1.1708517341319324e+18,17,63,3.7058823529411766,2,6,17,0
1.1708660481285384e+18,15,30,2.0,1,4,15,0
1.1709160977155487e+18,26,221,8.5,6,11,6,20
1.1709337593866606e+18,1,1,1.0,1,1,1,0
1.1709380754066452e+18,3,13,4.333333333333333,4,5,3,0
1.1709643923186542e+18,4,32,8.0,7,9,1,3
1.1710075528137288e+18,1,9,9.0,9,9,0,1
1.1710094390770762e+18,8,16,2.0,1,3,8,0
1.1710259269829496e+18,1,4,4.0,4,4,1,0
1.1710517558090386e+18,2,14,7.0,6,8,1,1
1.1710606384368676e+18,2,13,6.5,6,7,2,0
1.1710648338624556e+18,33,225,6.818181818181818,3,9,25,8
1.171072525806623e+18,38,360,9.473684210526315,7,12,3,35
1.1710778412858737e+18,81,709,8.753086419753087,2,12,8,73
1.1711047020348022e+18,11,88,8.0,7,10,4,7
1.1711259069547044e+18,30,297,9.9,2,12,2,28
1.1711316294361544e+18,15,142,9.466666666666667,3,12,2,13
1.171134915315989e+18,2,17,8.5,8,9,0,2
1.1711375907243735e+18,11,61,5.545454545454546,3,7,11,0
1.1711410178210143e+18,17,68,4.0,2,6,17,0
1.1712191760793178e+18,3,23,7.666666666666667,7,8,1,2
1.1714653861682066e+18,4,13,3.25,2,4,4,0
1.17146953784605e+18,17,139,8.176470588235293,4,11,5,12
1.1714807211487114e+18,2,12,6.0,5,7,2,0
1.1715071535995625e+18,2,13,6.5,6,7,2,0
1.1715203373894838e+18,109,744,6.825688073394495,2,9,74,35
1.1715215676780004e+18,7,56,8.0,3,10,2,5
1.1715280375906995e+18,15,143,9.533333333333333,8,11,0,15
1.1715398506481175e+18,10,74,7.4,5,9,5,5
1.1715443893202263e+18,35,108,3.085714285714286,1,5,35,0
1.1715466494080735e+18,5,51,10.2,9,11,0,5
1.171558499980488e+18,4,37,9.25,8,11,0,4
1.1716003142128993e+18,63,127,2.015873015873016,1,4,63,0
1.1716345452117302e+18,39,193,4.948717948717949,2,7,39,0
1.171637458166292e+18,45,286,6.355555555555555,2,9,39,6
1.1716647172507802e+18,17,162,9.529411764705882,4,12,2,15
1.171700706100423e+18,21,198,9.428571428571429,6,12,2,19
1.1717040995766853e+18,1,4,4.0,4,4,1,0
1.1717054440869834e+18,1,3,3.0,3,3,1,0
1.1717181864282353e+18,30,220,7.333333333333333,5,9,14,16
1.171730185289068e+18,10,96,9.6,8,11,0,10
1.171737923495708e+18,5,40,8.0,7,9,1,4
1.171765065515607e+18,2,5,2.5,2,3,2,0
1.1717783033694743e+18,24,53,2.2083333333333335,1,4,24,0
1.1718301342350802e+18,24,122,5.083333333333333,4,7,24,0
1.1718513964431908e+18,10,91,9.1,3,11,2,8
1.1719282611770944e+18,2,2,1.0,1,1,2,0
1.1719588960727278e+18,23,48,2.0869565217391304,1,4,23,0
1.172104422625515e+18,1,6,6.0,6,6,1,0
1.172191449649821e+18,9,73,8.11111111111111,7,9,3,6
1.172230225864437e+18,15,121,8.066666666666666,2,11,4,11
1.1722356118168115e+18,58,241,4.155172413793103,1,6,58,0
1.172236535027556e+18,4,22,5.5,5,6,4,0
1.172239830062076e+18,32,295,9.21875,6,12,3,29
1.1722426645415444e+18,1,5,5.0,5,5,1,0
1.1722545587756628e+18,5,28,5.6,3,8,4,1
1.1722772175122368e+18,1,4,4.0,4,4,1,0
1.1722908371909468e+18,14,98,7.0,5,9,10,4
1.1722967684673564e+18,24,115,4.791666666666667,3,7,24,0
1.1723023423210363e+18,41,251,6.121951219512195,4,8,38,3
1.1723215527886472e+18,2,14,7.0,7,7,2,0
1.1723291626492874e+18,30,86,2.8666666666666667,1,5,30,0
1.172332597941329e+18,11,36,3.272727272727273,2,5,11,0
1.1723497234982433e+18,18,95,5.277777777777778,4,6,18,0
1.1723672618059937e+18,8,60,7.5,6,9,3,5
1.172372036646768e+18,37,75,2.027027027027027,1,4,37,0
1.172373936477905e+18,4,17,4.25,2,6,4,0
1.1723822661031895e+18,1,9,9.0,9,9,0,1
1.1723869454639685e+18,4,18,4.5,4,5,4,0
1.1723870957514627e+18,21,40,1.9047619047619047,1,4,21,0
1.1723890086812447e+18,1,2,2.0,2,2,1,0
1.172391050385107e+18,32,165,5.15625,3,7,32,0
1.1724152685291471e+18,1,2,2.0,2,2,1,0
1.1724233717971313e+18,11,55,5.0,3,7,11,0
1.1724524493979459e+18,15,146,9.733333333333333,7,12,1,14
1.172455152667817e+18,24,217,9.041666666666666,2,12,3,21
1.1724564146351483e+18,7,19,2.7142857142857144,2,3,7,0
1.1724578331670976e+18,1,1,1.0,1,1,1,0
1.1724608050910572e+18,29,256,8.827586206896552,7,11,3,26
1.1724655463870802e+18,2,4,2.0,1,3,2,0
1.1724691356685435e+18,4,9,2.25,2,3,4,0
1.172570085462856e+18,51,71,1.392156862745098,1,4,51,0
1.172668293942687e+18,8,46,5.75,5,7,8,0
1.1728309770653123e+18,69,98,1.4202898550724639,1,5,69,0
1.1728903959183488e+18,5,41,8.2,6,9,1,4
1.1729061504030013e+18,7,35,5.0,4,7,7,0
1.1729098539124204e+18,2,4,2.0,2,2,2,0
1.1729273499261028e+18,10,18,1.8,1,3,10,0
1.1729395554793083e+18,2,13,6.5,4,9,1,1
1.1729501579066975e+18,5,9,1.8,1,3,5,0
1.1729540189172895e+18,1,3,3.0,3,3,1,0
1.172956159662962e+18,16,86,5.375,4,8,15,1
1.1729609620307556e+18,26,129,4.961538461538462,3,7,26,0
1.1729622896537155e+18,66,629,9.530303030303031,2,14,6,60
1.172982047496683e+18,3,7,2.3333333333333335,1,3,3,0
1.1729869206952845e+18,1,2,2.0,2,2,1,0
1.1730018058615608e+18,8,30,3.75,2,5,8,0
1.173004153748367e+18,50,334,6.68,2,9,37,13
1.1730277046711063e+18,48,324,6.75,5,9,38,10
1.1730292477149983e+18,40,285,7.125,5,9,27,13
1.1730302894372419e+18,40,272,6.8,2,9,30,10
1.173031193480121e+18,42,287,6.833333333333333,2,11,31,11
1.1730376633799007e+18,38,194,5.105263157894737,3,8,37,1
1.173052395643411e+18,1,3,3.0,3,3,1,0
1.17307035995775e+18,68,663,9.75,3,12,6,62
1.173082279848992e+18,13,116,8.923076923076923,5,10,1,12
1.173088376636428e+18,1,2,2.0,2,2,1,0
1.1730897519654308e+18,1,8,8.0,8,8,0,1
1.1730951797828613e+18,1,2,2.0,2,2,1,0
1.1731075939467802e+18,5,50,10.0,9,11,0,5
1.1731165604399283e+18,40,229,5.725,2,8,39,1
1.1731203326400074e+18,17,137,8.058823529411764,7,10,4,13
1.1731222027856678e+18,1,2,2.0,2,2,1,0
1.173150043088158e+18,21,210,10.0,8,12,0,21
1.1731584706312753e+18,21,195,9.285714285714286,3,12,2,19
1.1731654788154345e+18,1,6,6.0,6,6,1,0
1.1731799065136223e+18,14,28,2.0,1,4,14,0
1.173182440500784e+18,16,32,2.0,1,5,16,0
1.1731849031082755e+18,3,9,3.0,2,4,3,0
1.1731850989403645e+18,23,64,2.782608695652174,1,5,23,0
1.1731958014255657e+18,2,7,3.5,3,4,2,0
1.1732081882560215e+18,27,65,2.4074074074074074,1,4,27,0
1.173240556404906e+18,2,10,5.0,5,5,2,0
1.1732604127568737e+18,6,38,6.333333333333333,3,8,4,2
1.1734685994452316e+18,1,8,8.0,8,8,0,1
1.1736277208264684e+18,1,4,4.0,4,4,1,0
1.1736420287920166e+18,16,104,6.5,4,8,12,4
1.1736431312116137e+18,16,33,2.0625,1,3,16,0
1.173643137614214e+18,43,94,2.186046511627907,1,5,43,0
1.1736519447109975e+18,2,5,2.5,2,3,2,0
1.1736548824384714e+18,1,8,8.0,8,8,0,1
1.1736563457515136e+18,5,14,2.8,2,4,5,0
1.1736630922941512e+18,3,4,1.3333333333333333,1,2,3,0
1.173672162138446e+18,7,58,8.285714285714286,7,10,1,6
1.1736808657973e+18,3,22,7.333333333333333,7,8,2,1
1.173683989577069e+18,2,4,2.0,2,2,2,0
1.1736852544855657e+18,5,36,7.2,6,9,4,1
1.173685737885913e+18,8,53,6.625,5,9,7,1
1.1737033984972787e+18,2,8,4.0,4,4,2,0
1.1737035315446515e+18,3,10,3.3333333333333335,3,4,3,0
1.1737082860053092e+18,10,24,2.4,1,3,10,0
1.1737311626871644e+18,2,6,3.0,3,3,2,0
1.1737417547461972e+18,10,73,7.3,6,8,5,5
1.1737743575880305e+18,3,7,2.3333333333333335,2,3,3,0
1.173784161099597e+18,4,28,7.0,6,8,3,1
1.173798128134322e+18,4,9,2.25,1,3,4,0
1.1737996628694364e+18,3,21,7.0,6,8,2,1
1.1738031660449152e+18,4,18,4.5,2,6,4,0
1.1738294057485407e+18,97,578,5.958762886597938,2,8,92,5
1.1738571144798298e+18,2,7,3.5,3,4,2,0
1.1738626567098214e+18,1,1,1.0,1,1,1,0
1.1738674790943455e+18,1,1,1.0,1,1,1,0
1.1738739650934016e+18,1,1,1.0,1,1,1,0
1.1738824973771822e+18,1,2,2.0,2,2,1,0
1.1738907304720947e+18,11,79,7.181818181818182,6,10,7,4
1.1738911807934528e+18,26,78,3.0,1,4,26,0
1.173927972163041e+18,8,54,6.75,5,8,6,2
1.1739578114598897e+18,26,172,6.615384615384615,3,9,19,7
1.1739770362071647e+18,12,49,4.083333333333333,3,6,12,0
1.1739859581689477e+18,10,39,3.9,2,6,10,0
1.1739937295257582e+18,3,14,4.666666666666667,4,5,3,0
1.1740155372414612e+18,13,121,9.307692307692308,7,11,1,12
1.1740177017459428e+18,8,53,6.625,4,8,5,3
1.1740897745377285e+18,2,6,3.0,3,3,2,0
1.1740989181277486e+18,2,14,7.0,7,7,2,0
1.1741110883632187e+18,16,130,8.125,2,10,3,13
1.1741158074198858e+18,5,40,8.0,7,9,1,4
1.1742188866398254e+18,1,1,1.0,1,1,1,0
1.1743187767759657e+18,4,6,1.5,1,2,4,0
1.174370310606122e+18,51,248,4.862745098039215,2,7,51,0
1.1743884085697024e+18,2,5,2.5,2,3,2,0
1.1744271896314025e+18,24,232,9.666666666666666,3,12,2,22
1.1744444329651192e+18,37,265,7.162162162162162,3,10,20,17
1.1744453589219848e+18,4,31,7.75,7,9,2,2
1.1744689139494484e+18,15,134,8.933333333333334,7,10,1,14
1.1744724735287068e+18,20,200,10.0,5,11,1,19
1.1744757840560072e+18,1,7,7.0,7,7,1,0
1.174485839952588e+18,8,35,4.375,3,6,8,0
1.1745080585123412e+18,26,176,6.769230769230769,2,9,19,7
1.1745864372970102e+18,7,50,7.142857142857143,6,9,5,2
1.1746097650045737e+18,1,5,5.0,5,5,1,0
1.1746287198769697e+18,3,12,4.0,4,4,3,0
1.1746468067703232e+18,4,30,7.5,7,9,3,1
1.174679768147664e+18,1,7,7.0,7,7,1,0
1.174717960053406e+18,2,2,1.0,1,1,2,0
1.1747559513040497e+18,42,166,3.9523809523809526,1,6,42,0
1.1751225752572675e+18,24,114,4.75,2,7,24,0
1.1751753060762476e+18,11,17,1.5454545454545454,1,3,11,0
1.1751897002604396e+18,16,17,1.0625,1,2,16,0
1.1751965499256865e+18,13,65,5.0,3,7,13,0
1.1752076729816072e+18,1,1,1.0,1,1,1,0
1.175221386244019e+18,5,26,5.2,5,6,5,0
1.1752616915402893e+18,5,11,2.2,1,3,5,0
1.1752621463141376e+18,2,7,3.5,3,4,2,0
1.1753137850566438e+18,1,8,8.0,8,8,0,1
1.1753284177383798e+18,9,69,7.666666666666667,4,10,5,4
1.175330727423301e+18,2,17,8.5,8,9,0,2
1.1753862954854303e+18,14,125,8.928571428571429,8,10,0,14
1.1754551981862198e+18,15,75,5.0,2,7,15,0
1.175465837194287e+18,4,31,7.75,7,8,1,3
1.1754751825937116e+18,4,10,2.5,2,3,4,0
1.1754867502106813e+18,21,191,9.095238095238095,3,12,3,18
1.1755011127199352e+18,44,173,3.9318181818181817,2,6,44,0
1.175827267009399e+18,1,3,3.0,3,3,1,0
1.1758508586442373e+18,16,143,8.9375,8,10,0,16
1.1758590405717676e+18,10,105,10.5,9,12,0,10
1.175865485627716e+18,16,43,2.6875,1,4,16,0
1.1758661367093844e+18,11,50,4.545454545454546,2,6,11,0
1.175874697005514e+18,16,158,9.875,8,12,0,16
1.175886217990794e+18,1,1,1.0,1,1,1,0
1.1759577301730378e+18,8,17,2.125,1,3,8,0
1.1759644736327675e+18,2,12,6.0,5,7,2,0
1.176004052696425e+18,5,37,7.4,7,8,3,2
1.1760187195167053e+18,4,29,7.25,6,8,2,2
1.1760211984409554e+18,3,17,5.666666666666667,3,7,3,0
1.1760233059974472e+18,5,16,3.2,2,4,5,0
1.1760280695503199e+18,11,19,1.7272727272727273,1,3,11,0
1.1760389288894356e+18,6,40,6.666666666666667,5,8,3,3
1.1760415645459364e+18,40,194,4.85,3,7,40,0
1.176043271358498e+18,7,39,5.571428571428571,4,7,7,0
1.176056979872432e+18,6,30,5.0,2,7,6,0
1.176064125359308e+18,2,16,8.0,7,9,1,1
1.176098990571313e+18,30,63,2.1,1,4,30,0
1.176120157417207e+18,2,18,9.0,9,9,0,2
1.1761426125181555e+18,15,154,10.266666666666667,8,12,0,15
1.1761628068328502e+18,12,14,1.1666666666666667,1,2,12,0
1.1761817773894858e+18,10,16,1.6,1,3,10,0
1.1762166769387717e+18,1,4,4.0,4,4,1,0
1.1762247851034115e+18,1,2,2.0,2,2,1,0
1.1762784845209723e+18,1,8,8.0,8,8,0,1
1.1764602872940288e+18,30,82,2.7333333333333334,1,6,30,0
1.1765196250915853e+18,180,526,2.922222222222222,1,6,180,0
1.1765569117062052e+18,9,37,4.111111111111111,3,6,9,0
1.1765761330594598e+18,10,50,5.0,4,6,10,0
1.176577066611811e+18,13,88,6.769230769230769,2,9,6,7
1.1765833716164728e+18,45,94,2.088888888888889,1,4,45,0
1.176599171631758e+18,10,94,9.4,3,12,1,9
1.1766171459555643e+18,1,9,9.0,9,9,0,1
1.1766210027344556e+18,26,155,5.961538461538462,4,8,25,1
1.176628317422998e+18,27,134,4.962962962962963,3,7,27,0
1.1766558269002445e+18,1,11,11.0,11,11,0,1
1.1766619870770895e+18,1,2,2.0,2,2,1,0
1.1766629938876457e+18,2,14,7.0,7,7,2,0
1.1766640872855882e+18,1,1,1.0,1,1,1,0
1.1766652958282383e+18,34,69,2.0294117647058822,1,4,34,0
1.176688976155634e+18,1,1,1.0,1,1,1,0
1.1766992513170015e+18,1,1,1.0,1,1,1,0
1.1767383696190866e+18,15,78,5.2,3,8,14,1
1.176738542557199e+18,2,3,1.5,1,2,2,0
1.1767975965733837e+18,6,41,6.833333333333333,6,8,5,1
1.1768141524688397e+18,3,9,3.0,2,4,3,0
1.1768172047240397e+18,14,144,10.285714285714286,8,13,0,14
1.1768327459742587e+18,3,24,8.0,8,8,0,3
1.1768534490411474e+18,10,88,8.8,7,10,1,9
1.176881854714457e+18,68,333,4.897058823529412,2,9,67,1
1.176884746152976e+18,6,31,5.166666666666667,2,6,6,0
1.1768852695665807e+18,113,547,4.84070796460177,2,7,113,0
1.1768877001835077e+18,7,31,4.428571428571429,4,5,7,0
1.176909931318861e+18,16,123,7.6875,4,9,4,12
1.1769107503077463e+18,8,13,1.625,1,2,8,0
1.176920114551652e+18,3,24,8.0,7,9,1,2
1.1769828588506324e+18,25,144,5.76,3,7,25,0
1.1771537997365463e+18,1,1,1.0,1,1,1,0
1.1772787724873633e+18,9,44,4.888888888888889,2,7,9,0
1.1772958742973253e+18,6,53,8.833333333333334,3,11,1,5
1.1773097808645635e+18,2,16,8.0,6,10,1,1
1.177330841402774e+18,10,75,7.5,4,9,4,6
1.1773487987797978e+18,45,95,2.111111111111111,1,4,45,0
1.177394484784127e+18,15,48,3.2,2,5,15,0
1.177444898671386e+18,41,250,6.097560975609756,4,8,38,3
1.1774545704032146e+18,17,33,1.9411764705882353,1,3,17,0
1.1774615981047475e+18,1,5,5.0,5,5,1,0
1.177488430132045e+18,4,28,7.0,6,8,3,1
1.1775088134389952e+18,10,65,6.5,2,9,7,3
1.1775430530165706e+18,7,58,8.285714285714286,8,9,0,7
1.1775851834460618e+18,44,222,5.045454545454546,2,8,43,1
1.1776195207324777e+18,4,11,2.75,1,4,4,0
1.1776243053829286e+18,1,5,5.0,5,5,1,0
1.1776247981153759e+18,2,15,7.5,7,8,1,1
1.1776280716705203e+18,1,2,2.0,2,2,1,0
1.1776282571252516e+18,13,123,9.461538461538462,6,11,1,12
1.177629542388327e+18,9,13,1.4444444444444444,1,3,9,0
1.177629731999803e+18,2,9,4.5,4,5,2,0
1.1776343642145892e+18,6,46,7.666666666666667,7,9,3,3
1.1776492680692467e+18,2,16,8.0,8,8,0,2
1.177650900982e+18,1,4,4.0,4,4,1,0
1.1776879025263457e+18,4,12,3.0,1,5,4,0
1.177713837029667e+18,6,41,6.833333333333333,6,8,4,2
1.1779031283449736e+18,1,4,4.0,4,4,1,0
1.1779885900344453e+18,4,25,6.25,5,9,3,1
1.1780309129540544e+18,10,45,4.5,3,6,10,0
1.1780393510228188e+18,1,4,4.0,4,4,1,0
1.1780550299803203e+18,34,177,5.205882352941177,3,8,33,1
1.1780702216343104e+18,8,23,2.875,1,4,8,0
1.178074532076671e+18,3,28,9.333333333333334,9,10,0,3
1.1780780211782236e+18,10,77,7.7,6,9,3,7
1.1780835376957453e+18,34,198,5.823529411764706,2,8,30,4
1.1780979156328655e+18,37,214,5.783783783783784,3,7,37,0
1.1781093546583206e+18,12,36,3.0,1,4,12,0
1.1781187321837865e+18,6,13,2.1666666666666665,1,3,6,0
1.1781191286362012e+18,101,137,1.3564356435643565,1,3,101,0
1.1781538790667968e+18,9,31,3.4444444444444446,3,4,9,0
1.1781606080774684e+18,8,57,7.125,5,9,5,3
1.1781769655810522e+18,8,40,5.0,3,7,8,0
1.1781827398717898e+18,1,4,4.0,4,4,1,0
1.1782115454045714e+18,50,241,4.82,2,7,50,0
1.1782163359300956e+18,36,49,1.3611111111111112,1,3,36,0
1.1782197873595067e+18,1,7,7.0,7,7,1,0
1.1782313730711375e+18,10,99,9.9,9,11,0,10
1.1782473376244526e+18,9,50,5.555555555555555,4,7,9,0
1.1782492763439565e+18,13,88,6.769230769230769,5,9,9,4
1.1782772864632136e+18,59,293,4.966101694915254,3,8,58,1
1.178296020059014e+18,8,61,7.625,4,10,3,5
1.1783438365702072e+18,5,7,1.4,1,2,5,0
1.178354558759785e+18,45,92,2.0444444444444443,1,4,45,0
1.1783965989238615e+18,26,74,2.8461538461538463,1,4,26,0
1.1784044209238354e+18,6,18,3.0,2,4,6,0
1.1784058405318362e+18,3,23,7.666666666666667,6,9,1,2
1.1784289318885747e+18,12,70,5.833333333333333,5,7,12,0
1.1787316184116178e+18,1,6,6.0,6,6,1,0
1.1787713860897871e+18,4,16,4.0,3,5,4,0
1.1787874222256735e+18,13,87,6.6923076923076925,4,9,8,5
1.178795850864998e+18,1,4,4.0,4,4,1,0
1.178806251307095e+18,2,17,8.5,8,9,0,2
1.1788164605367583e+18,1,9,9.0,9,9,0,1
1.1788319056713746e+18,25,180,7.2,5,10,17,8
1.1788343444451917e+18,8,57,7.125,6,9,5,3
1.1788546521404938e+18,19,94,4.947368421052632,2,6,19,0
1.17885958406066e+18,10,94,9.4,5,10,1,9
1.1788651295289257e+18,26,221,8.5,3,11,3,23
1.1788726462986706e+18,4,30,7.5,7,8,2,2
1.178894879825822e+18,10,15,1.5,1,3,10,0
1.1789039336146056e+18,15,34,2.2666666666666666,1,3,15,0
1.1789067502444782e+18,4,9,2.25,1,3,4,0
1.1789144860463757e+18,31,189,6.096774193548387,2,8,26,5
1.1789213163039043e+18,3,26,8.666666666666666,8,9,0,3
1.1789462055037366e+18,10,102,10.2,9,12,0,10
1.1789990490497649e+18,1,3,3.0,3,3,1,0
1.1790210459065654e+18,3,17,5.666666666666667,5,6,3,0
1.1791049594433093e+18,9,43,4.777777777777778,4,5,9,0
1.1792878000725883e+18,6,60,10.0,9,11,0,6
1.1794465488521065e+18,1,1,1.0,1,1,1,0
1.179478292563934e+18,3,27,9.0,9,9,0,3
1.1794798867832666e+18,1,1,1.0,1,1,1,0
1.1794872668030467e+18,16,80,5.0,4,6,16,0
1.1795423212107197e+18,5,36,7.2,6,8,3,2
1.1795531759065428e+18,11,73,6.636363636363637,2,9,8,3
1.179562412975924e+18,13,93,7.153846153846154,4,9,8,5
1.179568913908988e+18,19,157,8.263157894736842,7,10,4,15
1.1795697728260004e+18,3,24,8.0,7,9,1,2
1.1795938675780372e+18,3,18,6.0,5,7,3,0
1.1795988088575014e+18,11,81,7.363636363636363,3,9,4,7
1.1796098638970386e+18,1,2,2.0,2,2,1,0
1.1796536315599913e+18,14,141,10.071428571428571,9,12,0,14
1.179667598291484e+18,1,8,8.0,8,8,0,1
1.1797732900084e+18,29,217,7.482758620689655,6,9,12,17
1.1797817491496701e+18,2,12,6.0,6,6,2,0
1.1798119450044787e+18,62,262,4.225806451612903,1,7,62,0
1.1798408139208148e+18,4,31,7.75,4,9,1,3
1.1798762150088404e+18,20,96,4.8,2,6,20,0
1.1801471079973412e+18,24,231,9.625,6,13,1,23
1.1801728822413647e+18,4,11,2.75,1,4,4,0
1.180222780305032e+18,10,31,3.1,1,5,10,0
1.1802302346156974e+18,2,16,8.0,8,8,0,2
1.1802352573010033e+18,4,33,8.25,7,9,1,3
1.1802582283892485e+18,1,7,7.0,7,7,1,0
1.1802714417747108e+18,5,43,8.6,8,10,0,5
1.180306871753451e+18,2,5,2.5,2,3,2,0
1.1803298970009774e+18,8,66,8.25,7,9,2,6
1.1804408567991636e+18,18,53,2.9444444444444446,1,5,18,0
1.18049791388755e+18,13,64,4.923076923076923,3,6,13,0
1.1805049324052475e+18,6,49,8.166666666666666,7,9,1,5
1.1805276356305457e+18,34,327,9.617647058823529,2,12,1,33
1.1805279816306924e+18,2,3,1.5,1,2,2,0
1.1805595430707535e+18,8,73,9.125,8,11,0,8
1.1805612192286428e+18,3,26,8.666666666666666,8,9,0,3
1.1805798313111293e+18,1,3,3.0,3,3,1,0
1.1805894677927652e+18,18,139,7.722222222222222,4,9,6,12
1.1806074197260436e+18,26,202,7.769230769230769,3,11,10,16
1.1806112735283945e+18,3,8,2.6666666666666665,2,3,3,0
1.180614549969078e+18,28,110,3.9285714285714284,2,6,28,0
1.1806250950190031e+18,5,33,6.6,4,9,4,1
1.1806259655803528e+18,18,132,7.333333333333333,2,10,7,11
1.1808408196456842e+18,11,90,8.181818181818182,2,12,2,9
1.1808625509393231e+18,22,109,4.954545454545454,3,7,22,0
1.1808626131421778e+18,2,16,8.0,8,8,0,2
1.1808929782770194e+18,1,9,9.0,9,9,0,1
1.1809187553332012e+18,1,3,3.0,3,3,1,0
1.1809296495774646e+18,1,6,6.0,6,6,1,0
1.1809402527858755e+18,1,2,2.0,2,2,1,0
1.181010449382218e+18,3,21,7.0,6,8,2,1
1.1810200100073905e+18,42,205,4.880952380952381,3,8,41,1
1.181038956330584e+18,5,43,8.6,8,10,0,5
1.1810437616679337e+18,5,11,2.2,1,4,5,0
1.1810468617396493e+18,37,225,6.081081081081081,4,8,34,3
1.1810635796265418e+18,13,87,6.6923076923076925,4,9,9,4
1.1810766507263063e+18,18,73,4.055555555555555,2,7,18,0
1.1811244542799808e+18,34,235,6.911764705882353,3,9,25,9
1.181127484086367e+18,5,29,5.8,4,7,5,0
1.1811932118254868e+18,2,6,3.0,2,4,2,0
1.1811978074017544e+18,3,18,6.0,2,8,1,2
1.1811989547977375e+18,2,2,1.0,1,1,2,0
1.1812034452613084e+18,7,54,7.714285714285714,7,9,3,4
1.181208251038231e+18,37,189,5.108108108108108,2,8,36,1
1.1812130848730852e+18,8,10,1.25,1,2,8,0
1.181223464160344e+18,4,37,9.25,7,12,1,3
1.1812425226883784e+18,11,52,4.7272727272727275,4,6,11,0
1.1812486840621742e+18,6,7,1.1666666666666667,1,2,6,0
1.1812727750271263e+18,26,123,4.730769230769231,3,7,26,0
1.1813073494207936e+18,5,9,1.8,1,3,5,0
1.181322595497448e+18,39,267,6.846153846153846,3,9,32,7
1.181325478401794e+18,27,232,8.592592592592593,3,12,5,22
1.181376559580876e+18,32,242,7.5625,2,10,11,21
1.1814315435876367e+18,7,40,5.714285714285714,4,7,7,0
1.181572191546745e+18,13,42,3.230769230769231,2,4,13,0
1.1816329505683282e+18,19,74,3.8947368421052633,1,6,19,0
1.1816447227674988e+18,21,101,4.809523809523809,2,7,21,0
1.1816459415274834e+18,20,122,6.1,4,7,20,0
1.1816512068788116e+18,40,86,2.15,1,5,40,0
1.1816542994382932e+18,6,15,2.5,1,3,6,0
1.181654724964659e+18,4,33,8.25,7,9,1,3
1.1816689242070948e+18,24,53,2.2083333333333335,1,4,24,0
1.181669060991038e+18,6,46,7.666666666666667,7,9,3,3
1.1816738917714122e+18,16,111,6.9375,5,8,11,5
1.1816768418685279e+18,41,88,2.1463414634146343,1,4,41,0
1.1816980811707136e+18,5,15,3.0,2,4,5,0
1.1817006041067494e+18,3,5,1.6666666666666667,1,2,3,0
1.1817021458681672e+18,15,68,4.533333333333333,2,6,15,0
1.18171366290405e+18,35,53,1.5142857142857142,1,4,35,0
1.181714880642824e+18,19,186,9.789473684210526,9,11,0,19
1.1817336574300375e+18,15,21,1.4,1,3,15,0
1.1817337949286415e+18,9,75,8.333333333333334,4,11,2,7
1.1817470452595845e+18,1,2,2.0,2,2,1,0
1.181754812991404e+18,2,5,2.5,2,3,2,0
1.1818074339527974e+18,1,2,2.0,2,2,1,0
1.181828606487986e+18,28,45,1.6071428571428572,1,3,28,0
1.1818287522251395e+18,3,8,2.6666666666666665,2,4,3,0
1.181836039938112e+18,9,21,2.3333333333333335,1,4,9,0
1.1818409843358036e+18,9,41,4.555555555555555,2,6,9,0
1.18184487215991e+18,6,15,2.5,1,4,6,0
1.1818615190192937e+18,35,138,3.942857142857143,2,6,35,0
1.181875355139187e+18,3,6,2.0,2,2,3,0
1.1818782375488084e+18,41,399,9.731707317073171,4,12,3,38
1.1819062518981396e+18,6,12,2.0,1,3,6,0
1.181910252807838e+18,3,17,5.666666666666667,2,8,2,1
1.1819851822143905e+18,2,19,9.5,9,10,0,2
1.1820097449886164e+18,64,271,4.234375,2,6,64,0
1.1820157714093993e+18,15,32,2.1333333333333333,1,4,15,0
1.1820674598245699e+18,2,5,2.5,2,3,2,0
1.1823370285508713e+18,20,177,8.85,2,13,4,16
1.1823808297297562e+18,12,25,2.0833333333333335,1,4,12,0
1.1823828075011443e+18,8,13,1.625,1,4,8,0
1.1823831438232668e+18,36,70,1.9444444444444444,1,4,36,0
1.182386792011407e+18,8,20,2.5,2,4,8,0
1.1823874110120407e+18,7,15,2.142857142857143,1,4,7,0
1.1823923146439857e+18,7,7,1.0,1,1,7,0
1.1823979163410929e+18,17,46,2.7058823529411766,1,4,17,0
1.1823991742836444e+18,11,75,6.818181818181818,5,8,8,3
1.1824157461252552e+18,1,10,10.0,10,10,0,1
1.1824236816217864e+18,15,38,2.533333333333333,1,4,15,0
1.1824251871194598e+18,3,16,5.333333333333333,4,7,3,0
1.1824257766863762e+18,13,21,1.6153846153846154,1,3,13,0
1.1824292309229448e+18,1,3,3.0,3,3,1,0
1.1824362155248612e+18,5,22,4.4,4,5,5,0
1.182437301214199e+18,3,7,2.3333333333333335,2,3,3,0
1.1824472888490304e+18,56,224,4.0,2,6,56,0
1.1824537159744115e+18,177,234,1.3220338983050848,1,4,177,0
1.1824777480894152e+18,15,112,7.466666666666667,5,10,8,7
1.182478237911143e+18,16,36,2.25,1,4,16,0
1.1825105436210107e+18,6,15,2.5,1,4,6,0
1.1825208941572419e+18,19,97,5.105263157894737,4,7,19,0
1.182522258210097e+18,21,211,10.047619047619047,4,12,1,20
1.1825455171009672e+18,26,96,3.6923076923076925,1,6,26,0
1.182548000379883e+18,2,4,2.0,2,2,2,0
1.1825480707734915e+18,1,3,3.0,3,3,1,0
1.1825530839846725e+18,6,19,3.1666666666666665,1,5,6,0
1.1825531270099955e+18,13,38,2.923076923076923,2,5,13,0
1.1825596124269773e+18,3,8,2.6666666666666665,2,3,3,0
1.1825621665586373e+18,3,5,1.6666666666666667,1,2,3,0
1.1825877189951555e+18,13,67,5.153846153846154,4,7,13,0
1.182590747445313e+18,1,1,1.0,1,1,1,0
1.182597718874353e+18,7,56,8.0,7,9,2,5
1.18261497805833e+18,8,14,1.75,1,3,8,0
1.1827072732973279e+18,2,4,2.0,1,3,2,0
1.1827096301853896e+18,32,47,1.46875,1,3,32,0
1.1827228647605558e+18,30,155,5.166666666666667,3,7,30,0
1.1827347584178458e+18,28,91,3.25,1,5,28,0
1.1827415431036908e+18,1,2,2.0,2,2,1,0
1.1829998711400064e+18,5,41,8.2,7,10,1,4
1.1830155312364055e+18,11,35,3.1818181818181817,1,5,11,0
1.183029171907558e+18,9,84,9.333333333333334,7,11,1,8
1.1830462618355162e+18,3,14,4.666666666666667,4,5,3,0
1.1830515156138816e+18,1,2,2.0,2,2,1,0
1.1830557496437555e+18,1,4,4.0,4,4,1,0
1.18306220471153e+18,5,50,10.0,9,11,0,5
1.18307128162807e+18,32,163,5.09375,3,7,32,0
1.1830741725404954e+18,29,65,2.2413793103448274,1,4,29,0
1.1830751275765222e+18,7,62,8.857142857142858,5,11,1,6
1.1830774857460959e+18,9,35,3.888888888888889,2,6,9,0
1.1830782453997432e+18,11,106,9.636363636363637,5,12,1,10
1.1830793455364375e+18,15,142,9.466666666666667,8,12,0,15
1.1830815446425083e+18,4,35,8.75,7,10,1,3
1.1830893229947082e+18,3,21,7.0,6,8,2,1
1.1830894792469025e+18,1,6,6.0,6,6,1,0
1.1830896284932575e+18,6,18,3.0,2,4,6,0
1.1831113032251264e+18,4,26,6.5,4,8,3,1
1.1831146074334213e+18,10,14,1.4,1,4,10,0
1.1831293136712238e+18,21,44,2.0952380952380953,1,4,21,0
1.1831322699607542e+18,1,1,1.0,1,1,1,0
1.1831331650546063e+18,1,6,6.0,6,6,1,0
1.1831351399090903e+18,24,51,2.125,1,4,24,0
1.183135383050249e+18,2,4,2.0,2,2,2,0
1.183137682594987e+18,26,154,5.923076923076923,5,8,24,2
1.1831421059447567e+18,14,79,5.642857142857143,2,8,12,2
1.183159909513252e+18,6,40,6.666666666666667,5,9,5,1
1.1831657082272788e+18,1,3,3.0,3,3,1,0
1.1831661937767188e+18,1,2,2.0,2,2,1,0
1.1831754271887007e+18,2,16,8.0,8,8,0,2
1.1831765929548406e+18,1,3,3.0,3,3,1,0
1.183179800121366e+18,12,94,7.833333333333333,7,10,6,6
1.183205373509658e+18,5,30,6.0,5,7,5,0
1.183218579843048e+18,11,90,8.181818181818182,6,9,1,10
1.1832597520671785e+18,9,19,2.111111111111111,1,3,9,0
1.1832907146438067e+18,31,148,4.774193548387097,2,7,31,0
1.1833045675819338e+18,25,49,1.96,1,4,25,0
1.1833187995454674e+18,4,9,2.25,1,3,4,0
1.1833380141182264e+18,23,35,1.5217391304347827,1,4,23,0
1.183396331223976e+18,1,3,3.0,3,3,1,0
1.1833970783842982e+18,2,4,2.0,1,3,2,0
1.1834025438351444e+18,17,167,9.823529411764707,8,11,0,17
1.183416912032041e+18,1,4,4.0,4,4,1,0
1.1834410111008282e+18,4,7,1.75,1,3,4,0
1.1834411717769318e+18,5,49,9.8,8,11,0,5
1.1834464137669606e+18,3,30,10.0,9,11,0,3
1.1834545588023762e+18,2,4,2.0,1,3,2,0
1.1834979308678774e+18,5,35,7.0,6,8,4,1
1.1835135862007506e+18,21,147,7.0,4,9,15,6
1.1837669074144008e+18,11,32,2.909090909090909,1,4,11,0
1.183788529382843e+18,4,30,7.5,6,9,2,2
1.1838013498363592e+18,28,189,6.75,4,8,21,7
1.18380233990313e+18,65,129,1.9846153846153847,1,4,65,0
1.183802345838158e+18,14,29,2.0714285714285716,1,4,14,0
1.183814154869504e+18,3,23,7.666666666666667,5,9,1,2
1.183821851837154e+18,6,42,7.0,6,8,5,1
1.183824112639535e+18,17,119,7.0,5,9,12,5
1.1838496192698317e+18,37,349,9.432432432432432,2,11,2,35
1.1838665684490706e+18,13,109,8.384615384615385,5,10,2,11
1.1838670217532718e+18,1,6,6.0,6,6,1,0
1.1838967081668805e+18,20,102,5.1,2,7,20,0
1.1839020084153764e+18,34,164,4.823529411764706,2,7,34,0
1.1839439314001267e+18,8,77,9.625,8,11,0,8
1.1839475230321027e+18,4,9,2.25,1,3,4,0
1.1839828074890913e+18,4,37,9.25,9,10,0,4
1.1839921400455693e+18,1,9,9.0,9,9,0,1
1.183997047719844e+18,9,49,5.444444444444445,4,6,9,0
1.1840006045647762e+18,3,7,2.3333333333333335,2,3,3,0
1.1840149562412096e+18,4,33,8.25,7,10,2,2
1.1840291989054098e+18,25,93,3.72,2,5,25,0
1.184056117563297e+18,21,191,9.095238095238095,4,11,4,17
1.1840586044985523e+18,1,2,2.0,2,2,1,0
1.184083533595076e+18,3,16,5.333333333333333,5,6,3,0
1.184178860754906e+18,4,18,4.5,3,6,4,0
1.1842313621651162e+18,4,18,4.5,3,5,4,0
1.1845173787434563e+18,20,120,6.0,3,8,17,3
1.1845262557394202e+18,1,8,8.0,8,8,0,1
1.1845624827215296e+18,4,39,9.75,8,11,0,4
1.1845630240501998e+18,4,7,1.75,1,2,4,0
1.1845741831701798e+18,1,2,2.0,2,2,1,0
1.1845809892303073e+18,33,197,5.96969696969697,5,8,32,1
1.1846517634661425e+18,2,13,6.5,6,7,2,0
1.18466508602226e+18,17,90,5.294117647058823,3,8,16,1
1.1846790866508593e+18,29,143,4.931034482758621,3,7,29,0
1.184710118224244e+18,1,2,2.0,2,2,1,0
1.184793504625829e+18,8,71,8.875,5,11,1,7
1.1848370222781437e+18,1,8,8.0,8,8,0,1
1.184856569984844e+18,6,46,7.666666666666667,6,9,3,3
1.184896437103918e+18,6,54,9.0,8,10,0,6
1.185251040188086e+18,43,303,7.046511627906977,3,9,28,15
1.1852855808806597e+18,7,52,7.428571428571429,5,10,4,3
1.1853058675142725e+18,1,2,2.0,2,2,1,0
1.185316554649078e+18,6,46,7.666666666666667,7,9,3,3
1.1853383437165734e+18,6,44,7.333333333333333,6,10,4,2
1.185376827285536e+18,10,105,10.5,8,12,0,10
1.1853882940123676e+18,12,97,8.083333333333334,6,9,3,9
1.1854637850034662e+18,3,10,3.3333333333333335,2,5,3,0
1.1854794916604022e+18,12,124,10.333333333333334,9,12,0,12
1.1855052402264878e+18,38,372,9.789473684210526,5,12,2,36
1.1855101822745761e+18,1,1,1.0,1,1,1,0
1.1856547136382177e+18,25,235,9.4,7,12,1,24
1.1857104664111153e+18,1,4,4.0,4,4,1,0
1.1857997559711068e+18,11,41,3.727272727272727,1,6,11,0
1.1859247651042004e+18,6,54,9.0,4,11,1,5
1.1859345599217119e+18,5,38,7.6,6,10,3,2
1.185938876514741e+18,4,19,4.75,3,6,4,0
1.185986936758291e+18,6,44,7.333333333333333,6,9,4,2
1.1859881524421765e+18,12,77,6.416666666666667,3,9,11,1
1.1860144091132237e+18,5,10,2.0,1,3,5,0
1.1860364988144776e+18,2,14,7.0,7,7,2,0
1.1860405617692122e+18,10,72,7.2,3,9,5,5
1.1860502369876137e+18,21,53,2.5238095238095237,1,4,21,0
1.1860564215479475e+18,30,292,9.733333333333333,2,12,2,28
1.18605801608364e+18,8,78,9.75,8,11,0,8
1.1860657787803384e+18,20,68,3.4,1,5,20,0
1.1860955243449372e+18,20,165,8.25,2,10,4,16
1.1860987743155732e+18,19,127,6.684210526315789,5,9,14,5
1.18609915309724e+18,9,64,7.111111111111111,6,9,6,3
1.1861214225106486e+18,25,104,4.16,2,6,25,0
1.186125612778433e+18,8,10,1.25,1,2,8,0
1.1861315957693988e+18,42,151,3.5952380952380953,2,6,42,0
1.186148135220065e+18,5,31,6.2,4,8,4,1
1.186150249121996e+18,4,8,2.0,1,4,4,0
1.186154512379432e+18,14,104,7.428571428571429,2,10,6,8
1.1861556300438003e+18,19,34,1.7894736842105263,1,5,19,0
1.186171863345316e+18,2,2,1.0,1,1,2,0
1.1861793038055204e+18,13,96,7.384615384615385,6,10,8,5
1.1861857657344563e+18,1,8,8.0,8,8,0,1
1.1861955303104863e+18,12,25,2.0833333333333335,1,4,12,0
1.186207868497771e+18,4,37,9.25,9,10,0,4
1.1862094623019448e+18,11,71,6.454545454545454,5,9,10,1
1.186213429333939e+18,7,17,2.4285714285714284,1,4,7,0
1.1862469921571205e+18,16,49,3.0625,2,5,16,0
1.1862623692897398e+18,12,77,6.416666666666667,5,8,9,3
1.1862760973746516e+18,4,40,10.0,9,11,0,4
1.1862785836449247e+18,4,5,1.25,1,2,4,0
1.1862972285257e+18,3,18,6.0,5,7,3,0
1.1863328327259556e+18,7,53,7.571428571428571,6,9,3,4
1.186347407107296e+18,7,34,4.857142857142857,4,6,7,0
1.1863552458028534e+18,61,605,9.918032786885245,7,13,1,60
1.186360659158212e+18,6,47,7.833333333333333,3,9,1,5
1.1863926892137695e+18,3,28,9.333333333333334,8,10,0,3
1.1864085894805202e+18,1,3,3.0,3,3,1,0
1.1866653673002744e+18,13,62,4.769230769230769,3,7,13,0
1.1866672931573852e+18,1,2,2.0,2,2,1,0
1.1867230242635922e+18,3,9,3.0,2,4,3,0
1.1867397324233833e+18,18,132,7.333333333333333,6,9,11,7
1.186760814814835e+18,1,4,4.0,4,4,1,0
1.1868175449505219e+18,1,9,9.0,9,9,0,1
1.1868188443134065e+18,32,96,3.0,1,4,32,0
1.1868240487611628e+18,11,19,1.7272727272727273,1,3,11,0
1.186830380152215e+18,3,8,2.6666666666666665,2,3,3,0
1.1868405594114867e+18,1,7,7.0,7,7,1,0
1.186845411102289e+18,2,18,9.0,9,9,0,2
1.1868583557869292e+18,1,3,3.0,3,3,1,0
1.1868636142827346e+18,1,5,5.0,5,5,1,0
1.1868924713356593e+18,27,89,3.2962962962962963,2,6,27,0
1.1869059688278848e+18,1,2,2.0,2,2,1,0
1.186913859530843e+18,8,58,7.25,4,9,4,4
1.1869221172482703e+18,2,18,9.0,8,10,0,2
1.1869295741674693e+18,5,12,2.4,1,4,5,0
1.1869347931517473e+18,3,19,6.333333333333333,5,7,3,0
1.1869922146141243e+18,5,30,6.0,4,7,5,0
1.1870232059257984e+18,49,387,7.8979591836734695,3,11,16,33
1.1870543209819333e+18,8,34,4.25,3,6,8,0
1.18711258667128e+18,11,27,2.4545454545454546,1,4,11,0
1.1872592001092434e+18,10,14,1.4,1,4,10,0
1.1873469401165875e+18,28,253,9.035714285714286,8,10,0,28
1.1874243123521408e+18,3,18,6.0,4,8,2,1
1.1874326081720932e+18,4,29,7.25,6,8,2,2
1.18743618032942e+18,3,23,7.666666666666667,7,8,1,2
1.1874381193984612e+18,14,93,6.642857142857143,5,9,10,4
1.1874547896923087e+18,6,11,1.8333333333333333,1,3,6,0
1.1874702135848755e+18,3,11,3.6666666666666665,3,4,3,0
1.1874730806016307e+18,9,22,2.4444444444444446,1,4,9,0
1.1874800102449915e+18,14,29,2.0714285714285716,1,4,14,0
1.1874949237621632e+18,4,32,8.0,7,9,2,2
1.1875088823503414e+18,3,29,9.666666666666666,9,11,0,3
1.1875130711273595e+18,15,97,6.466666666666667,3,9,12,3
1.1875241504904274e+18,7,20,2.857142857142857,1,4,7,0
1.1875362219836155e+18,21,200,9.523809523809524,5,11,2,19
1.1875506533323254e+18,3,24,8.0,7,10,2,1
1.1875515654968758e+18,1,9,9.0,9,9,0,1
1.187560300338707e+18,20,38,1.9,1,3,20,0
1.187568939148651e+18,33,72,2.1818181818181817,1,4,33,0
1.1876174442898555e+18,35,68,1.9428571428571428,1,3,35,0
1.1876222129958638e+18,1,9,9.0,9,9,0,1
1.1876589535222213e+18,8,57,7.125,6,9,6,2
1.1876696886780887e+18,3,6,2.0,1,3,3,0
1.1876793897819474e+18,10,24,2.4,1,4,10,0
1.1876862646694339e+18,3,15,5.0,4,7,3,0
1.1876922319772577e+18,10,96,9.6,8,11,0,10
1.1876978010553393e+18,14,126,9.0,8,10,0,14
1.1877003184172472e+18,2,23,11.5,11,12,0,2
1.1877043198334408e+18,1,8,8.0,8,8,0,1
1.1877150861532524e+18,2,17,8.5,8,9,0,2
1.1877277005380652e+18,3,9,3.0,2,4,3,0
1.1877297268281114e+18,13,132,10.153846153846153,9,11,0,13
1.1877390350298995e+18,1,1,1.0,1,1,1,0
1.1877532591466788e+18,10,58,5.8,5,6,10,0
1.187832824995277e+18,1,6,6.0,6,6,1,0
1.1878409796779151e+18,8,27,3.375,2,5,8,0
1.1878664336523254e+18,1,8,8.0,8,8,0,1
1.187871369434314e+18,3,7,2.3333333333333335,1,3,3,0
1.188064713066013e+18,8,68,8.5,4,10,1,7
1.1881231776865654e+18,28,131,4.678571428571429,2,6,28,0
1.188170110695631e+18,1,2,2.0,2,2,1,0
1.1881872614561393e+18,1,8,8.0,8,8,0,1
1.188192345609883e+18,4,10,2.5,2,3,4,0
1.1882074478582572e+18,1,3,3.0,3,3,1,0
1.1882079191438753e+18,15,63,4.2,2,6,15,0
1.1882093071035999e+18,5,9,1.8,1,2,5,0
1.1882111529112998e+18,40,48,1.2,1,3,40,0
1.1882128164477012e+18,2,5,2.5,2,3,2,0
1.1882157971333599e+18,10,83,8.3,5,10,2,8
1.1882237648837724e+18,3,11,3.6666666666666665,2,5,3,0
1.1882477327209231e+18,22,157,7.136363636363637,6,9,16,6
1.188257711471172e+18,1,8,8.0,8,8,0,1
1.1882794131872046e+18,1,3,3.0,3,3,1,0
1.1883190662282524e+18,1,1,1.0,1,1,1,0
1.1883320597742116e+18,51,251,4.921568627450981,2,7,51,0
1.1883485234225482e+18,14,146,10.428571428571429,9,12,0,14
1.1883583880473981e+18,40,277,6.925,5,10,31,9
1.1883640659013258e+18,7,27,3.857142857142857,3,5,7,0
1.1883691824208143e+18,5,8,1.6,1,2,5,0
1.188394917947936e+18,8,18,2.25,1,4,8,0
1.188401574007512e+18,8,13,1.625,1,3,8,0
1.188412227396042e+18,14,26,1.8571428571428572,1,4,14,0
1.1884502645503555e+18,3,21,7.0,6,8,2,1
1.1884726921254546e+18,6,22,3.6666666666666665,3,6,6,0
1.1884793485126915e+18,1,4,4.0,4,4,1,0
1.1884801452299476e+18,21,181,8.619047619047619,6,11,2,19
1.1885915597179523e+18,32,241,7.53125,2,10,12,20
1.18863447077757e+18,22,175,7.954545454545454,5,9,6,16
1.188636411417905e+18,12,115,9.583333333333334,3,11,1,11
1.1887963474937042e+18,1,1,1.0,1,1,1,0
1.1888541435954243e+18,3,29,9.666666666666666,8,11,0,3
1.188891405109944e+18,19,54,2.8421052631578947,1,5,19,0
1.188896401825238e+18,58,442,7.620689655172414,2,10,24,34
1.1889036963688174e+18,1,9,9.0,9,9,0,1
1.1889295734834742e+18,31,160,5.161290322580645,3,7,31,0
1.1889301789943747e+18,2,18,9.0,9,9,0,2
1.1889565392304543e+18,7,50,7.142857142857143,5,9,4,3
1.1889584508607273e+18,11,20,1.8181818181818181,1,4,11,0
1.1889923563166188e+18,35,240,6.857142857142857,4,9,23,12
1.188997336661169e+18,1,9,9.0,9,9,0,1
1.189001513537573e+18,18,33,1.8333333333333333,1,4,18,0
1.1890069297487368e+18,1,8,8.0,8,8,0,1
1.1890155691058678e+18,1,2,2.0,2,2,1,0
1.1890181551903852e+18,4,7,1.75,1,2,4,0
1.1890204248725594e+18,9,60,6.666666666666667,5,9,7,2
1.1890345413019597e+18,4,38,9.5,7,11,1,3
1.1890483001016276e+18,8,14,1.75,1,3,8,0
1.1890486097261827e+18,3,10,3.3333333333333335,3,4,3,0
1.189056665020987e+18,26,57,2.1923076923076925,1,4,26,0
1.189062454628937e+18,23,38,1.6521739130434783,1,3,23,0
1.1890693481753252e+18,25,114,4.56,3,7,25,0
1.1890811207561595e+18,61,466,7.639344262295082,2,10,19,42
1.1890928226477645e+18,26,136,5.230769230769231,4,8,25,1
1.1891086413133647e+18,4,32,8.0,7,9,1,3
1.1891158612351078e+18,24,119,4.958333333333333,2,7,24,0
1.1891181717170532e+18,5,15,3.0,1,4,5,0
1.1891264013576338e+18,8,53,6.625,3,9,5,3
1.189132936837098e+18,1,2,2.0,2,2,1,0
1.1891459066699766e+18,9,25,2.7777777777777777,2,4,9,0
1.1891535661175885e+18,19,38,2.0,1,3,19,0
1.1891851798376276e+18,5,15,3.0,1,5,5,0
1.189185380832222e+18,6,18,3.0,3,3,6,0
1.1891855967425656e+18,17,36,2.1176470588235294,1,4,17,0
1.1891857759639483e+18,6,10,1.6666666666666667,1,3,6,0
1.1891860601386056e+18,9,29,3.2222222222222223,2,5,9,0
1.1892679806008973e+18,30,144,4.8,3,7,30,0
1.1892721891205402e+18,3,5,1.6666666666666667,1,2,3,0
1.189279970018462e+18,6,49,8.166666666666666,7,9,1,5
1.1895970565759278e+18,1,7,7.0,7,7,1,0
1.1896183619109496e+18,2,13,6.5,6,7,2,0
1.1896846450388116e+18,5,37,7.4,6,9,3,2
1.189691252427177e+18,21,207,9.857142857142858,5,12,1,20
1.189706176798155e+18,2,5,2.5,2,3,2,0
1.1897111352073825e+18,5,39,7.8,7,8,1,4
1.1897297605593372e+18,1,6,6.0,6,6,1,0
1.189769815631882e+18,3,29,9.666666666666666,9,10,0,3
1.1897916887453947e+18,3,24,8.0,7,9,1,2
1.1898055469567944e+18,1,4,4.0,4,4,1,0
1.1898130948390418e+18,14,113,8.071428571428571,4,10,3,11
1.1898257235431352e+18,4,8,2.0,1,4,4,0
1.189837573878202e+18,2,10,5.0,5,5,2,0
1.1898451689020518e+18,4,32,8.0,4,10,1,3
1.1898893546917576e+18,11,112,10.181818181818182,8,12,0,11
1.189925897518533e+18,2,17,8.5,8,9,0,2
1.1899366603185902e+18,32,188,5.875,3,8,28,4
1.1899770785431718e+18,2,9,4.5,4,5,2,0
1.1902633807475016e+18,2,5,2.5,1,4,2,0
1.190318408383084e+18,13,113,8.692307692307692,7,11,1,12
1.1903508894070597e+18,4,30,7.5,7,9,3,1
1.1903679093496937e+18,19,129,6.7894736842105265,5,8,14,5
1.1903899466338476e+18,18,99,5.5,4,7,18,0
1.1904389339600824e+18,3,5,1.6666666666666667,1,2,3,0
1.1904606460397624e+18,11,79,7.181818181818182,3,10,6,5
1.190478243319474e+18,4,23,5.75,5,6,4,0
1.190532498422221e+18,3,25,8.333333333333334,6,10,1,2
1.1905357325941048e+18,49,67,1.3673469387755102,1,3,49,0
1.1905408083712082e+18,1,8,8.0,8,8,0,1
1.1905746320515796e+18,10,29,2.9,2,5,10,0
1.1905960676599437e+18,20,176,8.8,4,12,3,17
1.190625221320759e+18,45,216,4.8,3,7,45,0
1.190640864731877e+18,6,43,7.166666666666667,6,10,5,1
1.1906855365502031e+18,2,11,5.5,3,8,1,1
1.1907998192903905e+18,3,23,7.666666666666667,7,9,2,1
1.1908072685481795e+18,13,55,4.230769230769231,3,6,13,0
1.1910071660143516e+18,11,72,6.545454545454546,2,9,8,3
1.1910110613535747e+18,1,2,2.0,2,2,1,0
1.1910516227155443e+18,7,71,10.142857142857142,9,11,0,7
1.191064616586811e+18,2,7,3.5,3,4,2,0
1.1910768804412183e+18,13,26,2.0,1,4,13,0
1.1910883579519916e+18,13,31,2.3846153846153846,1,4,13,0
1.191143508181485e+18,16,34,2.125,1,5,16,0
1.1911520917885007e+18,3,31,10.333333333333334,9,11,0,3
1.1911799267634524e+18,4,10,2.5,2,3,4,0
1.1912312387591744e+18,4,28,7.0,6,8,3,1
1.191266830380412e+18,13,61,4.6923076923076925,2,7,13,0
1.1912756502535235e+18,27,54,2.0,1,4,27,0
1.1912891396543665e+18,8,42,5.25,4,7,8,0
1.191302096017881e+18,19,188,9.894736842105264,8,11,0,19
1.1913035237715151e+18,2,17,8.5,8,9,0,2
1.191315522795515e+18,1,2,2.0,2,2,1,0
1.1913187032206072e+18,2,15,7.5,7,8,1,1
1.1913415876504156e+18,9,71,7.888888888888889,6,9,2,7
1.1913449785031393e+18,14,56,4.0,1,6,14,0
1.1913618782406147e+18,8,25,3.125,1,5,8,0
1.191373180835143e+18,45,428,9.511111111111111,3,11,3,42
1.191374947118171e+18,2,15,7.5,7,8,1,1
1.191376278133035e+18,3,20,6.666666666666667,3,9,1,2
1.1913895664783754e+18,49,413,8.428571428571429,2,12,12,37
1.1914174542461765e+18,40,308,7.7,2,10,14,26
1.191426242922598e+18,6,13,2.1666666666666665,1,3,6,0
1.191435939359645e+18,6,16,2.6666666666666665,1,4,6,0
1.191473232953732e+18,10,72,7.2,6,9,7,3
1.1914961159961047e+18,1,3,3.0,3,3,1,0
1.1915244593303e+18,3,13,4.333333333333333,3,6,3,0
1.191524636167302e+18,7,33,4.714285714285714,2,6,7,0
1.1915248422375916e+18,5,28,5.6,4,7,5,0
1.1915251069955868e+18,4,19,4.75,4,5,4,0
1.1915253452572616e+18,3,16,5.333333333333333,4,7,3,0
1.1915254671568622e+18,1,7,7.0,7,7,1,0
1.1915256407447916e+18,2,8,4.0,4,4,2,0
1.1915259150870377e+18,1,5,5.0,5,5,1,0
1.1915261531531034e+18,2,9,4.5,4,5,2,0
1.1915264244457377e+18,3,15,5.0,4,6,3,0
1.1915265561293847e+18,5,24,4.8,4,6,5,0
1.1915267899645622e+18,4,19,4.75,3,6,4,0
1.1915269672895808e+18,2,12,6.0,6,6,2,0
1.191527173323733e+18,3,13,4.333333333333333,3,5,3,0
1.1915273848776463e+18,8,35,4.375,2,6,8,0
1.1917253617114926e+18,21,47,2.238095238095238,1,4,21,0
1.1917600418898337e+18,5,19,3.8,3,5,5,0
1.191788523029336e+18,3,25,8.333333333333334,8,9,0,3
1.19181886320642e+18,14,50,3.5714285714285716,2,6,14,0
1.191827135337576e+18,14,51,3.642857142857143,1,5,14,0
1.1918380757263114e+18,22,68,3.090909090909091,1,5,22,0
1.1918429988291082e+18,1,3,3.0,3,3,1,0
1.1918513519174848e+18,10,85,8.5,8,9,0,10
1.1918559853993838e+18,22,94,4.2727272727272725,2,8,21,1
1.19185761163984e+18,1,4,4.0,4,4,1,0
1.1918596064512812e+18,4,7,1.75,1,2,4,0
1.191882456004486e+18,3,26,8.666666666666666,8,9,0,3
1.1919197201735575e+18,3,3,1.0,1,1,3,0
1.1919289114501612e+18,3,27,9.0,8,10,0,3
1.1919603187782518e+18,1,4,4.0,4,4,1,0
1.1919681401937441e+18,2,8,4.0,2,6,2,0
1.1919700868133573e+18,6,38,6.333333333333333,5,7,6,0
1.1919728646985782e+18,3,24,8.0,7,9,1,2
1.1919802246855442e+18,6,13,2.1666666666666665,1,3,6,0
1.1919813800136458e+18,13,20,1.5384615384615385,1,2,13,0
1.1919833065083932e+18,5,15,3.0,2,4,5,0
1.1919925586672978e+18,85,663,7.8,2,10,30,55
1.192007835815074e+18,18,166,9.222222222222221,8,11,0,18
1.1920427579241997e+18,3,15,5.0,4,6,3,0
1.192043112463784e+18,8,85,10.625,9,12,0,8
1.1920458213409487e+18,2,5,2.5,2,3,2,0
1.1920772369765804e+18,29,144,4.9655172413793105,3,7,29,0
1.1920822052273106e+18,23,118,5.130434782608695,3,7,23,0
1.192135005235079e+18,5,17,3.4,2,5,5,0
1.1924542191805448e+18,2,8,4.0,4,4,2,0
1.192501287916275e+18,1,3,3.0,3,3,1,0
1.1925240843856694e+18,18,91,5.055555555555555,4,7,18,0
1.192538910195128e+18,1,7,7.0,7,7,1,0
1.192563625407792e+18,2,16,8.0,8,8,0,2
1.192565439742498e+18,1,8,8.0,8,8,0,1
1.192575649036266e+18,1,7,7.0,7,7,1,0
1.1925952390224512e+18,76,150,1.9736842105263157,1,4,76,0
1.1926087730756925e+18,12,87,7.25,6,9,8,4
1.1926110529731745e+18,14,125,8.928571428571429,8,10,0,14
1.1926249212792353e+18,19,39,2.0526315789473686,1,3,19,0
1.192626282805715e+18,3,19,6.333333333333333,6,7,3,0
1.1926271917698624e+18,23,53,2.3043478260869565,1,3,23,0
1.192629511920187e+18,33,169,5.121212121212121,4,7,33,0
1.192647491561862e+18,28,136,4.857142857142857,3,7,28,0
1.192651316954887e+18,1,2,2.0,2,2,1,0
1.192673391936496e+18,2,5,2.5,2,3,2,0
1.19268149212881e+18,4,24,6.0,5,7,4,0
1.192688518562439e+18,1,2,2.0,2,2,1,0
1.1926992152717043e+18,16,84,5.25,4,7,16,0
1.1927001772598134e+18,3,6,2.0,2,2,3,0
1.192713347826639e+18,10,84,8.4,2,10,1,9
1.1927140091257697e+18,5,13,2.6,1,4,5,0
1.1927233965881544e+18,4,29,7.25,6,8,2,2
1.1927314243660705e+18,4,24,6.0,2,8,3,1
1.1927458306600346e+18,7,50,7.142857142857143,5,9,4,3
1.192754514143204e+18,32,89,2.78125,1,5,32,0
1.1928083222191954e+18,3,24,8.0,5,10,1,2
1.1928337064320763e+18,8,31,3.875,2,6,8,0
1.1928643142878833e+18,26,243,9.346153846153847,2,13,3,23
1.1929407345903974e+18,30,201,6.7,4,8,23,7
1.1929423861813821e+18,48,277,5.770833333333333,2,8,46,2
1.192985133476222e+18,14,89,6.357142857142857,5,8,12,2
1.1931938410930934e+18,8,29,3.625,2,5,8,0
1.1932236837981396e+18,3,9,3.0,2,4,3,0
1.1932238386926845e+18,11,22,2.0,1,3,11,0
1.193229953718467e+18,62,569,9.17741935483871,2,12,6,56
1.1932864027215706e+18,11,110,10.0,9,12,0,11
1.1933076146463805e+18,36,110,3.0555555555555554,1,5,36,0
1.1933209438526513e+18,49,105,2.142857142857143,1,4,49,0
1.1933257341354094e+18,6,65,10.833333333333334,10,12,0,6
1.1933570294231708e+18,2,7,3.5,3,4,2,0
1.1933879415825196e+18,18,160,8.88888888888889,8,10,0,18
1.193399390608559e+18,3,7,2.3333333333333335,2,3,3,0
1.1934282020199516e+18,3,29,9.666666666666666,9,10,0,3
1.193448021513483e+18,26,166,6.384615384615385,3,9,20,6
1.1934693879192105e+18,2,13,6.5,6,7,2,0
1.1934859768059323e+18,1,3,3.0,3,3,1,0
1.1934900232067512e+18,2,18,9.0,8,10,0,2
1.1934908017980874e+18,1,3,3.0,3,3,1,0
1.1935095280886193e+18,17,34,2.0,1,4,17,0
1.1935717785035162e+18,4,23,5.75,5,7,4,0
1.1935752378533407e+18,39,343,8.794871794871796,2,12,5,34
1.1935820604107062e+18,9,51,5.666666666666667,4,7,9,0
1.1935835022192115e+18,3,19,6.333333333333333,5,8,2,1
1.1936616804265167e+18,21,208,9.904761904761905,8,13,0,21
1.1936916806487168e+18,2,4,2.0,1,3,2,0
1.1938458803301407e+18,1,8,8.0,8,8,0,1
1.1939007238516006e+18,44,210,4.7727272727272725,2,7,44,0
1.1939375288969605e+18,30,123,4.1,2,6,30,0
1.1939546212973832e+18,54,512,9.481481481481481,2,12,5,49
1.1939728483073213e+18,4,20,5.0,4,6,4,0
1.1939865023786045e+18,4,4,1.0,1,1,4,0
1.193998070801552e+18,1,5,5.0,5,5,1,0
1.1940008596547935e+18,4,32,8.0,7,10,2,2
1.194003821516707e+18,4,18,4.5,4,5,4,0
1.1940124058362906e+18,3,25,8.333333333333334,8,9,0,3
1.1940161214841137e+18,14,52,3.7142857142857144,2,5,14,0
1.1940177281396447e+18,9,62,6.888888888888889,6,8,7,2
1.194023187195561e+18,3,7,2.3333333333333335,2,3,3,0
1.1940483257112573e+18,19,41,2.1578947368421053,1,4,19,0
1.1940503534795418e+18,2,15,7.5,6,9,1,1
1.1940521040144246e+18,1,3,3.0,3,3,1,0
1.1940601996269197e+18,3,30,10.0,10,10,0,3
1.194072870251081e+18,23,88,3.8260869565217392,2,6,23,0
1.1941030024531633e+18,47,467,9.936170212765957,6,13,2,45
1.1941049750713935e+18,1,1,1.0,1,1,1,0
1.194148705428921e+18,19,129,6.7894736842105265,5,9,15,4
1.194186227153968e+18,39,261,6.6923076923076925,4,10,31,8
1.1941896786667005e+18,5,17,3.4,2,4,5,0
1.1941937199195274e+18,3,20,6.666666666666667,6,7,3,0
1.1942132899636795e+18,13,74,5.6923076923076925,4,7,13,0
1.1942347918236723e+18,9,18,2.0,1,4,9,0
1.1942743548498296e+18,24,225,9.375,3,12,2,22
1.1942944837071642e+18,19,117,6.157894736842105,4,8,16,3
1.1943030458969866e+18,17,98,5.764705882352941,4,7,17,0
1.194316967533803e+18,1,8,8.0,8,8,0,1
1.1943198948886623e+18,12,67,5.583333333333333,5,7,12,0
1.1943435139754765e+18,4,32,8.0,7,10,2,2
1.19461138560077e+18,15,115,7.666666666666667,6,10,7,8
1.1946381974320717e+18,1,2,2.0,2,2,1,0
1.1946796729564137e+18,2,4,2.0,1,3,2,0
1.1947110426580547e+18,46,446,9.695652173913043,5,13,2,44
1.1947225578656248e+18,8,58,7.25,5,10,6,2
1.1947324161132086e+18,21,124,5.904761904761905,2,8,20,1
1.1947482862954248e+18,7,44,6.285714285714286,4,7,7,0
1.194792570635022e+18,18,89,4.944444444444445,4,6,18,0
1.1948593045967532e+18,10,23,2.3,1,3,10,0
1.1949010241656748e+18,1,4,4.0,4,4,1,0
1.19490743685233e+18,6,60,10.0,8,12,0,6
1.194954716700282e+18,5,28,5.6,3,7,5,0
1.194999704823314e+18,1,8,8.0,8,8,0,1
1.1950173148141919e+18,9,72,8.0,4,10,2,7
1.1950354610411348e+18,37,76,2.054054054054054,1,4,37,0
1.195036880637911e+18,1,8,8.0,8,8,0,1
1.1950529015510538e+18,35,172,4.914285714285715,3,7,35,0
1.1950619960578368e+18,9,69,7.666666666666667,6,10,6,3
1.195085591793422e+18,3,8,2.6666666666666665,2,3,3,0
1.1951876442654917e+18,3,9,3.0,1,5,3,0
1.1953280395587638e+18,1,10,10.0,10,10,0,1
1.195391545546741e+18,45,451,10.022222222222222,2,13,1,44
1.1954193909925773e+18,28,159,5.678571428571429,2,8,27,1
1.1954398536360369e+18,36,178,4.944444444444445,3,6,36,0
1.1954611997531745e+18,26,191,7.346153846153846,6,9,16,10
1.1954996379678687e+18,13,130,10.0,8,12,0,13
1.195515137101875e+18,2,17,8.5,8,9,0,2
1.195526537182779e+18,8,27,3.375,2,5,8,0
1.195592643767977e+18,4,8,2.0,1,3,4,0
1.19561762558349e+18,39,371,9.512820512820513,2,12,3,36
1.195625451890053e+18,4,40,10.0,9,11,0,4
1.195690945454219e+18,1,10,10.0,10,10,0,1
1.1956961698279084e+18,27,258,9.555555555555555,3,12,3,24
1.195700287307396e+18,1,2,2.0,2,2,1,0
1.1957223188059523e+18,3,23,7.666666666666667,7,8,1,2
1.1957253657125297e+18,4,6,1.5,1,2,4,0
1.1957418327986952e+18,26,136,5.230769230769231,3,8,24,2
1.1957637114792694e+18,1,2,2.0,2,2,1,0
1.1957870500569585e+18,8,30,3.75,2,5,8,0
1.1958720408721393e+18,4,8,2.0,1,3,4,0
1.1959294909265661e+18,20,193,9.65,6,12,1,19
1.1960405498754348e+18,2,14,7.0,7,7,2,0
1.196107520164763e+18,4,32,8.0,7,9,1,3
1.1961234001954276e+18,2,6,3.0,3,3,2,0
1.1961244223947983e+18,1,7,7.0,7,7,1,0
1.1961315752604513e+18,16,31,1.9375,1,3,16,0
1.1961510764527593e+18,8,19,2.375,1,4,8,0
1.1961775019675581e+18,15,104,6.933333333333334,5,9,11,4
1.1961812221471598e+18,19,129,6.7894736842105265,3,9,17,2
1.196190232406155e+18,24,61,2.5416666666666665,1,4,24,0
1.196223868841179e+18,3,8,2.6666666666666665,1,4,3,0
1.1962407934553646e+18,25,232,9.28,8,11,0,25
1.1962439590840796e+18,5,10,2.0,1,3,5,0
1.1962454801094508e+18,1,2,2.0,2,2,1,0
1.1962619029132524e+18,7,15,2.142857142857143,1,4,7,0
1.1962738886994442e+18,12,21,1.75,1,3,12,0
1.1962752572987313e+18,16,148,9.25,3,13,2,14
1.1963171370033236e+18,1,8,8.0,8,8,0,1
1.196328225811399e+18,13,87,6.6923076923076925,2,10,10,3
1.196330400379863e+18,31,162,5.225806451612903,4,7,31,0
1.1963522510507167e+18,4,33,8.25,7,10,1,3
1.1963671026838817e+18,4,27,6.75,6,7,4,0
1.1963724887854958e+18,3,23,7.666666666666667,7,9,2,1
1.1963747012485924e+18,10,33,3.3,1,4,10,0
1.1963907775435034e+18,25,181,7.24,2,10,12,13
1.196405201982421e+18,31,149,4.806451612903226,2,6,31,0
1.1964053827349576e+18,48,464,9.666666666666666,2,12,4,44
1.196452761134309e+18,8,59,7.375,5,9,4,4
1.196463616199981e+18,14,141,10.071428571428571,7,12,1,13
1.1964890126618586e+18,25,229,9.16,3,11,3,22
1.196505279482991e+18,53,512,9.660377358490566,2,12,3,50
1.1965087075606397e+18,2,17,8.5,8,9,0,2
1.1965288323327043e+18,14,135,9.642857142857142,3,12,1,13
1.196535116647181e+18,22,102,4.636363636363637,2,7,22,0
1.1967631026116582e+18,7,47,6.714285714285714,2,9,4,3
1.1968165400484877e+18,1,2,2.0,2,2,1,0
1.196834628209417e+18,49,466,9.510204081632653,4,12,3,46
1.196838151584907e+18,28,188,6.714285714285714,3,9,20,8
1.196845675564666e+18,6,21,3.5,2,5,6,0
1.1968492838068375e+18,22,152,6.909090909090909,5,9,14,8
1.1968503656439613e+18,14,91,6.5,2,8,9,5
1.196869241426901e+18,18,35,1.9444444444444444,1,4,18,0
1.1968894216994924e+18,3,6,2.0,1,3,3,0
1.1968979463554652e+18,22,113,5.136363636363637,3,8,20,2
1.1969018052650458e+18,3,23,7.666666666666667,7,8,1,2
1.1969217415817485e+18,12,77,6.416666666666667,4,8,9,3
1.1969285959382395e+18,18,88,4.888888888888889,3,7,18,0
1.1969439048930417e+18,3,8,2.6666666666666665,2,3,3,0
1.1969649872487342e+18,4,26,6.5,5,8,3,1
1.1969798761147323e+18,16,30,1.875,1,3,16,0
1.196982903125252e+18,1,10,10.0,10,10,0,1
1.196996136734369e+18,18,57,3.1666666666666665,1,5,18,0
1.197006737744824e+18,15,22,1.4666666666666666,1,2,15,0
1.1970186558012506e+18,46,453,9.847826086956522,4,12,2,44
1.1970308279545618e+18,4,33,8.25,3,11,1,3
1.1970375472500774e+18,39,391,10.025641025641026,4,12,1,38
1.1970443808012326e+18,2,3,1.5,1,2,2,0
1.197070032968317e+18,6,50,8.333333333333334,7,10,1,5
1.1970934032816696e+18,3,4,1.3333333333333333,1,2,3,0
1.197108203580135e+18,22,196,8.909090909090908,2,11,4,18
1.1971202249728433e+18,2,10,5.0,4,6,2,0
1.1971814639231127e+18,4,12,3.0,2,4,4,0
1.1972218573990595e+18,1,8,8.0,8,8,0,1
1.197312765352231e+18,5,50,10.0,7,12,1,4
1.1974791249647014e+18,43,370,8.604651162790697,2,11,4,39
1.1975555309535007e+18,16,30,1.875,1,3,16,0
1.1975700125150787e+18,2,13,6.5,5,8,1,1
1.1975741101413453e+18,32,215,6.71875,4,9,25,7
1.1975744368859272e+18,43,219,5.093023255813954,3,7,43,0
1.1975817527834394e+18,19,147,7.7368421052631575,6,10,8,11
1.1976063925068224e+18,1,7,7.0,7,7,1,0
1.197611970982318e+18,4,14,3.5,2,4,4,0
1.197616635131069e+18,1,4,4.0,4,4,1,0
1.1976268928154115e+18,11,20,1.8181818181818181,1,4,11,0
1.1976284126706186e+18,2,9,4.5,4,5,2,0
1.1976419968027392e+18,3,27,9.0,8,10,0,3
1.1976645359557898e+18,1,1,1.0,1,1,1,0
1.1977015081322606e+18,6,59,9.833333333333334,8,11,0,6
1.1977389712491753e+18,3,5,1.6666666666666667,1,3,3,0
1.1977529468913341e+18,4,5,1.25,1,2,4,0
1.1977590811907917e+18,3,6,2.0,1,3,3,0
1.197763319429872e+18,1,3,3.0,3,3,1,0
1.1977718609153303e+18,1,1,1.0,1,1,1,0
1.197777608465031e+18,3,5,1.6666666666666667,1,2,3,0
1.1977822471726257e+18,7,13,1.8571428571428572,1,3,7,0
1.197783359765134e+18,3,20,6.666666666666667,6,7,3,0
1.1977860193145272e+18,1,1,1.0,1,1,1,0
1.1977902260706903e+18,3,32,10.666666666666666,10,12,0,3
1.1977943028781837e+18,2,4,2.0,2,2,2,0
1.1978033927200707e+18,2,6,3.0,2,4,2,0
1.197809439756139e+18,1,1,1.0,1,1,1,0
1.1978147047287698e+18,3,4,1.3333333333333333,1,2,3,0
1.1978550823370916e+18,23,69,3.0,1,5,23,0
1.19787190623375e+18,66,387,5.863636363636363,2,9,62,4
1.1979060593632335e+18,1,1,1.0,1,1,1,0
1.1979719268544228e+18,4,13,3.25,2,4,4,0
1.1979737258752197e+18,5,9,1.8,1,3,5,0
1.1980738171386504e+18,24,220,9.166666666666666,5,12,2,22
1.1980938210813033e+18,2,3,1.5,1,2,2,0
1.1982819680984404e+18,15,82,5.466666666666667,4,7,15,0
1.1983014886998144e+18,2,15,7.5,6,9,1,1
1.1983086429884045e+18,17,28,1.6470588235294117,1,3,17,0
1.1983151957167096e+18,10,98,9.8,9,11,0,10
1.1983277878965627e+18,2,14,7.0,7,7,2,0
1.1983353348925048e+18,8,51,6.375,3,8,7,1
1.1983432727558185e+18,17,50,2.9411764705882355,1,5,17,0
1.198387456962587e+18,3,19,6.333333333333333,5,7,3,0
1.1983893768495516e+18,5,31,6.2,5,7,5,0
1.1983895779488392e+18,4,36,9.0,7,10,1,3
1.1983986744053156e+18,1,1,1.0,1,1,1,0
1.1984057893189128e+18,2,3,1.5,1,2,2,0
1.1984092929218478e+18,1,1,1.0,1,1,1,0
1.1984119464950776e+18,1,4,4.0,4,4,1,0
1.1984229885475832e+18,5,50,10.0,4,12,1,4
1.1984260364630674e+18,8,42,5.25,4,7,8,0
1.19842726089209e+18,1,10,10.0,10,10,0,1
1.1984369202119939e+18,4,24,6.0,2,9,3,1
1.1984441688157445e+18,9,63,7.0,5,9,6,3
1.1984568929687954e+18,7,45,6.428571428571429,5,8,6,1
1.198461322238869e+18,31,211,6.806451612903226,2,9,23,8
1.198464460433027e+18,24,57,2.375,1,5,24,0
1.1984823919969016e+18,35,330,9.428571428571429,2,12,3,32
1.1984869706130179e+18,30,264,8.8,4,11,3,27
1.1984998989000676e+18,10,75,7.5,5,9,4,6
1.198505733199368e+18,19,23,1.2105263157894737,1,3,19,0
1.1985505227373489e+18,41,287,7.0,5,10,29,12
1.198577167245029e+18,4,37,9.25,9,10,0,4
1.1986243724408484e+18,16,141,8.8125,5,10,2,14
1.1986817942980188e+18,50,240,4.8,2,7,50,0
1.1986881617855534e+18,52,504,9.692307692307692,3,12,4,48
1.19883782360736e+18,3,4,1.3333333333333333,1,2,3,0
1.1988807908397494e+18,3,6,2.0,2,2,3,0
1.198951254585042e+18,3,9,3.0,2,4,3,0
1.1990187642645847e+18,30,70,2.3333333333333335,1,5,30,0
1.1990218300191032e+18,9,18,2.0,1,4,9,0
1.1990465339825608e+18,18,40,2.2222222222222223,1,3,18,0
1.1990477357116268e+18,30,207,6.9,2,9,18,12
1.1990617338951956e+18,8,62,7.75,4,10,2,6
1.1990750785072573e+18,3,8,2.6666666666666665,2,4,3,0
1.199075564505437e+18,24,171,7.125,6,9,17,7
1.1990799984013496e+18,10,100,10.0,8,11,0,10
1.1990805871791247e+18,23,44,1.9130434782608696,1,4,23,0
1.199096752071267e+18,5,10,2.0,1,3,5,0
1.1991017631597396e+18,55,73,1.3272727272727274,1,3,55,0
1.1991274006614858e+18,20,122,6.1,4,8,17,3
1.1991302964660375e+18,2,17,8.5,8,9,0,2
1.1991525523461427e+18,2,12,6.0,5,7,2,0
1.1991621334118707e+18,1,6,6.0,6,6,1,0
1.1991691756971397e+18,8,24,3.0,2,4,8,0
1.199172976167261e+18,7,34,4.857142857142857,3,6,7,0
1.1991744591395694e+18,17,99,5.823529411764706,2,7,17,0
1.1992250801949827e+18,1,1,1.0,1,1,1,0
1.199264071815863e+18,13,17,1.3076923076923077,1,2,13,0
1.1992663630526006e+18,1,7,7.0,7,7,1,0
1.19927997068288e+18,10,75,7.5,4,9,5,5
1.1993247747301197e+18,10,19,1.9,1,2,10,0
1.1993357747952013e+18,7,11,1.5714285714285714,1,2,7,0
1.1993474008366756e+18,1,3,3.0,3,3,1,0
1.1994394897443372e+18,10,69,6.9,2,9,6,4
1.1994546155582044e+18,2,7,3.5,3,4,2,0
1.1997551264597115e+18,2,6,3.0,3,3,2,0
1.1997553565869476e+18,8,56,7.0,4,10,4,4
1.1997691338657485e+18,18,142,7.888888888888889,2,11,6,12
1.1998500915698716e+18,7,11,1.5714285714285714,1,2,7,0
1.19985404784561e+18,40,288,7.2,3,11,22,18
1.199870697676017e+18,12,25,2.0833333333333335,1,3,12,0
1.1998836972700836e+18,1,3,3.0,3,3,1,0
1.1999913304901752e+18,4,7,1.75,1,3,4,0
1.200140190765833e+18,25,70,2.8,1,5,25,0
1.200342104845481e+18,5,34,6.8,5,9,3,2
1.2004158858681487e+18,1,6,6.0,6,6,1,0
1.2005257533399017e+18,51,479,9.392156862745098,4,12,3,48
1.2005856315041495e+18,9,47,5.222222222222222,4,7,9,0
1.2005913649636805e+18,1,8,8.0,8,8,0,1
1.2006479496015322e+18,6,37,6.166666666666667,5,7,6,0
1.2006581403203397e+18,18,24,1.3333333333333333,1,3,18,0
1.2006751576120932e+18,26,128,4.923076923076923,2,7,26,0
1.2007195553087427e+18,21,58,2.761904761904762,1,4,21,0
1.2007222694650537e+18,2,14,7.0,5,9,1,1
1.2007558698557345e+18,1,7,7.0,7,7,1,0
1.2007678866258962e+18,25,124,4.96,2,7,25,0
1.200786423292403e+18,19,96,5.052631578947368,3,7,19,0
1.2008174574459476e+18,3,5,1.6666666666666667,1,2,3,0
1.2008469108348447e+18,19,42,2.210526315789474,1,4,19,0
1.200886399729008e+18,12,95,7.916666666666667,6,9,3,9
1.2010657691536993e+18,4,30,7.5,6,9,2,2
1.2011091559359752e+18,30,153,5.1,4,8,29,1
1.2011812355527045e+18,1,9,9.0,9,9,0,1
1.20119733871122e+18,2,4,2.0,1,3,2,0
1.2012173324202163e+18,10,69,6.9,5,8,8,2
1.201220813139761e+18,3,16,5.333333333333333,5,6,3,0
1.2012445236706967e+18,17,155,9.117647058823529,7,12,1,16
1.2012682017907297e+18,6,47,7.833333333333333,6,9,2,4
1.2012820407834893e+18,21,103,4.904761904761905,3,7,21,0
1.2012908804570084e+18,5,19,3.8,3,5,5,0
1.2012921185812544e+18,14,93,6.642857142857143,4,9,11,3
1.201299693647594e+18,11,78,7.090909090909091,6,8,7,4
1.2013087668531116e+18,13,24,1.8461538461538463,1,3,13,0
1.2013110975571978e+18,56,548,9.785714285714286,7,12,2,54
1.2013516732205368e+18,29,287,9.89655172413793,3,12,1,28
1.2014229175300063e+18,2,19,9.5,9,10,0,2
1.2014336684415867e+18,1,2,2.0,2,2,1,0
1.2014340417030902e+18,13,87,6.6923076923076925,5,8,11,2
1.2014380616430034e+18,11,51,4.636363636363637,3,6,11,0
1.2014411852216297e+18,12,122,10.166666666666666,9,11,0,12
1.2014461104254794e+18,1,4,4.0,4,4,1,0
1.201449248718084e+18,2,5,2.5,2,3,2,0
1.2014524895456125e+18,3,6,2.0,1,3,3,0
1.2014781711891717e+18,28,114,4.071428571428571,3,6,28,0
1.2015072609999772e+18,4,29,7.25,7,8,3,1
1.201541793672229e+18,49,239,4.877551020408164,3,7,49,0
1.2015418462504658e+18,19,91,4.7894736842105265,3,6,19,0
1.201558935754587e+18,1,7,7.0,7,7,1,0
1.2015817351798625e+18,1,2,2.0,2,2,1,0
1.2015829106876278e+18,4,32,8.0,7,9,1,3
1.2016143578534735e+18,43,188,4.372093023255814,2,7,43,0
1.2016624427198725e+18,6,42,7.0,3,9,2,4
1.2016952967143035e+18,22,149,6.7727272727272725,5,8,18,4
1.2017728113668242e+18,4,27,6.75,6,8,3,1
1.2017841236856684e+18,9,72,8.0,6,10,2,7
1.201876645020749e+18,1,3,3.0,3,3,1,0
1.2018894945286333e+18,2,5,2.5,2,3,2,0
1.2019533157655908e+18,14,95,6.785714285714286,5,8,11,3
1.2019609853965788e+18,4,31,7.75,7,9,2,2
1.2019631875158676e+18,20,93,4.65,2,7,20,0
1.2019714050874022e+18,3,8,2.6666666666666665,2,3,3,0
1.202045958827527e+18,4,30,7.5,6,9,2,2
1.2020847091419359e+18,5,14,2.8,2,3,5,0
1.2020996737287647e+18,1,1,1.0,1,1,1,0
1.2021189810571791e+18,2,3,1.5,1,2,2,0
1.2021198204707753e+18,3,20,6.666666666666667,6,7,3,0
1.2021232160290452e+18,17,118,6.9411764705882355,6,8,13,4
1.2021392609381343e+18,1,1,1.0,1,1,1,0
1.2021448086878413e+18,1,5,5.0,5,5,1,0
1.2021509842264893e+18,1,10,10.0,10,10,0,1
1.2021649517440927e+18,1,2,2.0,2,2,1,0
1.2021758686495247e+18,3,6,2.0,2,2,3,0
1.2021777509495552e+18,1,2,2.0,2,2,1,0
1.202202195012153e+18,1,8,8.0,8,8,0,1
1.2022777406687972e+18,18,163,9.055555555555555,4,11,1,17
1.2022998616105915e+18,9,40,4.444444444444445,3,6,9,0
1.2023207600810294e+18,1,9,9.0,9,9,0,1
1.2023526815928522e+18,4,36,9.0,8,10,0,4
1.2026699431225206e+18,17,74,4.352941176470588,3,6,17,0
1.2026870963264143e+18,5,9,1.8,1,4,5,0
1.2026951696798966e+18,5,41,8.2,6,10,2,3
1.202731066662017e+18,1,6,6.0,6,6,1,0
1.2027620922591296e+18,3,20,6.666666666666667,6,7,3,0
1.2027696348210926e+18,28,79,2.8214285714285716,1,5,28,0
1.202788470873389e+18,7,62,8.857142857142858,5,11,1,6
1.2027941589116498e+18,37,103,2.7837837837837838,1,5,37,0
1.2028856066684326e+18,22,217,9.863636363636363,4,12,1,21
1.2029064044528684e+18,3,15,5.0,3,6,3,0
1.2029814795188516e+18,11,58,5.2727272727272725,3,7,11,0
1.2030472198143608e+18,1,2,2.0,2,2,1,0
1.2031053255402079e+18,69,596,8.63768115942029,5,10,9,60
1.2033393770578685e+18,7,52,7.428571428571429,4,9,2,5
1.2033685343660355e+18,1,1,1.0,1,1,1,0
1.2033689923987039e+18,2,16,8.0,8,8,0,2
1.2033764420665188e+18,3,24,8.0,7,9,1,2
1.2033834117145807e+18,4,9,2.25,1,4,4,0
1.2033860185442867e+18,11,56,5.090909090909091,3,7,11,0
1.2033877242181046e+18,3,22,7.333333333333333,6,10,2,1
1.2034171020145083e+18,3,11,3.6666666666666665,3,4,3,0
1.203421957848995e+18,6,44,7.333333333333333,6,8,3,3
1.2034394427303665e+18,6,41,6.833333333333333,6,8,5,1
1.2034625159740116e+18,23,91,3.9565217391304346,2,5,23,0
1.2034731186668867e+18,4,17,4.25,3,6,4,0
1.2034752388913974e+18,6,42,7.0,4,9,4,2
1.2034853255386478e+18,22,97,4.409090909090909,2,7,22,0
1.2035073451309486e+18,8,50,6.25,3,8,5,3
1.2035097209749517e+18,17,160,9.411764705882353,3,11,1,16
1.2035102044765507e+18,5,39,7.8,7,9,2,3
1.203524361829332e+18,12,33,2.75,1,4,12,0
1.2035552405052808e+18,4,31,7.75,7,8,1,3
1.2035571441825352e+18,12,35,2.9166666666666665,1,5,12,0
1.2036013619979302e+18,24,163,6.791666666666667,5,9,18,6
1.2036082346161219e+18,3,22,7.333333333333333,6,9,2,1
1.203627560019111e+18,1,9,9.0,9,9,0,1
1.2036449336645343e+18,1,7,7.0,7,7,1,0
1.2036642815969108e+18,12,78,6.5,4,8,11,1
1.2036672239461473e+18,47,452,9.617021276595745,3,12,3,44
1.2037030357375014e+18,7,70,10.0,9,12,0,7
1.2037078544125194e+18,6,60,10.0,9,11,0,6
1.2038273980272202e+18,54,120,2.2222222222222223,1,4,54,0
1.2040548063147607e+18,4,10,2.5,1,4,4,0
1.2040686448230577e+18,37,265,7.162162162162162,4,9,26,11
1.20407357103786e+18,5,7,1.4,1,3,5,0
1.2040970277219702e+18,1,5,5.0,5,5,1,0
1.2041155515384184e+18,39,199,5.102564102564102,3,7,39,0
1.2041273466170665e+18,40,118,2.95,1,5,40,0
1.204145701695019e+18,13,29,2.230769230769231,1,4,13,0
1.204174122209733e+18,18,91,5.055555555555555,3,7,18,0
1.2041932022825997e+18,15,107,7.133333333333334,5,9,9,6
1.204246942306863e+18,8,39,4.875,4,6,8,0
1.204247463104448e+18,6,29,4.833333333333333,4,6,6,0
1.2042484551104238e+18,4,16,4.0,3,5,4,0
1.204248965964442e+18,12,48,4.0,3,5,12,0
1.204268176437134e+18,3,15,5.0,5,5,3,0
1.2042688994255872e+18,19,92,4.842105263157895,3,6,19,0
1.2042699590312806e+18,12,45,3.75,2,6,12,0
1.204270904479785e+18,11,41,3.727272727272727,2,5,11,0
1.204272415263552e+18,6,26,4.333333333333333,2,6,6,0
1.2042737073074422e+18,5,24,4.8,4,6,5,0
1.2042745880726467e+18,9,33,3.6666666666666665,2,6,9,0
1.204275644686985e+18,8,32,4.0,3,5,8,0
1.2042846920850734e+18,21,186,8.857142857142858,7,10,2,19
1.2043141007307315e+18,1,9,9.0,9,9,0,1
1.2043414043285084e+18,4,16,4.0,3,5,4,0
1.2043770781502976e+18,9,84,9.333333333333334,5,12,1,8
1.204389681336423e+18,6,27,4.5,3,6,6,0
1.204409786220549e+18,3,13,4.333333333333333,2,6,3,0
1.204837497356905e+18,2,5,2.5,2,3,2,0
1.2048528627576394e+18,2,11,5.5,5,6,2,0
1.204888652609007e+18,13,103,7.923076923076923,6,10,4,9
1.204941912400858e+18,17,103,6.0588235294117645,3,8,16,1
1.204944333575758e+18,19,168,8.842105263157896,3,11,1,18
1.204963142076039e+18,26,146,5.615384615384615,4,7,26,0
1.2049680540167846e+18,19,25,1.3157894736842106,1,2,19,0
1.2049792725547704e+18,6,30,5.0,3,7,6,0
1.204983512778817e+18,9,56,6.222222222222222,4,8,7,2
1.2050233530297718e+18,1,10,10.0,10,10,0,1
1.2050687661783475e+18,6,40,6.666666666666667,6,8,5,1
1.2050738203634068e+18,11,71,6.454545454545454,6,9,10,1
1.2051106732557706e+18,7,36,5.142857142857143,3,7,7,0
1.2051381207465027e+18,17,110,6.470588235294118,2,9,12,5
1.2051460738035832e+18,6,50,8.333333333333334,7,9,1,5
1.2051814108725238e+18,21,148,7.0476190476190474,3,9,13,8
1.2056273219201723e+18,23,203,8.826086956521738,2,11,2,21
1.2056279063600123e+18,5,16,3.2,2,4,5,0
1.205628192580512e+18,3,11,3.6666666666666665,3,4,3,0
1.2056295183102482e+18,20,193,9.65,3,12,3,17
1.2056746594293125e+18,4,26,6.5,6,7,4,0
1.2056980767065298e+18,11,15,1.3636363636363635,1,3,11,0
1.2057461498204308e+18,7,52,7.428571428571429,4,9,2,5
1.205845639058253e+18,43,375,8.720930232558139,2,11,6,37
1.2058617912315597e+18,3,11,3.6666666666666665,2,5,3,0
1.2058691103479537e+18,1,3,3.0,3,3,1,0
1.2059544484810276e+18,2,5,2.5,2,3,2,0
1.2059567758912013e+18,9,18,2.0,1,3,9,0
1.2059784665660897e+18,5,46,9.2,8,11,0,5
1.2060001985485747e+18,18,37,2.0555555555555554,1,4,18,0
1.206246393491858e+18,4,29,7.25,4,9,2,2
1.2062817978833754e+18,14,30,2.142857142857143,1,4,14,0
1.206323247047103e+18,3,20,6.666666666666667,6,7,3,0
1.20634088572055e+18,29,138,4.758620689655173,2,7,29,0
1.2063472096951017e+18,1,2,2.0,2,2,1,0
1.2063497458880422e+18,1,7,7.0,7,7,1,0
1.206387012687651e+18,29,251,8.655172413793103,2,12,4,25
1.2063923523799698e+18,2,15,7.5,7,8,1,1
1.2063989878543631e+18,9,45,5.0,4,6,9,0
1.2064178157844076e+18,12,26,2.1666666666666665,1,3,12,0
1.206425687230743e+18,7,34,4.857142857142857,4,6,7,0
1.2064296527261998e+18,5,41,8.2,7,9,2,3
1.2064297098359247e+18,4,10,2.5,2,3,4,0
1.2064611845566305e+18,1,5,5.0,5,5,1,0
1.2064852826717678e+18,2,16,8.0,8,8,0,2
1.2064882203889285e+18,7,71,10.142857142857142,9,11,0,7
1.2064999372414564e+18,5,8,1.6,1,3,5,0
1.206527743325304e+18,4,10,2.5,2,3,4,0
1.2065318947199442e+18,31,159,5.129032258064516,3,7,31,0
1.206536264290763e+18,2,15,7.5,7,8,1,1
1.2065382716336596e+18,7,66,9.428571428571429,8,10,0,7
1.2065445082575137e+18,10,20,2.0,1,3,10,0
1.2066759246958e+18,8,23,2.875,2,5,8,0
1.2067032186127903e+18,7,14,2.0,1,3,7,0
1.2069968720217016e+18,19,69,3.6315789473684212,2,5,19,0
1.2070061772303565e+18,2,13,6.5,5,8,1,1
1.2070341749728622e+18,9,30,3.3333333333333335,2,6,9,0
1.2070546991810655e+18,13,88,6.769230769230769,4,9,9,4
1.2070643059145426e+18,14,27,1.9285714285714286,1,3,14,0
1.2070655537670054e+18,1,7,7.0,7,7,1,0
1.2070663907530235e+18,17,44,2.588235294117647,1,4,17,0
1.2070686830209032e+18,1,2,2.0,2,2,1,0
1.2070778472998792e+18,4,25,6.25,4,8,3,1
1.2070798674473075e+18,3,20,6.666666666666667,6,8,2,1
1.207080475263383e+18,1,7,7.0,7,7,1,0
1.2070819212798812e+18,5,35,7.0,5,9,4,1
1.2070863750563976e+18,1,1,1.0,1,1,1,0
1.2070939015408737e+18,1,4,4.0,4,4,1,0
1.207096559228049e+18,1,3,3.0,3,3,1,0
1.20711573224327e+18,2,3,1.5,1,2,2,0
1.2071179287700142e+18,38,355,9.342105263157896,3,12,3,35
1.2071290557821315e+18,70,668,9.542857142857143,2,12,3,67
1.20713347501171e+18,3,10,3.3333333333333335,2,4,3,0
1.2071609194716298e+18,2,19,9.5,9,10,0,2
1.2071683479435364e+18,4,31,7.75,7,8,1,3
1.2072031999747722e+18,1,9,9.0,9,9,0,1
1.2072091484041285e+18,7,24,3.4285714285714284,3,5,7,0
1.2072481908179e+18,32,275,8.59375,5,11,6,26
1.2072598633532393e+18,2,17,8.5,8,9,0,2
1.2072748230103017e+18,5,11,2.2,1,4,5,0
1.2072955752349018e+18,21,44,2.0952380952380953,1,4,21,0
1.2073087999765804e+18,1,8,8.0,8,8,0,1
1.2073096181476255e+18,12,25,2.0833333333333335,1,5,12,0
1.2073130074035415e+18,7,16,2.2857142857142856,1,3,7,0
1.2073203769956378e+18,2,16,8.0,7,9,1,1
1.207321359730038e+18,3,23,7.666666666666667,7,8,1,2
1.2073331339868406e+18,3,16,5.333333333333333,4,7,3,0
1.2073503965655642e+18,6,17,2.8333333333333335,2,3,6,0
1.2073601821530903e+18,2,7,3.5,3,4,2,0
1.2074698282131113e+18,1,1,1.0,1,1,1,0
1.2075540540142413e+18,8,74,9.25,8,11,0,8
1.2077157273692436e+18,1,7,7.0,7,7,1,0
1.20773927216906e+18,4,9,2.25,1,4,4,0
1.2077652282929329e+18,2,21,10.5,10,11,0,2
1.2077687062324224e+18,1,3,3.0,3,3,1,0
1.207773441408426e+18,29,148,5.103448275862069,3,7,29,0
1.2078022094355922e+18,16,143,8.9375,8,10,0,16
1.2078101582981356e+18,39,297,7.615384615384615,3,10,16,23
1.2078163418321843e+18,14,133,9.5,6,12,1,13
1.2078226236471974e+18,3,10,3.3333333333333335,2,4,3,0
1.2078744854828012e+18,2,15,7.5,5,10,1,1
1.207902176078446e+18,1,4,4.0,4,4,1,0
1.2079025247560993e+18,2,19,9.5,9,10,0,2
1.2079027800600653e+18,2,14,7.0,6,8,1,1
1.2079030955662362e+18,1,8,8.0,8,8,0,1
1.2079046612837414e+18,1,8,8.0,8,8,0,1
1.2079046626816366e+18,1,3,3.0,3,3,1,0
1.2079046700960855e+18,1,9,9.0,9,9,0,1
1.20790479604673e+18,1,3,3.0,3,3,1,0
1.2079055568928154e+18,1,8,8.0,8,8,0,1
1.2079076882557655e+18,1,9,9.0,9,9,0,1
1.2079165014217682e+18,4,7,1.75,1,2,4,0
1.2079179119298752e+18,16,21,1.3125,1,3,16,0
1.207920035747845e+18,1,3,3.0,3,3,1,0
1.2079293417367967e+18,1,3,3.0,3,3,1,0
1.207941839736026e+18,27,34,1.2592592592592593,1,3,27,0
1.2079758735131095e+18,1,6,6.0,6,6,1,0
1.2080014861370115e+18,28,87,3.107142857142857,1,6,28,0
1.2080186793565146e+18,20,96,4.8,2,7,20,0
1.2080323629212946e+18,5,17,3.4,2,4,5,0
1.2080326062619297e+18,2,2,1.0,1,1,2,0
1.2080351627555927e+18,7,22,3.142857142857143,2,5,7,0
1.208093709423026e+18,60,403,6.716666666666667,3,10,48,12
1.2081357265106616e+18,23,201,8.73913043478261,5,11,2,21
1.2084459754268237e+18,19,37,1.9473684210526316,1,4,19,0
1.2084909004426253e+18,3,15,5.0,5,5,3,0
1.208525223649087e+18,2,16,8.0,7,9,1,1
1.2085269756045622e+18,18,172,9.555555555555555,4,12,1,17
1.2085269964712425e+18,15,130,8.666666666666666,3,10,2,13
1.2085678798382034e+18,4,6,1.5,1,3,4,0
1.208575714477369e+18,18,130,7.222222222222222,5,8,8,10
1.2085792147458819e+18,1,1,1.0,1,1,1,0
1.208618995655849e+18,1,3,3.0,3,3,1,0
1.2086313667969285e+18,10,85,8.5,7,11,2,8
1.208632585050188e+18,28,107,3.8214285714285716,2,6,28,0
1.2086465135007217e+18,1,9,9.0,9,9,0,1
1.2086660824626606e+18,21,97,4.619047619047619,3,7,21,0
1.2086744295798205e+18,4,19,4.75,4,5,4,0
1.2086766551683896e+18,82,177,2.158536585365854,1,5,82,0
1.2086810654723804e+18,10,90,9.0,6,11,2,8
1.2087220605831913e+18,5,12,2.4,2,4,5,0
1.2088209138018255e+18,15,134,8.933333333333334,4,11,2,13
1.209198677044476e+18,5,50,10.0,9,13,0,5
1.2092069936853048e+18,14,77,5.5,4,7,14,0
1.209209197348228e+18,3,6,2.0,1,3,3,0
1.209219599283318e+18,16,31,1.9375,1,3,16,0
1.2092324372117568e+18,4,20,5.0,4,6,4,0
1.209256800556656e+18,28,140,5.0,3,7,28,0
1.209341075180427e+18,13,54,4.153846153846154,2,6,13,0
1.2093521648683261e+18,2,21,10.5,10,11,0,2
1.2093663571174182e+18,15,51,3.4,1,5,15,0
1.2093739526622052e+18,5,41,8.2,5,10,1,4
1.2094720479333924e+18,2,15,7.5,6,9,1,1
1.2095736764884188e+18,2,15,7.5,7,8,1,1
1.2098942624630682e+18,8,79,9.875,9,11,0,8
1.210023013460254e+18,1,6,6.0,6,6,1,0
1.2100465046517755e+18,3,9,3.0,2,4,3,0
1.2100579455442527e+18,22,25,1.1363636363636365,1,2,22,0
1.2100617350110582e+18,1,2,2.0,2,2,1,0
1.210071897759071e+18,4,20,5.0,4,6,4,0
1.210103333322425e+18,5,37,7.4,4,10,2,3
1.2101161070445396e+18,7,38,5.428571428571429,5,7,7,0
1.2101400721737684e+18,6,44,7.333333333333333,6,8,3,3
1.210182581449993e+18,9,46,5.111111111111111,3,6,9,0
1.2105201750669852e+18,1,8,8.0,8,8,0,1
1.2105734966144297e+18,9,11,1.2222222222222223,1,3,9,0
1.2106785470602025e+18,1,4,4.0,4,4,1,0
1.2107177064007841e+18,2,14,7.0,7,7,2,0
1.2107542666946493e+18,5,14,2.8,1,4,5,0
1.210782044619271e+18,18,29,1.6111111111111112,1,3,18,0
1.2108247579393472e+18,12,43,3.5833333333333335,2,6,12,0
1.2108541717808003e+18,25,200,8.0,6,10,8,17
1.2109222395961075e+18,31,156,5.032258064516129,4,7,31,0
1.2109391504634813e+18,1,2,2.0,2,2,1,0
1.2109524701974753e+18,14,29,2.0714285714285716,1,4,14,0
1.2110678131448082e+18,1,3,3.0,3,3,1,0
1.2113151553971889e+18,3,19,6.333333333333333,6,7,3,0
1.2113495222224858e+18,19,77,4.052631578947368,1,6,19,0
1.2113637463902653e+18,1,8,8.0,8,8,0,1
1.2113749669727183e+18,5,29,5.8,3,7,5,0
1.2113751394739505e+18,7,57,8.142857142857142,7,9,2,5
1.2113899226631519e+18,1,10,10.0,10,10,0,1
1.21138994561445e+18,23,113,4.913043478260869,3,7,23,0
1.2113972558241925e+18,7,49,7.0,6,8,5,2
1.2114180969546655e+18,5,33,6.6,6,7,5,0
1.211462381320486e+18,6,17,2.8333333333333335,2,4,6,0
1.2114700048482545e+18,9,17,1.8888888888888888,1,4,9,0
1.211473998369352e+18,2,4,2.0,1,3,2,0
1.2114835301466248e+18,5,8,1.6,1,2,5,0
1.2115046041390339e+18,2,5,2.5,2,3,2,0
1.2115095439461445e+18,3,18,6.0,4,7,3,0
1.211512683892356e+18,10,47,4.7,3,6,10,0
1.211568329124762e+18,1,2,2.0,2,2,1,0
1.211583077777642e+18,14,98,7.0,6,8,10,4
1.211584776901617e+18,8,60,7.5,7,8,4,4
1.2115853537688466e+18,12,96,8.0,6,10,2,10
1.2115887001377052e+18,14,106,7.571428571428571,6,9,6,8
1.2115964496477425e+18,13,84,6.461538461538462,5,8,10,3
1.211597296058247e+18,4,27,6.75,5,9,3,1
1.2115979444067776e+18,14,103,7.357142857142857,3,9,6,8
1.2115980630219825e+18,3,20,6.666666666666667,5,8,2,1
1.2116509835755433e+18,18,53,2.9444444444444446,1,4,18,0
1.211666140981284e+18,7,55,7.857142857142857,7,9,2,5
1.211683556303078e+18,2,13,6.5,6,7,2,0
1.2116871091619812e+18,20,194,9.7,4,12,1,19
1.2117056657475249e+18,12,61,5.083333333333333,4,6,12,0
1.2117132796583575e+18,4,19,4.75,2,6,4,0
1.2117570897907195e+18,18,86,4.777777777777778,3,6,18,0
1.211993545619248e+18,2,16,8.0,7,9,1,1
1.21202200166703e+18,1,7,7.0,7,7,1,0
1.2120221896327012e+18,4,15,3.75,3,6,4,0
1.2120230273903939e+18,2,8,4.0,4,4,2,0
1.212059867903457e+18,3,22,7.333333333333333,7,8,2,1
1.2120778573316923e+18,8,15,1.875,1,3,8,0
1.2120971388135375e+18,8,13,1.625,1,3,8,0
1.2121523270147105e+18,2,6,3.0,3,3,2,0
1.2122039868322327e+18,18,49,2.7222222222222223,1,4,18,0
1.2122599737684022e+18,20,149,7.45,2,9,7,13
1.2122806606369605e+18,25,46,1.84,1,3,25,0
1.2123295573396895e+18,35,100,2.857142857142857,1,4,35,0
1.2123451441082765e+18,18,22,1.2222222222222223,1,3,18,0
1.2123673365347085e+18,32,305,9.53125,4,12,2,30
1.212378323614794e+18,33,291,8.818181818181818,6,11,2,31
1.2123889345801055e+18,36,310,8.61111111111111,3,11,2,34
1.2124499774522043e+18,1,1,1.0,1,1,1,0
1.2125057520007158e+18,39,78,2.0,1,3,39,0
1.2125183947570545e+18,2,10,5.0,5,5,2,0
1.2125185448733548e+18,2,11,5.5,5,6,2,0
1.2125187009953992e+18,3,14,4.666666666666667,3,7,3,0
1.212518908317621e+18,3,12,4.0,2,6,3,0
1.212519206412442e+18,2,12,6.0,6,6,2,0
1.2125195118036227e+18,1,6,6.0,6,6,1,0
1.2125197440897014e+18,1,5,5.0,5,5,1,0
1.2125199552441946e+18,2,10,5.0,4,6,2,0
1.2125201876832292e+18,1,4,4.0,4,4,1,0
1.2125203916838062e+18,2,10,5.0,4,6,2,0
1.2125208462407475e+18,2,10,5.0,4,6,2,0
1.2125210077506772e+18,2,9,4.5,4,5,2,0
1.2125212676184986e+18,1,6,6.0,6,6,1,0
1.2125282498059315e+18,2,16,8.0,8,8,0,2
1.2126899759514063e+18,6,29,4.833333333333333,3,6,6,0
1.2127581109600952e+18,7,38,5.428571428571429,2,8,5,2
1.212767295173905e+18,12,47,3.9166666666666665,2,6,12,0
1.2127744088752443e+18,6,16,2.6666666666666665,1,4,6,0
1.2127856233404268e+18,4,35,8.75,8,10,0,4
1.2128108021240576e+18,19,54,2.8421052631578947,1,5,19,0
1.2128351797472192e+18,2,9,4.5,4,5,2,0
1.2128792942185687e+18,12,27,2.25,1,4,12,0
1.2128897046960292e+18,18,88,4.888888888888889,4,7,18,0
1.2128915504827274e+18,11,23,2.090909090909091,1,4,11,0
1.2128944459502124e+18,21,45,2.142857142857143,1,4,21,0
1.2128959409277916e+18,2,10,5.0,4,6,2,0
1.2129019409126223e+18,25,73,2.92,2,4,25,0
1.2129075781612221e+18,23,55,2.391304347826087,1,4,23,0
1.213006128456519e+18,4,17,4.25,3,5,4,0
1.213068035603792e+18,9,64,7.111111111111111,5,9,5,4
1.2130734645581166e+18,1,1,1.0,1,1,1,0
1.2130888745635796e+18,9,55,6.111111111111111,5,7,9,0
1.2131526059749548e+18,6,26,4.333333333333333,3,6,6,0
1.2132505949202301e+18,14,94,6.714285714285714,4,9,8,6
1.2132694897826383e+18,13,49,3.769230769230769,2,5,13,0
1.213523991739287e+18,2,14,7.0,5,9,1,1
1.2135496163151754e+18,2,23,11.5,11,12,0,2
1.2135533609410785e+18,9,19,2.111111111111111,1,3,9,0
1.2135776216420938e+18,2,5,2.5,2,3,2,0
1.2135822395877942e+18,26,183,7.038461538461538,2,9,18,8
1.2135839025971154e+18,1,2,2.0,2,2,1,0
1.213586668482317e+18,16,107,6.6875,2,10,12,4
1.2135912953544333e+18,1,7,7.0,7,7,1,0
1.2136027246061294e+18,6,14,2.3333333333333335,1,3,6,0
1.2136214306421545e+18,5,33,6.6,2,10,2,3
1.2136229125825577e+18,5,37,7.4,7,8,3,2
1.213632584243124e+18,10,17,1.7,1,3,10,0
1.2136389512760916e+18,1,6,6.0,6,6,1,0
1.2136491112634555e+18,11,111,10.090909090909092,8,11,0,11
1.2136542529777667e+18,1,7,7.0,7,7,1,0
1.2136591423076787e+18,4,7,1.75,1,3,4,0
1.213665043476654e+18,21,154,7.333333333333333,5,11,14,7
1.2136713922660424e+18,2,19,9.5,8,11,0,2
1.2136774717980426e+18,1,7,7.0,7,7,1,0
1.2136920499128932e+18,11,77,7.0,5,8,9,2
1.2137177541256865e+18,5,33,6.6,5,8,4,1
1.2137243774389092e+18,3,8,2.6666666666666665,2,3,3,0
1.2137293188806533e+18,3,6,2.0,1,3,3,0
1.2137430461703373e+18,6,13,2.1666666666666665,1,3,6,0
1.2137524177313853e+18,13,41,3.1538461538461537,1,5,13,0
1.2137754253703068e+18,40,272,6.8,4,9,30,10
1.2137978724519967e+18,4,7,1.75,1,2,4,0
1.2138252228508326e+18,37,52,1.4054054054054055,1,3,37,0
1.2138308126156536e+18,10,71,7.1,5,9,7,3
1.2138356932781888e+18,7,38,5.428571428571429,4,8,6,1
1.213841192465479e+18,8,59,7.375,7,8,5,3
1.213845412493422e+18,3,4,1.3333333333333333,1,2,3,0
1.2138508542948319e+18,12,59,4.916666666666667,1,7,12,0
1.2138575695632238e+18,10,64,6.4,5,8,9,1
1.2141965780836032e+18,1,9,9.0,9,9,0,1
1.2142272106549676e+18,2,16,8.0,7,9,1,1
1.2142324844977723e+18,1,6,6.0,6,6,1,0
1.2142479949772836e+18,1,5,5.0,5,5,1,0
1.2142590952966405e+18,4,33,8.25,7,10,2,2
1.214271282833856e+18,4,28,7.0,5,8,2,2
1.2142877831929103e+18,12,90,7.5,6,9,6,6
1.214295381343519e+18,9,61,6.777777777777778,6,9,7,2
1.2143233724013565e+18,3,8,2.6666666666666665,2,3,3,0
1.2143241645428516e+18,6,40,6.666666666666667,5,8,5,1
1.2143298451126141e+18,3,19,6.333333333333333,4,8,2,1
1.2143334522943409e+18,3,29,9.666666666666666,9,11,0,3
1.214339382941487e+18,9,89,9.88888888888889,9,11,0,9
1.2143478577756774e+18,3,22,7.333333333333333,7,8,2,1
1.2143618723929052e+18,3,22,7.333333333333333,7,8,2,1
1.2143677264653809e+18,8,58,7.25,6,9,5,3
1.2143966267255724e+18,7,23,3.2857142857142856,2,4,7,0
1.214399815976024e+18,3,27,9.0,8,10,0,3
1.2144047896908096e+18,20,156,7.8,2,10,8,12
1.214406346444904e+18,3,19,6.333333333333333,4,8,2,1
1.2144250768687524e+18,4,26,6.5,6,8,3,1
1.2144343248351767e+18,12,48,4.0,2,5,12,0
1.2144347055274417e+18,4,24,6.0,4,8,3,1
1.2144628934232207e+18,7,58,8.285714285714286,7,10,1,6
1.21447527389643e+18,7,37,5.285714285714286,3,7,7,0
1.2144787325438945e+18,1,3,3.0,3,3,1,0
1.2144885314643912e+18,13,62,4.769230769230769,3,7,13,0
1.2145044052109156e+18,10,97,9.7,8,11,0,10
1.2145582954110208e+18,18,54,3.0,1,5,18,0
1.214655867795326e+18,18,81,4.5,2,7,18,0
1.2146884797341908e+18,2,5,2.5,2,3,2,0
1.2146917507937021e+18,28,57,2.0357142857142856,1,4,28,0
1.2147091218743142e+18,14,81,5.785714285714286,4,8,13,1
1.2147108522056737e+18,16,95,5.9375,5,8,15,1
1.2147198547872458e+18,15,87,5.8,3,7,15,0
1.2147277394754872e+18,10,11,1.1,1,2,10,0
1.2147359824506322e+18,20,129,6.45,4,8,17,3
1.2150093538473636e+18,1,8,8.0,8,8,0,1
1.2150390646236544e+18,8,10,1.25,1,2,8,0
1.2151309624086966e+18,34,230,6.764705882352941,5,9,26,8
1.2151467803185756e+18,2,12,6.0,5,7,2,0
1.2151511197024202e+18,2,13,6.5,6,7,2,0
1.2151523092348516e+18,2,6,3.0,2,4,2,0
1.2151655116625357e+18,4,9,2.25,1,3,4,0
1.2152194181082102e+18,7,13,1.8571428571428572,1,3,7,0
1.215284833412443e+18,37,74,2.0,1,4,37,0
1.2153438632722196e+18,1,8,8.0,8,8,0,1
1.2154332150178732e+18,8,57,7.125,3,9,3,5
1.2154871931812124e+18,6,20,3.3333333333333335,3,4,6,0
1.2156647912817533e+18,18,82,4.555555555555555,3,6,18,0
1.2156863641963359e+18,22,146,6.636363636363637,3,8,15,7
1.2157023885000264e+18,17,85,5.0,3,7,17,0
1.2157221027158917e+18,28,188,6.714285714285714,3,9,19,9
1.2157460615397952e+18,6,37,6.166666666666667,3,9,4,2
1.2157801154819924e+18,27,188,6.962962962962963,3,9,16,11
1.2158426987728773e+18,28,166,5.928571428571429,2,8,25,3
1.2158479833779064e+18,2,13,6.5,5,8,1,1
1.2158491692859884e+18,23,134,5.826086956521739,2,9,21,2
1.2158531282453356e+18,15,95,6.333333333333333,4,8,13,2
1.2158553891288968e+18,16,88,5.5,3,8,15,1
1.2158737058772641e+18,1,4,4.0,4,4,1,0
1.2158805547487186e+18,5,39,7.8,6,9,1,4
1.2158828575983644e+18,9,87,9.666666666666666,8,11,0,9
1.2159173235437204e+18,3,7,2.3333333333333335,2,3,3,0
1.215932011134466e+18,1,2,2.0,2,2,1,0
1.215978505657191e+18,66,454,6.878787878787879,3,9,46,20
1.215981421198853e+18,2,9,4.5,4,5,2,0
1.2159886916046482e+18,23,158,6.869565217391305,5,9,17,6
1.2159943225302054e+18,1,2,2.0,2,2,1,0
1.216020294205909e+18,4,30,7.5,7,9,3,1
1.2162438504183478e+18,2,4,2.0,1,3,2,0
1.2162800036035786e+18,1,8,8.0,8,8,0,1
1.2163573543265055e+18,17,149,8.764705882352942,3,10,1,16
1.2164126459331325e+18,3,21,7.0,6,9,2,1
1.2164335275957996e+18,2,11,5.5,5,6,2,0
1.2164716328502316e+18,4,38,9.5,8,11,0,4
1.2165182058945032e+18,1,8,8.0,8,8,0,1
1.2165282191473213e+18,8,59,7.375,6,8,4,4
1.216532331462452e+18,2,11,5.5,5,6,2,0
1.21653422059975e+18,15,105,7.0,4,9,10,5
1.2165366834878116e+18,7,27,3.857142857142857,3,6,7,0
1.2165411170612808e+18,15,59,3.933333333333333,2,5,15,0
1.216543154461407e+18,5,42,8.4,7,11,2,3
1.2165445793275617e+18,3,29,9.666666666666666,8,11,0,3
1.216566552752493e+18,2,4,2.0,1,3,2,0
1.2165698276853094e+18,4,31,7.75,7,8,1,3
1.2165880930020419e+18,7,17,2.4285714285714284,1,3,7,0
1.2166098704500708e+18,4,5,1.25,1,2,4,0
1.2166116377927212e+18,6,41,6.833333333333333,2,9,3,3
1.2166569554056883e+18,4,10,2.5,2,4,4,0
1.2166818130469023e+18,3,23,7.666666666666667,5,10,1,2
1.2166819542270566e+18,1,3,3.0,3,3,1,0
1.216742299054351e+18,5,9,1.8,1,4,5,0
1.2167492405128876e+18,13,32,2.4615384615384617,1,4,13,0
1.2167503242404682e+18,1,2,2.0,2,2,1,0
1.2167684529708045e+18,1,2,2.0,2,2,1,0
1.2167807245898368e+18,4,13,3.25,2,4,4,0
1.2168373063557806e+18,6,35,5.833333333333333,5,6,6,0
1.2168603398085837e+18,33,272,8.242424242424242,3,11,5,28
1.2168771065268987e+18,4,14,3.5,2,6,4,0
1.2170547868955878e+18,14,58,4.142857142857143,2,6,14,0
1.2171386081954583e+18,5,23,4.6,4,5,5,0
1.2171395300472412e+18,1,7,7.0,7,7,1,0
1.2171553112227118e+18,1,3,3.0,3,3,1,0
1.217157949686016e+18,27,210,7.777777777777778,6,9,10,17
1.2171606681076e+18,9,39,4.333333333333333,3,6,9,0
1.2171673943750016e+18,1,5,5.0,5,5,1,0
1.2172175631169848e+18,3,9,3.0,2,4,3,0
1.2172271171405545e+18,1,8,8.0,8,8,0,1
1.2172463251185093e+18,1,5,5.0,5,5,1,0
1.217246598658115e+18,1,8,8.0,8,8,0,1
1.2172647819909038e+18,3,10,3.3333333333333335,3,4,3,0
1.2173306109661437e+18,2,12,6.0,5,7,2,0
1.2173367482625792e+18,2,5,2.5,2,3,2,0
1.2173489233422725e+18,7,23,3.2857142857142856,2,5,7,0
1.2173554054966118e+18,2,19,9.5,9,10,0,2
1.2173698927998157e+18,5,13,2.6,2,3,5,0
1.2173739742256276e+18,2,13,6.5,6,7,2,0
1.2173844667205117e+18,32,179,5.59375,3,8,31,1
1.2173866589409828e+18,32,191,5.96875,4,8,30,2
1.2173876772115213e+18,23,90,3.9130434782608696,2,7,23,0
1.2173946067546138e+18,21,115,5.476190476190476,4,7,21,0
1.2173992508907246e+18,19,113,5.947368421052632,3,8,17,2
1.217401472304395e+18,12,74,6.166666666666667,3,8,10,2
1.2174022109635218e+18,23,200,8.695652173913043,7,10,1,22
1.2174050244831089e+18,24,143,5.958333333333333,4,8,22,2
1.217407310770989e+18,8,48,6.0,5,7,8,0
1.217448569767354e+18,4,30,7.5,6,9,2,2
1.217459260532075e+18,13,85,6.538461538461538,5,10,10,3
1.2174892833725998e+18,9,30,3.3333333333333335,2,5,9,0
1.2175172211332024e+18,9,34,3.7777777777777777,2,5,9,0
1.2175481942136366e+18,14,28,2.0,1,4,14,0
1.2175721262854346e+18,10,66,6.6,4,8,9,1
1.2176990172101348e+18,9,14,1.5555555555555556,1,3,9,0
1.2178045561682227e+18,1,7,7.0,7,7,1,0
1.217827422186303e+18,9,41,4.555555555555555,2,7,9,0
1.2178428054012943e+18,3,4,1.3333333333333333,1,2,3,0
1.2178514295974397e+18,8,24,3.0,2,5,8,0
1.217861041077313e+18,1,3,3.0,3,3,1,0
1.2178638894274524e+18,3,9,3.0,2,4,3,0
1.217868130138602e+18,11,22,2.0,1,5,11,0
1.2178718413312635e+18,13,87,6.6923076923076925,5,8,11,2
1.2178783346433188e+18,11,81,7.363636363636363,2,9,3,8
1.217885140540638e+18,25,251,10.04,3,12,1,24
1.2178914183808522e+18,4,9,2.25,1,4,4,0
1.2178920913986153e+18,2,16,8.0,8,8,0,2
1.217905463747558e+18,5,14,2.8,2,4,5,0
1.2179347475971515e+18,27,260,9.62962962962963,8,11,0,27
1.2179414977968415e+18,5,48,9.6,9,10,0,5
1.217949094065207e+18,8,49,6.125,4,8,7,1
1.21795411945387e+18,11,83,7.545454545454546,7,9,7,4
1.2179556801034778e+18,16,109,6.8125,5,9,11,5
1.2179783208251018e+18,22,28,1.2727272727272727,1,2,22,0
1.2179993634474662e+18,10,58,5.8,2,8,8,2
1.2180076113891453e+18,14,39,2.7857142857142856,2,5,14,0
1.21801825381001e+18,1,2,2.0,2,2,1,0
1.2180273605140186e+18,3,9,3.0,1,5,3,0
1.2180276128844378e+18,2,14,7.0,7,7,2,0
1.2180422198172518e+18,2,4,2.0,2,2,2,0
1.2180442985993626e+18,3,18,6.0,3,8,2,1
1.2180754961378954e+18,8,57,7.125,6,9,6,2
1.218092110440205e+18,16,47,2.9375,2,5,16,0
1.21811627865757e+18,11,19,1.7272727272727273,1,3,11,0
1.2181495519534461e+18,1,6,6.0,6,6,1,0
1.218167501774461e+18,8,42,5.25,3,7,8,0
1.2181864453465144e+18,40,195,4.875,3,7,40,0
1.2182015841428283e+18,4,26,6.5,6,7,4,0
1.2182078740126546e+18,2,5,2.5,2,3,2,0
1.2182121641163116e+18,1,8,8.0,8,8,0,1
1.218224649525584e+18,2,17,8.5,8,9,0,2
1.218235568770612e+18,8,53,6.625,5,8,6,2
1.218244301027992e+18,36,306,8.5,3,12,4,32
1.2182825600946898e+18,25,90,3.6,2,6,25,0
1.2182928218896899e+18,16,68,4.25,1,5,16,0
1.2183796856801398e+18,4,36,9.0,9,9,0,4
1.2183873586969969e+18,6,56,9.333333333333334,9,10,0,6
1.2183910407924772e+18,13,128,9.846153846153847,4,12,1,12
1.2183953044871936e+18,6,57,9.5,5,11,1,5
1.2185592043397066e+18,11,44,4.0,3,5,11,0
1.2185770866389606e+18,8,62,7.75,7,9,3,5
1.218589284851751e+18,22,196,8.909090909090908,4,11,2,20
1.2185970817043185e+18,1,2,2.0,2,2,1,0
1.2185980185937595e+18,6,28,4.666666666666667,2,7,6,0
1.2186190108752108e+18,6,19,3.1666666666666665,1,5,6,0
1.218620110690976e+18,1,9,9.0,9,9,0,1
1.2186566305270623e+18,5,35,7.0,2,9,2,3
1.218687673069479e+18,1,8,8.0,8,8,0,1
1.218694468772723e+18,3,31,10.333333333333334,10,11,0,3
1.218703550265626e+18,7,9,1.2857142857142858,1,2,7,0
1.2187068807682657e+18,2,16,8.0,8,8,0,2
1.2187106621192248e+18,12,56,4.666666666666667,2,6,12,0
1.2187199518610877e+18,13,57,4.384615384615385,3,7,13,0
1.218761222435114e+18,13,63,4.846153846153846,3,6,13,0
1.2187681677138043e+18,22,63,2.8636363636363638,1,4,22,0
1.2187707444693363e+18,4,12,3.0,3,3,4,0
1.2187793929214013e+18,1,9,9.0,9,9,0,1
1.2187840436294003e+18,17,32,1.8823529411764706,1,3,17,0
1.2187842748455483e+18,20,42,2.1,1,4,20,0
1.218785189666043e+18,13,21,1.6153846153846154,1,4,13,0
1.2187855174634752e+18,18,34,1.8888888888888888,1,4,18,0
1.2187982256585364e+18,2,16,8.0,8,8,0,2
1.2188104753480812e+18,19,171,9.0,4,12,4,15
1.218819603537478e+18,21,106,5.0476190476190474,3,7,21,0
1.2188464565285012e+18,2,13,6.5,5,8,1,1
1.218850976913201e+18,5,40,8.0,7,9,1,4
1.2189173897939645e+18,1,2,2.0,2,2,1,0
1.2189612896695122e+18,10,107,10.7,10,12,0,10
1.2189837224422482e+18,9,91,10.11111111111111,9,11,0,9
1.2190192392898893e+18,14,104,7.428571428571429,5,10,6,8
1.2192238288393103e+18,7,44,6.285714285714286,3,8,6,1
1.2192346018248433e+18,7,46,6.571428571428571,5,10,6,1
1.2193085309533998e+18,3,11,3.6666666666666665,2,5,3,0
1.2193369373086845e+18,12,75,6.25,3,8,10,2
1.2193437345452915e+18,6,25,4.166666666666667,3,6,6,0
1.219344193629426e+18,2,4,2.0,1,3,2,0
1.2193583518466373e+18,7,15,2.142857142857143,1,3,7,0
1.2193615487069225e+18,10,20,2.0,1,3,10,0
1.2193902691017498e+18,11,94,8.545454545454545,8,10,0,11
1.2193910152715133e+18,5,37,7.4,7,8,3,2
1.2193914887571791e+18,4,25,6.25,5,7,4,0
1.219417337815211e+18,4,10,2.5,2,3,4,0
1.219418712467353e+18,7,63,9.0,8,10,0,7
1.2194441332461286e+18,14,119,8.5,7,10,1,13
1.219502160359551e+18,1,7,7.0,7,7,1,0
1.2195059019994693e+18,26,129,4.961538461538462,3,7,26,0
1.2195076992473134e+18,25,234,9.36,3,11,1,24
1.2195189697628436e+18,22,155,7.045454545454546,5,9,15,7
1.2195371280728297e+18,17,31,1.8235294117647058,1,4,17,0
1.2195373763775555e+18,8,54,6.75,3,9,5,3
1.2195804232642877e+18,22,112,5.090909090909091,3,7,22,0
1.219585832292943e+18,11,24,2.1818181818181817,1,4,11,0
1.2196485632590472e+18,1,11,11.0,11,11,0,1
1.219671787412551e+18,9,75,8.333333333333334,4,11,2,7
1.2196783247317212e+18,9,85,9.444444444444445,8,10,0,9
1.2196842297925038e+18,11,98,8.909090909090908,8,10,0,11
1.2196897136144701e+18,9,83,9.222222222222221,8,10,0,9
1.2196944777415462e+18,14,115,8.214285714285714,3,10,2,12
1.219707579114511e+18,2,17,8.5,8,9,0,2
1.2197275592118382e+18,4,21,5.25,2,9,3,1
1.2200202568658857e+18,6,49,8.166666666666666,7,10,2,4
1.2200520853083018e+18,4,7,1.75,1,3,4,0
1.220053847149601e+18,9,68,7.555555555555555,7,9,6,3
1.220056665428793e+18,5,33,6.6,3,9,3,2
1.2200663883187028e+18,4,25,6.25,4,8,3,1
1.2200711642380004e+18,3,22,7.333333333333333,7,8,2,1
1.2201079797579233e+18,10,78,7.8,6,9,4,6
1.2201473296322332e+18,7,47,6.714285714285714,2,10,4,3
1.220242997618117e+18,21,138,6.571428571428571,5,8,17,4
1.2202469639493985e+18,18,40,2.2222222222222223,1,4,18,0
1.2202778710463137e+18,17,103,6.0588235294117645,5,8,16,1
1.2203762546797169e+18,10,81,8.1,6,9,1,9
1.2207892778631575e+18,34,304,8.941176470588236,7,11,1,33
1.2208035083327818e+18,3,5,1.6666666666666667,1,2,3,0
1.22085203127968e+18,4,31,7.75,7,8,1,3
1.2208871599763914e+18,13,92,7.076923076923077,5,9,8,5
1.2209434889671706e+18,28,42,1.5,1,3,28,0
1.2209531838939116e+18,29,46,1.5862068965517242,1,4,29,0
1.2209614522515973e+18,8,16,2.0,1,3,8,0
1.22099075071991e+18,2,2,1.0,1,1,2,0
1.2210159020126979e+18,8,33,4.125,2,6,8,0
1.2210403672809178e+18,2,13,6.5,6,7,2,0
1.2211084843958807e+18,14,109,7.785714285714286,6,10,6,8
1.2211256523139428e+18,2,9,4.5,4,5,2,0
1.2211367211367094e+18,2,19,9.5,8,11,0,2
1.2214766604321052e+18,3,24,8.0,8,8,0,3
1.2214866372513743e+18,5,13,2.6,1,4,5,0
1.2215335614032906e+18,5,38,7.6,6,9,2,3
1.2215610558464381e+18,48,181,3.7708333333333335,1,6,48,0
1.2216869788220303e+18,47,237,5.042553191489362,2,7,47,0
1.221704253070206e+18,14,66,4.714285714285714,2,7,14,0
1.2217485612673928e+18,5,27,5.4,5,6,5,0
1.2217646282305664e+18,19,51,2.6842105263157894,1,5,19,0
1.221786284490073e+18,15,65,4.333333333333333,3,6,15,0
1.2217887841683658e+18,8,57,7.125,5,8,4,4
1.2218077292204828e+18,15,51,3.4,2,5,15,0
1.2218227499648097e+18,23,34,1.4782608695652173,1,4,23,0
1.2218230429221366e+18,62,550,8.870967741935484,2,11,8,54
1.2218330506238234e+18,3,32,10.666666666666666,10,11,0,3
1.2218717278988767e+18,5,44,8.8,2,11,1,4
1.2218933869255616e+18,3,4,1.3333333333333333,1,2,3,0
1.2219051710826637e+18,3,11,3.6666666666666665,2,5,3,0
1.221932756879905e+18,43,127,2.953488372093023,1,6,43,0
1.2219408680289285e+18,14,69,4.928571428571429,4,8,13,1
1.2219724227718216e+18,2,7,3.5,3,4,2,0
1.22219274496808e+18,4,28,7.0,5,8,2,2
1.2222060889601756e+18,1,2,2.0,2,2,1,0
1.2222135568098355e+18,8,78,9.75,6,11,1,7
1.2222181908263324e+18,13,71,5.461538461538462,3,7,13,0
1.2222348526963607e+18,6,40,6.666666666666667,5,9,5,1
1.2222458711266465e+18,2,14,7.0,7,7,2,0
1.2222666019069788e+18,19,105,5.526315789473684,4,8,18,1
1.2222916986800822e+18,19,40,2.1052631578947367,1,4,19,0
1.222296328728117e+18,2,15,7.5,7,8,1,1
1.2223037887170342e+18,4,27,6.75,4,8,2,2
1.2223070061065144e+18,3,18,6.0,5,7,3,0
1.2223330920140017e+18,20,118,5.9,4,8,18,2
1.222349883334553e+18,17,30,1.7647058823529411,1,3,17,0
1.2223813036881021e+18,8,19,2.375,1,4,8,0
1.2224250494292744e+18,8,22,2.75,1,4,8,0
1.222443201760873e+18,2,6,3.0,1,5,2,0
1.2224465899612424e+18,13,63,4.846153846153846,2,7,13,0
1.2224657075853898e+18,28,51,1.8214285714285714,1,3,28,0
1.2224968075232113e+18,6,42,7.0,6,9,5,1
1.2224996601549778e+18,14,42,3.0,2,5,14,0
1.222510910822724e+18,12,37,3.0833333333333335,2,5,12,0
1.2226502813514045e+18,11,53,4.818181818181818,4,7,11,0
1.2227252993056466e+18,7,47,6.714285714285714,5,9,6,1
1.2229087344430554e+18,8,65,8.125,2,10,1,7
1.2229301799947745e+18,3,3,1.0,1,1,3,0
1.2229645727192026e+18,10,19,1.9,1,3,10,0
1.2229718082921705e+18,15,93,6.2,2,8,12,3
1.222977793777608e+18,5,35,7.0,6,8,4,1
1.2229950929757258e+18,1,5,5.0,5,5,1,0
1.2230219114440968e+18,5,25,5.0,4,6,5,0
1.2230286501713403e+18,76,739,9.723684210526315,4,13,4,72
1.2230320599867062e+18,5,14,2.8,2,4,5,0
1.22306660223198e+18,2,6,3.0,2,4,2,0
1.223073540959178e+18,9,25,2.7777777777777777,1,5,9,0
1.223086103865717e+18,1,2,2.0,2,2,1,0
1.2230945766005686e+18,45,396,8.8,5,11,5,40
1.2231344454486533e+18,1,2,2.0,2,2,1,0
1.2231419482398592e+18,28,78,2.7857142857142856,1,5,28,0
1.2231535975347246e+18,9,20,2.2222222222222223,1,3,9,0
1.2231650769089759e+18,3,16,5.333333333333333,4,7,3,0
1.223182310958524e+18,1,2,2.0,2,2,1,0
1.223258625432994e+18,1,3,3.0,3,3,1,0
1.2232768691986186e+18,1,2,2.0,2,2,1,0
1.2232839692138642e+18,1,3,3.0,3,3,1,0
1.2235696229798026e+18,3,8,2.6666666666666665,2,3,3,0
1.2235754289467126e+18,1,3,3.0,3,3,1,0
1.223654027915837e+18,18,25,1.3888888888888888,1,3,18,0
1.223674118904213e+18,5,40,8.0,7,10,2,3
1.223697130532093e+18,99,785,7.929292929292929,3,10,31,68
1.2237387898182682e+18,24,48,2.0,1,4,24,0
1.223759896483699e+18,5,40,8.0,7,9,1,4
1.2237779294054423e+18,14,142,10.142857142857142,8,13,0,14
1.2239150053727365e+18,25,113,4.52,2,6,25,0
1.2239879883567688e+18,3,22,7.333333333333333,6,8,1,2
1.2240482397572692e+18,5,14,2.8,2,5,5,0
1.2243534823649114e+18,10,20,2.0,1,3,10,0
1.2243859738623729e+18,4,26,6.5,3,8,2,2
1.2243985247309217e+18,4,29,7.25,7,8,3,1
1.2244013549202883e+18,3,24,8.0,5,10,1,2
1.2244201712163005e+18,19,69,3.6315789473684212,2,5,19,0
1.2244223402361295e+18,13,68,5.230769230769231,4,8,12,1
1.224441797351589e+18,18,36,2.0,1,4,18,0
1.2244711011293335e+18,4,29,7.25,6,9,3,1
1.2244811262419546e+18,2,5,2.5,2,3,2,0
1.2245304219758154e+18,23,149,6.478260869565218,4,9,18,5
1.2245481702102226e+18,5,38,7.6,6,9,2,3
1.2245539950256876e+18,2,12,6.0,6,6,2,0
1.2245603817941501e+18,10,86,8.6,5,10,2,8
1.2245839598957204e+18,22,194,8.818181818181818,4,11,3,19
1.2246037956641103e+18,2,10,5.0,3,7,2,0
1.2246522826391247e+18,5,43,8.6,7,11,1,4
1.2246554022225308e+18,8,24,3.0,2,5,8,0
1.224677864329973e+18,24,242,10.083333333333334,8,12,0,24
1.2247051736918817e+18,6,58,9.666666666666666,9,10,0,6
1.2247269482731604e+18,17,130,7.647058823529412,6,9,7,10
1.2247409947670228e+18,32,305,9.53125,5,12,2,30
1.2247748753378895e+18,26,255,9.807692307692308,2,13,1,25
1.2247883815921126e+18,32,308,9.625,6,12,3,29
1.224805087531639e+18,39,354,9.076923076923077,2,12,4,35
1.2251299895423542e+18,3,22,7.333333333333333,6,8,1,2
1.225174170113324e+18,9,16,1.7777777777777777,1,3,9,0
1.2252439875003855e+18,7,58,8.285714285714286,6,9,2,5
1.2253027238884823e+18,9,18,2.0,1,3,9,0
1.225327903775488e+18,14,31,2.2142857142857144,1,3,14,0
1.2253302618185216e+18,23,135,5.869565217391305,3,8,21,2
1.2253369774635072e+18,22,32,1.4545454545454546,1,3,22,0
1.2253372663723387e+18,3,7,2.3333333333333335,2,3,3,0
1.2253488812188692e+18,14,96,6.857142857142857,5,9,9,5
1.2253585596230618e+18,3,22,7.333333333333333,7,8,2,1
1.225433819275226e+18,18,34,1.8888888888888888,1,4,18,0
1.2254616325534175e+18,46,419,9.108695652173912,3,11,1,45
1.2255257501040648e+18,5,29,5.8,3,8,4,1
1.225588210544009e+18,5,22,4.4,3,5,5,0
1.22579970313671e+18,20,141,7.05,4,8,11,9
1.2258353648268308e+18,27,263,9.74074074074074,4,12,1,26
1.2259736889715515e+18,21,216,10.285714285714286,8,13,0,21
1.226171563951724e+18,1,9,9.0,9,9,0,1
1.2262222686806264e+18,6,36,6.0,4,7,6,0
1.226565121955517e+18,22,203,9.227272727272727,4,12,4,18
1.2265680784969756e+18,20,117,5.85,4,8,19,1
1.226574236172736e+18,8,17,2.125,1,3,8,0
1.2265896873467295e+18,2,15,7.5,7,8,1,1
1.2265903565876966e+18,25,145,5.8,4,8,24,1
1.2265975764803354e+18,18,180,10.0,5,13,1,17
1.2266240252296248e+18,21,30,1.4285714285714286,1,3,21,0
1.226636884568502e+18,2,9,4.5,4,5,2,0
1.2266374130973893e+18,3,8,2.6666666666666665,1,4,3,0
1.226643840282601e+18,6,48,8.0,6,11,3,3
1.22665902871202e+18,1,9,9.0,9,9,0,1
1.2266631996605932e+18,1,2,2.0,2,2,1,0
1.2266778011775076e+18,7,14,2.0,1,3,7,0
1.226715513133515e+18,19,27,1.4210526315789473,1,4,19,0
1.2267277779234918e+18,11,25,2.272727272727273,1,4,11,0
1.2267441742263631e+18,3,8,2.6666666666666665,2,3,3,0
1.2267507077725376e+18,2,8,4.0,4,4,2,0
1.226790254339941e+18,1,11,11.0,11,11,0,1
1.2267976083488648e+18,3,5,1.6666666666666667,1,2,3,0
1.226803928347982e+18,13,55,4.230769230769231,3,5,13,0
1.2268252078102994e+18,4,9,2.25,1,3,4,0
1.2268459545481152e+18,31,124,4.0,2,6,31,0
1.2269097206043e+18,5,10,2.0,1,3,5,0
1.2273188362878797e+18,11,78,7.090909090909091,4,9,6,5
1.227328219124551e+18,1,2,2.0,2,2,1,0
1.2273545893723697e+18,2,11,5.5,5,6,2,0
1.2273552310206766e+18,1,5,5.0,5,5,1,0
1.227428351702733e+18,3,25,8.333333333333334,7,10,1,2
1.227461931585676e+18,16,70,4.375,3,6,16,0
1.227496048583877e+18,11,81,7.363636363636363,5,9,6,5
1.2274966980876467e+18,14,89,6.357142857142857,5,8,13,1
1.227497594849432e+18,9,63,7.0,6,8,8,1
1.2274985531151834e+18,9,72,8.0,5,10,1,8
1.227499546449312e+18,12,85,7.083333333333333,5,9,8,4
1.2275002257460004e+18,8,14,1.75,1,3,8,0
1.227500892948542e+18,13,128,9.846153846153847,5,12,1,12
1.2275009805404326e+18,9,26,2.888888888888889,2,4,9,0
1.2275019595536632e+18,12,40,3.3333333333333335,2,5,12,0
1.227502601495953e+18,13,24,1.8461538461538463,1,3,13,0
1.227503336987275e+18,17,38,2.235294117647059,1,4,17,0
1.2275038507732285e+18,10,30,3.0,1,5,10,0
1.2275048887943718e+18,12,78,6.5,3,8,8,4
1.2275379450368737e+18,4,24,6.0,5,7,4,0
1.227588665839338e+18,20,180,9.0,7,11,2,18
1.2276081441007939e+18,5,33,6.6,6,8,4,1
1.2276156126019116e+18,3,10,3.3333333333333335,3,4,3,0
1.2279950419553766e+18,2,15,7.5,7,8,1,1
1.2280122025272978e+18,4,8,2.0,1,3,4,0
1.2280255215937802e+18,7,38,5.428571428571429,4,7,7,0
1.2280322833423836e+18,8,55,6.875,6,8,5,3
1.2280331232712197e+18,19,73,3.8421052631578947,2,5,19,0
1.2280398385221094e+18,3,8,2.6666666666666665,2,3,3,0
1.228041334749917e+18,1,7,7.0,7,7,1,0
1.228053595612815e+18,1,10,10.0,10,10,0,1
1.2280543566530683e+18,10,45,4.5,2,6,10,0
1.228057690316937e+18,2,17,8.5,8,9,0,2
1.2280633595543255e+18,16,77,4.8125,3,6,16,0
1.2280649638461427e+18,1,6,6.0,6,6,1,0
1.2280709405033385e+18,36,82,2.2777777777777777,1,6,36,0
1.2280712642639176e+18,6,23,3.8333333333333335,3,5,6,0
1.2281096973529856e+18,6,43,7.166666666666667,6,8,4,2
1.2281169764390592e+18,5,41,8.2,7,10,2,3
1.2281753133751035e+18,1,7,7.0,7,7,1,0
1.2282499049109125e+18,19,38,2.0,1,4,19,0
1.2282607760368594e+18,11,51,4.636363636363637,3,6,11,0
1.2282989729141514e+18,3,7,2.3333333333333335,2,3,3,0
1.2283057759284508e+18,4,11,2.75,1,4,4,0
1.2283113480445076e+18,45,341,7.5777777777777775,2,10,17,28
1.2283430266168975e+18,10,14,1.4,1,3,10,0
1.2283554384116204e+18,8,49,6.125,5,7,8,0
1.228746208589032e+18,1,2,2.0,2,2,1,0
1.22878753278799e+18,15,37,2.466666666666667,1,4,15,0
1.2288069821200307e+18,11,74,6.7272727272727275,5,8,9,2
1.2288095009075963e+18,5,32,6.4,6,7,5,0
1.2288116494687027e+18,2,4,2.0,2,2,2,0
1.228862082073003e+18,2,14,7.0,7,7,2,0
1.2288706911943452e+18,21,147,7.0,4,9,13,8
1.228907832387268e+18,13,119,9.153846153846153,7,11,2,11
1.2289808556114975e+18,10,57,5.7,4,8,9,1
1.2289883006752392e+18,5,11,2.2,1,3,5,0
1.2289990759031227e+18,38,381,10.026315789473685,7,12,1,37
1.2289995544728e+18,28,256,9.142857142857142,4,12,3,25
1.2290098968508736e+18,42,297,7.071428571428571,5,10,27,15
1.2290120336000515e+18,39,90,2.3076923076923075,1,4,39,0
1.2290132471600512e+18,30,65,2.1666666666666665,1,4,30,0
1.229014068388224e+18,33,77,2.3333333333333335,1,4,33,0
1.229024038448218e+18,14,42,3.0,2,5,14,0
1.2290599108902298e+18,8,59,7.375,7,8,5,3
1.2293904684014218e+18,10,20,2.0,1,3,10,0
1.229509118480302e+18,3,21,7.0,6,8,2,1
1.2295118535896673e+18,5,15,3.0,1,4,5,0
1.2295551780800548e+18,8,42,5.25,4,6,8,0
1.229570355895772e+18,13,101,7.769230769230769,5,10,3,10
1.2295842473990461e+18,2,20,10.0,7,13,1,1
1.229599401172018e+18,2,20,10.0,10,10,0,2
1.2296066715606838e+18,14,27,1.9285714285714286,1,3,14,0
1.2296283494951124e+18,2,3,1.5,1,2,2,0
1.2296404255093573e+18,11,35,3.1818181818181817,2,5,11,0
1.2296663573344466e+18,1,4,4.0,4,4,1,0
1.2296950906810924e+18,3,3,1.0,1,1,3,0
1.229733692203448e+18,1,3,3.0,3,3,1,0
1.2297403087918136e+18,21,160,7.619047619047619,5,9,8,13
1.2297534375685023e+18,14,130,9.285714285714286,3,11,1,13
1.2297954522318157e+18,61,474,7.770491803278689,3,11,20,41
1.2298021426511066e+18,5,26,5.2,4,6,5,0
1.2298402072029358e+18,19,76,4.0,2,7,19,0
1.2298470079590216e+18,3,18,6.0,5,7,3,0
1.2298538308833692e+18,1,8,8.0,8,8,0,1
1.2298752607177812e+18,4,30,7.5,7,8,2,2
1.2298846158259776e+18,4,31,7.75,7,8,1,3
1.2298891711515103e+18,34,267,7.852941176470588,6,10,12,22
1.2299040947628685e+18,11,21,1.9090909090909092,1,3,11,0
1.2301565065557353e+18,1,2,2.0,2,2,1,0
1.2302075920178378e+18,1,7,7.0,7,7,1,0
1.2302317858477563e+18,28,139,4.964285714285714,3,7,28,0
1.230233971998341e+18,39,295,7.564102564102564,3,10,13,26
1.2302464415473336e+18,18,176,9.777777777777779,8,11,0,18
1.2302481577485005e+18,3,20,6.666666666666667,6,7,3,0
1.230385878270525e+18,42,366,8.714285714285714,2,11,3,39
1.2303933478481848e+18,4,8,2.0,1,3,4,0
1.2304211243973686e+18,6,40,6.666666666666667,6,7,6,0
1.230563664402089e+18,41,163,3.975609756097561,2,6,41,0
1.2305734237519368e+18,6,62,10.333333333333334,6,12,1,5
1.2310113929941266e+18,22,67,3.0454545454545454,1,5,22,0
1.2310348886096888e+18,22,90,4.090909090909091,2,7,22,0
1.231050521425954e+18,18,44,2.4444444444444446,1,5,18,0
1.2310573467793352e+18,16,84,5.25,2,7,16,0
1.2311019037568983e+18,47,417,8.872340425531915,3,11,5,42
1.2311219304956275e+18,49,438,8.938775510204081,4,11,5,44
1.23123157768346e+18,3,20,6.666666666666667,6,7,3,0
1.2315579441071334e+18,4,32,8.0,7,9,2,2
1.231633734204946e+18,17,34,2.0,1,4,17,0
1.2316380820571098e+18,4,36,9.0,8,10,0,4
1.2316583517345743e+18,3,29,9.666666666666666,9,10,0,3
1.2316615641123912e+18,21,106,5.0476190476190474,4,7,21,0
1.2316644861486482e+18,2,22,11.0,11,11,0,2
1.2316715163755988e+18,42,125,2.9761904761904763,1,5,42,0
1.2316721483930826e+18,6,55,9.166666666666666,8,11,0,6
1.231678712626705e+18,46,363,7.891304347826087,3,10,16,30
1.231679384063053e+18,3,26,8.666666666666666,8,9,0,3
1.2316821404718034e+18,5,50,10.0,9,12,0,5
1.2316834775820037e+18,5,48,9.6,8,11,0,5
1.2316847535627446e+18,5,39,7.8,6,9,2,3
1.2316860948575334e+18,1,9,9.0,9,9,0,1
1.2316872285362173e+18,2,18,9.0,6,12,1,1
1.2317370564395564e+18,1,6,6.0,6,6,1,0
1.231738188888459e+18,24,214,8.916666666666666,5,11,1,23
1.2317436993131075e+18,12,82,6.833333333333333,5,8,10,2
1.231749309736556e+18,4,30,7.5,7,8,2,2
1.2317540562292247e+18,4,32,8.0,6,10,1,3
1.2317559715194557e+18,27,183,6.777777777777778,3,9,20,7
1.2317585302541394e+18,1,2,2.0,2,2,1,0
1.2317624374783288e+18,2,18,9.0,8,10,0,2
1.2317639864390648e+18,1,8,8.0,8,8,0,1
1.231764035207597e+18,1,2,2.0,2,2,1,0
1.2317716898098225e+18,4,16,4.0,3,5,4,0
1.231775338105251e+18,2,4,2.0,1,3,2,0
1.2317776537339507e+18,3,7,2.3333333333333335,1,3,3,0
1.231779720251537e+18,2,6,3.0,2,4,2,0
1.2317910982619213e+18,1,4,4.0,4,4,1,0
1.2318230071336863e+18,3,5,1.6666666666666667,1,2,3,0
1.2318441144084692e+18,4,33,8.25,7,10,2,2
1.2319587858904497e+18,13,67,5.153846153846154,2,6,13,0
1.232006032043082e+18,26,122,4.6923076923076925,2,7,26,0
1.232288714589128e+18,3,18,6.0,5,7,3,0
1.2324211140579576e+18,1,4,4.0,4,4,1,0
1.2324736402591644e+18,6,23,3.8333333333333335,3,5,6,0
1.2324793212333545e+18,7,18,2.5714285714285716,2,3,7,0
1.2324882442763889e+18,1,3,3.0,3,3,1,0
1.232525327477052e+18,1,9,9.0,9,9,0,1
1.232528486130403e+18,2,8,4.0,3,5,2,0
1.2325528913756982e+18,10,78,7.8,6,10,4,6
1.2325546495252774e+18,9,82,9.11111111111111,7,11,1,8
1.232584399843385e+18,12,25,2.0833333333333335,1,3,12,0
1.2325909918969062e+18,14,33,2.357142857142857,1,5,14,0
1.2325910297176456e+18,9,15,1.6666666666666667,1,2,9,0
1.232592692235454e+18,2,10,5.0,5,5,2,0
1.2325970148573317e+18,22,72,3.272727272727273,1,5,22,0
1.2326014556853156e+18,8,68,8.5,7,10,1,7
1.2326044261099822e+18,19,34,1.7894736842105263,1,3,19,0
1.2326044322830298e+18,20,39,1.95,1,4,20,0
1.233018541714256e+18,3,7,2.3333333333333335,2,3,3,0
1.233091959164206e+18,24,187,7.791666666666667,3,10,8,16
1.2331108040243607e+18,6,47,7.833333333333333,7,8,1,5
1.2331132918229212e+18,1,3,3.0,3,3,1,0
1.2331334791721341e+18,15,49,3.2666666666666666,1,5,15,0
1.233147597260024e+18,26,142,5.461538461538462,4,8,25,1
1.2331583253624845e+18,14,46,3.2857142857142856,1,5,14,0
1.2331845431575803e+18,1,4,4.0,4,4,1,0
1.2332187893366915e+18,2,4,2.0,1,3,2,0
1.2332299994364324e+18,2,7,3.5,3,4,2,0
1.2332478925911777e+18,9,93,10.333333333333334,9,11,0,9
1.233251590880304e+18,8,23,2.875,1,4,8,0
1.2332547324699958e+18,1,6,6.0,6,6,1,0
1.233276882320717e+18,1,12,12.0,12,12,0,1
1.2332896009210696e+18,4,23,5.75,5,6,4,0
1.2333299638893327e+18,19,38,2.0,1,3,19,0
1.2333754397937341e+18,13,73,5.615384615384615,2,7,13,0
1.2334587763064435e+18,4,10,2.5,2,3,4,0
1.2334785643624786e+18,17,167,9.823529411764707,9,11,0,17
1.233573875273569e+18,3,24,8.0,7,10,2,1
1.2337996716371402e+18,17,48,2.823529411764706,1,4,17,0
1.2338147762265206e+18,27,75,2.7777777777777777,1,4,27,0
1.2338735816935268e+18,10,30,3.0,1,5,10,0
1.2338881757029847e+18,7,59,8.428571428571429,6,10,1,6
1.2338901976088271e+18,1,2,2.0,2,2,1,0
1.2338951111973476e+18,13,104,8.0,7,10,5,8
1.233906012351459e+18,1,4,4.0,4,4,1,0
1.2339287925810568e+18,6,53,8.833333333333334,7,11,1,5
1.2339410782783713e+18,2,4,2.0,1,3,2,0
1.2339664028737508e+18,5,39,7.8,6,9,1,4
1.2339823471971904e+18,7,14,2.0,1,3,7,0
1.2339846785225935e+18,1,2,2.0,2,2,1,0
1.233986239419821e+18,1,6,6.0,6,6,1,0
1.23399373524108e+18,4,14,3.5,3,4,4,0
1.2340096010356585e+18,4,11,2.75,1,4,4,0
1.2340198932956803e+18,10,63,6.3,5,9,9,1
1.2340306852518062e+18,3,9,3.0,2,5,3,0
1.2340462564337055e+18,76,498,6.552631578947368,2,9,58,18
1.2340539690753577e+18,1,4,4.0,4,4,1,0
1.2340639051563338e+18,9,57,6.333333333333333,4,9,8,1
1.234098630082937e+18,3,10,3.3333333333333335,3,4,3,0
1.2341099756602683e+18,12,66,5.5,4,7,12,0
1.2341221240658988e+18,3,11,3.6666666666666665,3,4,3,0
1.2341412201266816e+18,1,5,5.0,5,5,1,0
1.2341570467566966e+18,4,30,7.5,6,9,2,2
1.2341753451986893e+18,30,155,5.166666666666667,4,7,30,0
1.2341942687353746e+18,15,78,5.2,4,7,15,0
1.2342005681376998e+18,2,6,3.0,2,4,2,0
1.2342333308928353e+18,26,124,4.769230769230769,3,7,26,0
1.2342368926138e+18,14,20,1.4285714285714286,1,2,14,0
1.2345591678855142e+18,38,258,6.7894736842105265,5,10,28,10
1.2345649122919145e+18,10,80,8.0,6,9,3,7
1.2345976076825513e+18,20,39,1.95,1,5,20,0
1.2346215284098952e+18,18,37,2.0555555555555554,1,4,18,0
1.234640844268596e+18,1,8,8.0,8,8,0,1
1.2347272145730877e+18,2,3,1.5,1,2,2,0
1.2347355652861745e+18,3,22,7.333333333333333,6,8,1,2
1.234752068072232e+18,3,24,8.0,8,8,0,3
1.234782819896975e+18,6,25,4.166666666666667,3,5,6,0
1.2348022388829391e+18,4,9,2.25,2,3,4,0
1.2348043469042744e+18,10,57,5.7,4,7,10,0
1.2348051439673262e+18,1,5,5.0,5,5,1,0
1.234849025188518e+18,3,27,9.0,8,10,0,3
1.2348686830252526e+18,11,104,9.454545454545455,8,11,0,11
1.234969462119443e+18,7,61,8.714285714285714,7,10,1,6
1.2349709326519747e+18,6,11,1.8333333333333333,1,3,6,0
1.2350452519419745e+18,11,74,6.7272727272727275,2,9,9,2
1.2351725779802314e+18,2,15,7.5,5,10,1,1
1.2351982322696294e+18,6,37,6.166666666666667,5,7,6,0
1.2352395366439076e+18,4,23,5.75,4,8,3,1
1.235310167597226e+18,7,57,8.142857142857142,8,9,0,7
1.2353968838218465e+18,20,137,6.85,5,9,16,4
1.235411807744119e+18,3,22,7.333333333333333,7,8,2,1
1.2355196199292096e+18,22,144,6.545454545454546,6,7,22,0
1.2355622270885263e+18,16,92,5.75,5,7,16,0
1.2356593965194824e+18,14,21,1.5,1,3,14,0
1.2359604201139863e+18,1,8,8.0,8,8,0,1
1.2360074623960955e+18,1,2,2.0,2,2,1,0
1.23607108332039e+18,28,258,9.214285714285714,7,11,2,26
1.2361550311475592e+18,4,26,6.5,2,10,2,2
1.2361773405248095e+18,13,125,9.615384615384615,5,12,1,12
1.2361877306977283e+18,1,7,7.0,7,7,1,0
1.2361962236955151e+18,18,158,8.777777777777779,2,11,2,16
1.236210250796547e+18,4,9,2.25,1,3,4,0
1.2362105123496617e+18,6,38,6.333333333333333,5,8,5,1
1.2362486251556178e+18,4,25,6.25,4,7,4,0
1.2362805650406246e+18,15,30,2.0,1,3,15,0
1.236299676151718e+18,2,10,5.0,5,5,2,0
1.2363386924696714e+18,6,15,2.5,1,4,6,0
1.2364173957234004e+18,28,82,2.9285714285714284,1,4,28,0
1.2366473774435264e+18,5,34,6.8,6,8,4,1
1.2367046660158927e+18,1,8,8.0,8,8,0,1
1.236725407360882e+18,6,16,2.6666666666666665,2,3,6,0
1.236735784579636e+18,4,29,7.25,7,8,3,1
1.236766090413876e+18,3,23,7.666666666666667,7,8,1,2
1.236771704968042e+18,27,54,2.0,1,4,27,0
1.236798609793857e+18,4,24,6.0,2,9,3,1
1.2368087636404262e+18,1,7,7.0,7,7,1,0
1.2368214493714025e+18,4,20,5.0,2,8,3,1
1.2368301268369242e+18,4,25,6.25,6,7,4,0
1.2368484165371028e+18,1,10,10.0,10,10,0,1
1.236872673770783e+18,7,10,1.4285714285714286,1,2,7,0
1.2368886364059412e+18,3,6,2.0,1,3,3,0
1.236918000599056e+18,8,59,7.375,6,9,5,3
1.2369673527923889e+18,5,17,3.4,2,5,5,0
1.2369833055052608e+18,24,35,1.4583333333333333,1,3,24,0
1.2370098494876042e+18,67,271,4.044776119402985,2,6,67,0
1.2370240376708045e+18,30,291,9.7,4,12,3,27
1.2370396643507013e+18,4,22,5.5,4,7,4,0
1.237067358612214e+18,1,1,1.0,1,1,1,0
1.2370692259993859e+18,21,84,4.0,2,6,21,0
1.2370713929855002e+18,7,65,9.285714285714286,7,10,1,6
1.2374278994010616e+18,1,7,7.0,7,7,1,0
1.2374296072096504e+18,9,57,6.333333333333333,5,7,9,0
1.2374674756278134e+18,6,31,5.166666666666667,5,6,6,0
1.237491176773826e+18,24,193,8.041666666666666,3,11,6,18
1.237546042607168e+18,1,3,3.0,3,3,1,0
1.2376084307564992e+18,1,7,7.0,7,7,1,0
1.2376346383715244e+18,20,56,2.8,1,6,20,0
1.2376399518090138e+18,17,113,6.647058823529412,5,8,15,2
1.2376458091927437e+18,10,19,1.9,1,4,10,0
1.237649144810321e+18,16,52,3.25,2,5,16,0
1.2376530446416517e+18,12,90,7.5,6,9,6,6
1.2376547077505807e+18,11,32,2.909090909090909,2,5,11,0
1.237699308841754e+18,21,126,6.0,4,9,19,2
1.2376994299686188e+18,35,205,5.857142857142857,4,9,32,3
1.2377028359758474e+18,18,104,5.777777777777778,3,8,17,1
1.2377237104120156e+18,11,74,6.7272727272727275,5,8,8,3
1.237733406747635e+18,1,9,9.0,9,9,0,1
1.2377610621983145e+18,3,7,2.3333333333333335,1,4,3,0
1.2378422871746296e+18,13,26,2.0,1,3,13,0
1.2379066811917353e+18,38,333,8.763157894736842,2,12,4,34
1.2379447643322074e+18,16,29,1.8125,1,4,16,0
1.2381181092011372e+18,23,154,6.695652173913044,4,8,19,4
1.2381534343959002e+18,2,13,6.5,5,8,1,1
1.23817880582222e+18,1,8,8.0,8,8,0,1
1.2381954034468344e+18,16,78,4.875,4,7,16,0
1.2382182213803418e+18,8,63,7.875,6,10,3,5
1.238241933601034e+18,6,11,1.8333333333333333,1,4,6,0
1.2382424356172465e+18,10,22,2.2,1,3,10,0
1.238253836629342e+18,5,19,3.8,3,5,5,0
1.2382945112851835e+18,1,4,4.0,4,4,1,0
1.2383072703109837e+18,6,8,1.3333333333333333,1,3,6,0
1.2383263161531988e+18,2,21,10.5,10,11,0,2
1.2383917826750653e+18,12,79,6.583333333333333,5,8,10,2
1.2384010729256143e+18,16,135,8.4375,7,10,2,14
1.2385228567337121e+18,17,65,3.823529411764706,2,6,17,0
1.2385256674917806e+18,1,5,5.0,5,5,1,0
1.2385489511891597e+18,8,24,3.0,2,4,8,0
1.2385498458451238e+18,4,25,6.25,4,9,3,1
1.238674425858379e+18,7,13,1.8571428571428572,1,4,7,0
1.2388640817832123e+18,13,72,5.538461538461538,3,7,13,0
1.2388898805251052e+18,6,46,7.666666666666667,6,9,2,4
1.238896689387379e+18,1,3,3.0,3,3,1,0
1.2389011582930624e+18,5,12,2.4,1,4,5,0
1.2389258625509914e+18,5,36,7.2,6,8,2,3
1.2389330914906353e+18,6,51,8.5,7,9,1,5
1.2389693276299786e+18,4,32,8.0,7,9,1,3
1.2389711897896786e+18,6,40,6.666666666666667,6,7,6,0
1.2389724033986045e+18,1,5,5.0,5,5,1,0
1.2389783046192573e+18,2,7,3.5,3,4,2,0
1.2389903747403223e+18,15,75,5.0,4,6,15,0
1.239021325682073e+18,6,17,2.8333333333333335,2,5,6,0
1.2390319204901865e+18,1,8,8.0,8,8,0,1
1.239054722588363e+18,4,22,5.5,5,6,4,0
1.2390589246126328e+18,26,80,3.076923076923077,2,5,26,0
1.2390879314581194e+18,1,4,4.0,4,4,1,0
1.2391180731292526e+18,4,8,2.0,1,3,4,0
1.2391302470878684e+18,6,21,3.5,2,6,6,0
1.2391360451017152e+18,25,102,4.08,3,5,25,0
1.2391399409631206e+18,46,234,5.086956521739131,3,6,46,0
1.2391519469234936e+18,22,25,1.1363636363636365,1,2,22,0
1.2391575777444024e+18,2,7,3.5,3,4,2,0
1.239179108638836e+18,3,21,7.0,6,8,2,1
1.2392150940277514e+18,5,24,4.8,3,7,5,0
1.2392243857254234e+18,3,24,8.0,7,9,1,2
1.239255974697436e+18,2,18,9.0,8,10,0,2
1.2395562302102413e+18,7,62,8.857142857142858,8,10,0,7
1.2395966134265295e+18,1,10,10.0,10,10,0,1
1.2395972909831754e+18,2,5,2.5,2,3,2,0
1.2395996294556493e+18,3,23,7.666666666666667,7,8,1,2
1.2396113120835297e+18,16,109,6.8125,3,9,11,5
1.2396255511933448e+18,4,32,8.0,7,9,1,3
1.2396383722901478e+18,10,16,1.6,1,3,10,0
1.2396517284325962e+18,5,16,3.2,2,4,5,0
1.239653421944639e+18,14,77,5.5,2,8,13,1
1.239663834717285e+18,10,82,8.2,6,10,1,9
1.2396734974584463e+18,2,3,1.5,1,2,2,0
1.2396736530879944e+18,5,11,2.2,1,4,5,0
1.2396742247067052e+18,3,9,3.0,2,4,3,0
1.23968145402599e+18,4,7,1.75,1,3,4,0
1.2396889624993165e+18,14,30,2.142857142857143,1,5,14,0
1.2396895383089034e+18,8,59,7.375,6,9,4,4
1.239697877150124e+18,14,33,2.357142857142857,1,5,14,0
1.2397045822235492e+18,2,3,1.5,1,2,2,0
1.2397102545960968e+18,5,31,6.2,2,10,3,2
1.239717986505079e+18,12,29,2.4166666666666665,1,4,12,0
1.239718324179265e+18,18,121,6.722222222222222,4,9,15,3
1.2397874384288735e+18,9,20,2.2222222222222223,1,3,9,0
1.2398669955418092e+18,23,95,4.130434782608695,3,7,23,0
1.2399195910584745e+18,21,115,5.476190476190476,4,8,20,1
1.2399909084737142e+18,12,73,6.083333333333333,5,7,12,0
1.239991891102217e+18,10,76,7.6,6,9,5,5
1.240143666599562e+18,9,37,4.111111111111111,3,5,9,0
1.2403222798562534e+18,1,3,3.0,3,3,1,0
1.2403262680613194e+18,10,26,2.6,1,4,10,0
1.240374729148718e+18,5,38,7.6,6,9,3,2
1.2403991060642706e+18,1,3,3.0,3,3,1,0
1.240439858627965e+18,10,89,8.9,4,12,1,9
1.2404652279935839e+18,5,38,7.6,7,8,2,3
1.2404702015577162e+18,1,5,5.0,5,5,1,0
1.240546991729399e+18,6,15,2.5,1,4,6,0
1.2405658465126582e+18,4,33,8.25,8,9,0,4
1.2405754879551322e+18,12,101,8.416666666666666,8,9,0,12
1.2406446079966044e+18,35,328,9.371428571428572,2,12,3,32
1.2407015967745021e+18,1,3,3.0,3,3,1,0
1.2407389417222874e+18,13,86,6.615384615384615,2,8,9,4
1.2411654380398175e+18,1,1,1.0,1,1,1,0
1.2411948062963005e+18,1,3,3.0,3,3,1,0
1.241280255193384e+18,3,10,3.3333333333333335,2,5,3,0
1.2412850219179185e+18,6,53,8.833333333333334,8,10,0,6
1.2412946274855032e+18,22,129,5.863636363636363,3,7,22,0
1.2412958275415265e+18,19,64,3.3684210526315788,2,5,19,0
1.24129902087862e+18,6,11,1.8333333333333333,1,3,6,0
1.2413505705990902e+18,5,37,7.4,4,9,2,3
1.2413628533035003e+18,14,44,3.142857142857143,2,4,14,0
1.2413665113174966e+18,2,5,2.5,1,4,2,0
1.2413886216486008e+18,2,3,1.5,1,2,2,0
1.2414018955054213e+18,1,9,9.0,9,9,0,1
1.241409485672461e+18,1,6,6.0,6,6,1,0
1.2414156901168282e+18,2,18,9.0,9,9,0,2
1.2414266604359224e+18,1,7,7.0,7,7,1,0
1.2414328002254886e+18,2,16,8.0,7,9,1,1
1.2414376261272538e+18,2,13,6.5,4,9,1,1
1.241437966582601e+18,1,8,8.0,8,8,0,1
1.24149951142105e+18,37,380,10.27027027027027,8,12,0,37
1.241518378481819e+18,23,26,1.1304347826086956,1,2,23,0
1.2415483669549494e+18,51,112,2.196078431372549,1,4,51,0
1.2417769822454863e+18,1,7,7.0,7,7,1,0
1.241779420881075e+18,2,21,10.5,10,11,0,2
1.2418082648853699e+18,10,33,3.3,2,5,10,0
1.2418107239499238e+18,1,7,7.0,7,7,1,0
1.2418151091750356e+18,16,116,7.25,2,10,9,7
1.241816361436392e+18,31,236,7.612903225806452,2,11,12,19
1.2418254071735101e+18,9,24,2.6666666666666665,1,5,9,0
1.24183117820984e+18,3,28,9.333333333333334,8,10,0,3
1.241836962285079e+18,1,1,1.0,1,1,1,0
1.2418403858088484e+18,5,8,1.6,1,2,5,0
1.2418477354940472e+18,11,31,2.8181818181818183,1,5,11,0
1.241852152927628e+18,4,34,8.5,7,10,1,3
1.2418549466114207e+18,14,29,2.0714285714285716,1,3,14,0
1.241869552722841e+18,13,23,1.7692307692307692,1,4,13,0
1.2418735964024381e+18,24,46,1.9166666666666667,1,4,24,0
1.2418932483703933e+18,3,17,5.666666666666667,4,7,3,0
1.241902600240413e+18,6,14,2.3333333333333335,1,4,6,0
1.2419041145743741e+18,4,10,2.5,1,4,4,0
1.2419191796239e+18,3,29,9.666666666666666,9,10,0,3
1.241938741702351e+18,1,9,9.0,9,9,0,1
1.2419570758077125e+18,6,21,3.5,3,4,6,0
1.241976306945087e+18,17,54,3.176470588235294,2,6,17,0
1.2419930617217137e+18,16,130,8.125,6,11,5,11
1.2419958410409047e+18,8,35,4.375,3,6,8,0
1.2420331283323428e+18,4,29,7.25,7,8,3,1
1.242074815634641e+18,12,39,3.25,1,5,12,0
1.242151218449758e+18,1,3,3.0,3,3,1,0
1.2422103968492416e+18,18,131,7.277777777777778,4,9,8,10
1.2424708633897303e+18,1,4,4.0,4,4,1,0
1.2424924080721336e+18,1,4,4.0,4,4,1,0
1.2425196620543887e+18,2,17,8.5,8,9,0,2
1.2425242551532987e+18,7,20,2.857142857142857,2,4,7,0
1.242527950276484e+18,15,81,5.4,2,7,15,0
1.2425289128609416e+18,18,126,7.0,5,10,12,6
1.242564208022229e+18,1,1,1.0,1,1,1,0
1.2425872772466898e+18,1,7,7.0,7,7,1,0
1.2425949914956145e+18,21,151,7.190476190476191,6,9,13,8
1.2426012758467517e+18,1,4,4.0,4,4,1,0
1.2426012917697042e+18,5,38,7.6,6,9,2,3
1.2426192546083794e+18,1,9,9.0,9,9,0,1
1.242659985301236e+18,21,28,1.3333333333333333,1,3,21,0
1.2426629135971174e+18,19,31,1.631578947368421,1,3,19,0
1.2426658012778138e+18,23,48,2.0869565217391304,1,4,23,0
1.2426752537040965e+18,26,97,3.730769230769231,2,6,26,0
1.2426776854389524e+18,36,357,9.916666666666666,8,12,0,36
1.2426832630755712e+18,33,172,5.212121212121212,3,8,31,2
1.2426931763768584e+18,3,23,7.666666666666667,7,9,2,1
1.2427187094595318e+18,4,34,8.5,8,10,0,4
1.2427271296423237e+18,6,7,1.1666666666666667,1,2,6,0
1.2427279528806927e+18,4,10,2.5,1,3,4,0
1.2427371357127316e+18,12,14,1.1666666666666667,1,2,12,0
1.242753937476944e+18,36,52,1.4444444444444444,1,3,36,0
1.242754433105429e+18,4,25,6.25,4,8,2,2
1.2428222252965832e+18,20,156,7.8,4,9,5,15
1.2428355633794043e+18,21,30,1.4285714285714286,1,3,21,0
1.242873119604143e+18,5,17,3.4,2,5,5,0
1.2428761104878228e+18,13,72,5.538461538461538,2,7,13,0
1.2430207630243151e+18,1,6,6.0,6,6,1,0
1.2432002024907036e+18,1,9,9.0,9,9,0,1
1.2432218018611476e+18,4,38,9.5,9,10,0,4
1.2432523030073784e+18,1,7,7.0,7,7,1,0
1.2432592286129738e+18,17,32,1.8823529411764706,1,3,17,0
1.243262209570026e+18,3,22,7.333333333333333,7,8,2,1
1.2432680716907653e+18,8,24,3.0,1,4,8,0
1.2432746425052664e+18,2,14,7.0,7,7,2,0
1.2432753339817664e+18,6,47,7.833333333333333,7,9,3,3
1.2432770453263616e+18,1,9,9.0,9,9,0,1
1.2432884847997025e+18,21,170,8.095238095238095,6,11,7,14
1.2432891961350822e+18,1,8,8.0,8,8,0,1
1.2432996057072955e+18,5,9,1.8,1,2,5,0
1.2433174915010035e+18,9,25,2.7777777777777777,2,4,9,0
1.2433399679972733e+18,2,6,3.0,2,4,2,0
1.24338184804063e+18,3,26,8.666666666666666,7,10,1,2
1.2434070779930893e+18,6,42,7.0,6,8,4,2
1.2434097467230784e+18,1,1,1.0,1,1,1,0
1.243414458853442e+18,2,3,1.5,1,2,2,0
1.2434233007726994e+18,1,7,7.0,7,7,1,0
1.2434405402695025e+18,2,18,9.0,8,10,0,2
1.2434420268853804e+18,2,12,6.0,5,7,2,0
1.243443521253855e+18,2,15,7.5,6,9,1,1
1.2434439283002365e+18,1,6,6.0,6,6,1,0
1.2434445798584376e+18,2,13,6.5,6,7,2,0
1.2434572780797714e+18,8,49,6.125,2,9,5,3
1.2434854367924477e+18,3,3,1.0,1,1,3,0
1.2434877771218575e+18,2,4,2.0,1,3,2,0
1.243497820895364e+18,9,65,7.222222222222222,6,8,5,4
1.2435640148493396e+18,41,190,4.634146341463414,2,7,41,0
1.2435913763466609e+18,7,44,6.285714285714286,2,9,5,2
1.243605482717322e+18,4,12,3.0,2,4,4,0
1.2436370404141012e+18,34,156,4.588235294117647,3,6,34,0
1.2436458973192911e+18,6,55,9.166666666666666,7,11,1,5
1.2436633143131005e+18,1,8,8.0,8,8,0,1
1.24367308659323e+18,25,157,6.28,2,9,22,3
1.243723621484185e+18,7,50,7.142857142857143,6,9,5,2
1.243965516034198e+18,4,27,6.75,5,8,3,1
1.2439744600379315e+18,15,137,9.133333333333333,7,11,1,14
1.243980438225598e+18,20,118,5.9,4,7,20,0
1.2440131768712033e+18,16,112,7.0,4,9,11,5
1.2440215352458427e+18,12,83,6.916666666666667,6,8,8,4
1.2440519202735777e+18,3,6,2.0,1,3,3,0
1.2440620293886725e+18,16,32,2.0,1,4,16,0
1.2440646440571118e+18,7,66,9.428571428571429,7,11,1,6
1.244084533187989e+18,23,46,2.0,1,3,23,0
1.244214355961172e+18,58,352,6.068965517241379,4,8,53,5
1.2442245769570179e+18,58,333,5.741379310344827,2,8,57,1
1.244239462481644e+18,16,21,1.3125,1,2,16,0
1.2442530090844285e+18,21,25,1.1904761904761905,1,3,21,0
1.2443160485241987e+18,1,6,6.0,6,6,1,0
1.2443372066144225e+18,6,12,2.0,1,3,6,0
1.2446023100514e+18,43,62,1.441860465116279,1,3,43,0
1.2446690312928934e+18,2,12,6.0,5,7,2,0
1.2446854243425615e+18,16,34,2.125,1,4,16,0
1.244687759802738e+18,21,38,1.8095238095238095,1,4,21,0
1.2447025691447421e+18,3,23,7.666666666666667,7,9,2,1
1.2447043145181944e+18,18,75,4.166666666666667,2,6,18,0
1.2447658379793354e+18,32,191,5.96875,4,8,31,1
1.2447680289403325e+18,2,13,6.5,5,8,1,1
1.24477226888249e+18,4,12,3.0,2,4,4,0
1.2447828528487104e+18,7,15,2.142857142857143,1,5,7,0
1.2447845026102935e+18,2,5,2.5,2,3,2,0
1.2447943765997658e+18,1,9,9.0,9,9,0,1
1.244799914800959e+18,3,27,9.0,8,10,0,3
1.2448099023309307e+18,7,13,1.8571428571428572,1,4,7,0
1.2448730916692954e+18,15,97,6.466666666666667,6,7,15,0
1.2451096117953492e+18,3,25,8.333333333333334,8,9,0,3
1.2451636343385946e+18,2,5,2.5,2,3,2,0
1.245455326345529e+18,9,69,7.666666666666667,6,9,3,6
1.2455570822409439e+18,25,107,4.28,2,6,25,0
1.245572506780696e+18,21,127,6.0476190476190474,3,8,18,3
1.245573913928894e+18,1,10,10.0,10,10,0,1
1.245602895152397e+18,14,19,1.3571428571428572,1,3,14,0
1.2456155042266522e+18,6,34,5.666666666666667,4,7,6,0
1.246243609522509e+18,2,5,2.5,1,4,2,0
1.246278910536783e+18,9,46,5.111111111111111,3,6,9,0
1.2462965512616676e+18,8,17,2.125,1,4,8,0
1.2463176064212232e+18,3,23,7.666666666666667,5,9,1,2
1.2463844713063693e+18,34,297,8.735294117647058,3,11,5,29
1.246389644043586e+18,55,119,2.1636363636363636,1,4,55,0
1.246422973808105e+18,2,14,7.0,6,8,1,1
1.246840270359882e+18,7,20,2.857142857142857,1,5,7,0
1.2468586167703252e+18,7,53,7.571428571428571,6,9,3,4
1.24686127619412e+18,2,14,7.0,6,8,1,1
1.2468673391506895e+18,3,25,8.333333333333334,7,10,1,2
1.2468916010422182e+18,4,26,6.5,4,8,3,1
1.2468948721598118e+18,2,8,4.0,3,5,2,0
1.2469294353007363e+18,2,15,7.5,7,8,1,1
1.246929785903222e+18,3,9,3.0,2,4,3,0
1.2469299671974136e+18,9,64,7.111111111111111,6,8,6,3
1.2469302782795067e+18,7,14,2.0,1,3,7,0
1.246930531585168e+18,5,14,2.8,1,4,5,0
1.2469307875153661e+18,5,14,2.8,2,4,5,0
1.2469311123095741e+18,11,35,3.1818181818181817,2,5,11,0
1.246931432756545e+18,12,35,2.9166666666666665,1,4,12,0
1.2469317899081334e+18,2,5,2.5,2,3,2,0
1.2469320603415619e+18,7,16,2.2857142857142856,1,4,7,0
1.2469325609390907e+18,3,8,2.6666666666666665,2,3,3,0
1.246933062360693e+18,3,23,7.666666666666667,7,8,1,2
1.2469338255626322e+18,11,28,2.5454545454545454,1,6,11,0
1.2469340846175898e+18,2,4,2.0,1,3,2,0
1.2469345473002273e+18,4,7,1.75,1,2,4,0
1.246934870407576e+18,7,21,3.0,1,4,7,0
1.2469350935886817e+18,4,16,4.0,3,5,4,0
1.246935913531572e+18,10,17,1.7,1,3,10,0
1.2469362650114982e+18,1,3,3.0,3,3,1,0
1.2469365604785516e+18,1,3,3.0,3,3,1,0
1.2469367696624566e+18,8,24,3.0,1,6,8,0
1.2469370241483564e+18,6,12,2.0,1,4,6,0
1.2469373736796214e+18,6,18,3.0,2,4,6,0
1.2469375724021115e+18,1,2,2.0,2,2,1,0
1.2469376007468672e+18,4,17,4.25,3,5,4,0
1.246938144259932e+18,4,7,1.75,1,3,4,0
1.2469387676259653e+18,2,7,3.5,2,5,2,0
1.2469389627317727e+18,5,9,1.8,1,3,5,0
1.2469392686698524e+18,5,14,2.8,2,4,5,0
1.2469396523594813e+18,3,8,2.6666666666666665,2,3,3,0
1.2469402222371423e+18,2,4,2.0,2,2,2,0
1.2469405583796326e+18,4,11,2.75,1,4,4,0
1.2469408677612454e+18,10,24,2.4,1,4,10,0
1.2469411565460493e+18,3,24,8.0,8,8,0,3
1.2469413504607898e+18,10,26,2.6,2,4,10,0
1.2469415955893148e+18,5,39,7.8,6,9,2,3
1.2469419174467676e+18,15,54,3.6,3,5,15,0
1.2469426024267343e+18,5,18,3.6,3,4,5,0
1.2469428309466598e+18,5,11,2.2,2,3,5,0
1.2469430142743918e+18,3,11,3.6666666666666665,3,4,3,0
1.2469432586712579e+18,6,13,2.1666666666666665,1,3,6,0
1.2469434571781402e+18,10,29,2.9,2,4,10,0
1.2469437211158659e+18,3,6,2.0,1,3,3,0
1.2469469345809894e+18,9,65,7.222222222222222,6,9,6,3
1.2469690125487194e+18,1,9,9.0,9,9,0,1
1.2469964494868984e+18,2,16,8.0,7,9,1,1
1.2470073090288433e+18,6,39,6.5,5,8,5,1
1.2470267027743414e+18,6,24,4.0,3,5,6,0
1.247035055184051e+18,1,8,8.0,8,8,0,1
1.2470375897715635e+18,7,36,5.142857142857143,4,6,7,0
1.2470699743425006e+18,23,166,7.217391304347826,6,10,14,9
1.2470739573548431e+18,5,20,4.0,3,5,5,0
1.247121871031344e+18,7,47,6.714285714285714,2,9,4,3
1.2471435601055782e+18,19,74,3.8947368421052633,1,6,19,0
1.2471612989837868e+18,11,67,6.090909090909091,2,9,10,1
1.2471784463660844e+18,10,24,2.4,1,4,10,0
1.2471914507035735e+18,16,32,2.0,1,4,16,0
1.2471982764484657e+18,12,105,8.75,5,11,2,10
1.2473048020627868e+18,5,16,3.2,1,4,5,0
1.2475253093813076e+18,15,135,9.0,3,11,2,13
1.2475631164777439e+18,9,66,7.333333333333333,5,9,6,3
1.2476055439443407e+18,7,54,7.714285714285714,7,9,3,4
1.247616471345229e+18,4,15,3.75,3,5,4,0
1.2476316015954191e+18,3,12,4.0,3,5,3,0
1.2476403214159027e+18,15,34,2.2666666666666666,1,4,15,0
1.2476627122111e+18,8,49,6.125,4,8,6,2
1.247669689048015e+18,18,124,6.888888888888889,4,9,11,7
1.2476762520067305e+18,8,60,7.5,6,9,4,4
1.2476860905211953e+18,4,11,2.75,2,4,4,0
1.247710337038672e+18,6,55,9.166666666666666,8,10,0,6
1.2477322412429932e+18,1,9,9.0,9,9,0,1
1.2477454144702236e+18,15,145,9.666666666666666,4,12,1,14
1.2477468143572221e+18,3,19,6.333333333333333,6,7,3,0
1.2477584859535178e+18,3,31,10.333333333333334,10,11,0,3
1.2477951003898803e+18,20,172,8.6,4,11,4,16
1.247818495114875e+18,5,12,2.4,1,3,5,0
1.2478313622874145e+18,1,3,3.0,3,3,1,0
1.2478365173798902e+18,8,19,2.375,1,3,8,0
1.2478923402362222e+18,1,3,3.0,3,3,1,0
1.2479111721536673e+18,4,10,2.5,2,3,4,0
1.2479475551880233e+18,9,15,1.6666666666666667,1,3,9,0
1.2479488366655068e+18,4,9,2.25,1,3,4,0
1.2479505691330468e+18,9,17,1.8888888888888888,1,3,9,0
1.2479516439935378e+18,3,11,3.6666666666666665,2,5,3,0
1.2479572746771487e+18,6,41,6.833333333333333,6,8,5,1
1.247968267838687e+18,10,21,2.1,1,3,10,0
1.247991983100015e+18,1,9,9.0,9,9,0,1
1.2482803152914924e+18,8,57,7.125,6,8,5,3
1.248281859453747e+18,2,3,1.5,1,2,2,0
1.2483581185869578e+18,16,119,7.4375,6,9,7,9
1.2483586526337213e+18,13,27,2.076923076923077,1,4,13,0
1.248386886118523e+18,1,3,3.0,3,3,1,0
1.248390847649211e+18,2,20,10.0,10,10,0,2
1.2484191592366326e+18,17,75,4.411764705882353,3,6,17,0
1.248467943360677e+18,31,176,5.67741935483871,2,7,31,0
1.248508709299055e+18,9,46,5.111111111111111,3,6,9,0
1.2485111935675853e+18,1,9,9.0,9,9,0,1
1.248559139234377e+18,4,32,8.0,5,9,1,3
1.2486933091829202e+18,52,308,5.923076923076923,2,8,49,3
1.2487276294228997e+18,1,3,3.0,3,3,1,0
1.248728243102747e+18,12,98,8.166666666666666,3,11,3,9
1.248890379745069e+18,39,156,4.0,2,7,39,0
1.248933780543407e+18,5,16,3.2,3,4,5,0
1.249040306366267e+18,2,22,11.0,11,11,0,2
1.2490919053861427e+18,2,14,7.0,7,7,2,0
1.249097680133685e+18,9,90,10.0,9,11,0,9
1.2491075786041016e+18,1,5,5.0,5,5,1,0
1.2491164972417526e+18,2,2,1.0,1,1,2,0
1.2491255798553638e+18,21,41,1.9523809523809523,1,3,21,0
1.2491568670220746e+18,7,44,6.285714285714286,5,8,6,1
1.2491756376455025e+18,2,2,1.0,1,1,2,0
1.2492048608027218e+18,18,114,6.333333333333333,2,8,14,4
1.2492504705704648e+18,5,37,7.4,6,10,3,2
1.2492630679523313e+18,6,43,7.166666666666667,5,9,3,3
1.2494184123178212e+18,17,131,7.705882352941177,4,9,5,12
1.2497144327015278e+18,1,4,4.0,4,4,1,0
1.2497650253319693e+18,15,140,9.333333333333334,2,11,1,14
1.2497801157964047e+18,8,54,6.75,5,8,5,3
1.2498395058792036e+18,1,10,10.0,10,10,0,1
1.2498495641748316e+18,2,7,3.5,3,4,2,0
1.249924136545052e+18,1,3,3.0,3,3,1,0
1.2499878819849083e+18,17,86,5.0588235294117645,3,7,17,0
1.250050091910225e+18,4,27,6.75,6,8,3,1
1.2500820327425782e+18,1,2,2.0,2,2,1,0
1.2500826922316529e+18,1,1,1.0,1,1,1,0
1.25009085107265e+18,1,6,6.0,6,6,1,0
1.2501020242749555e+18,2,21,10.5,10,11,0,2
1.250169625839743e+18,1,11,11.0,11,11,0,1
1.2504269876749353e+18,1,9,9.0,9,9,0,1
1.2504506237225674e+18,2,3,1.5,1,2,2,0
1.250458378031794e+18,4,17,4.25,3,6,4,0
1.250469774306103e+18,12,61,5.083333333333333,3,6,12,0
1.2504952086204035e+18,2,9,4.5,4,5,2,0
1.2505171659250609e+18,6,22,3.6666666666666665,3,5,6,0
1.2505988139200515e+18,7,72,10.285714285714286,9,11,0,7
1.250614999670577e+18,11,23,2.090909090909091,1,4,11,0
1.2507017410686244e+18,6,44,7.333333333333333,2,9,1,5
1.250729107716736e+18,1,3,3.0,3,3,1,0
1.2507355125316452e+18,1,7,7.0,7,7,1,0
1.2507611315180372e+18,1,8,8.0,8,8,0,1
1.2512298758910502e+18,15,98,6.533333333333333,3,9,13,2
1.2512459823991926e+18,1,6,6.0,6,6,1,0
1.2512530075375045e+18,16,39,2.4375,1,4,16,0
1.2513276932248658e+18,24,91,3.7916666666666665,2,5,24,0
1.2513406137740058e+18,6,17,2.8333333333333335,1,4,6,0
1.2513543869089623e+18,1,11,11.0,11,11,0,1
1.2513558027423068e+18,6,41,6.833333333333333,6,8,5,1
1.2514268350969014e+18,25,232,9.28,8,11,0,25
1.2514730111809047e+18,12,16,1.3333333333333333,1,3,12,0
1.2515405136181325e+18,1,10,10.0,10,10,0,1
1.2515589028496346e+18,22,175,7.954545454545454,2,10,4,18
1.2516855720419308e+18,3,6,2.0,1,3,3,0
1.25186367157448e+18,1,1,1.0,1,1,1,0
1.2519418028925166e+18,2,7,3.5,3,4,2,0
1.2519478952294528e+18,4,25,6.25,5,7,4,0
1.2520219217598784e+18,6,41,6.833333333333333,3,10,5,1
1.25204716013957e+18,22,148,6.7272727272727275,4,9,15,7
1.2521516256742572e+18,2,16,8.0,7,9,1,1
1.2521686519012974e+18,2,4,2.0,1,3,2,0
1.2522117247814664e+18,5,8,1.6,1,2,5,0
1.2522973245536965e+18,9,24,2.6666666666666665,1,4,9,0
1.2523133848098898e+18,6,19,3.1666666666666665,2,5,6,0
1.2523192262970345e+18,28,279,9.964285714285714,7,12,1,27
1.252396027062224e+18,1,8,8.0,8,8,0,1
1.252660991319515e+18,12,58,4.833333333333333,3,8,11,1
1.2526619723627694e+18,10,61,6.1,2,8,8,2
1.252693300315761e+18,3,9,3.0,2,4,3,0
1.2527341196733763e+18,9,14,1.5555555555555556,1,4,9,0
1.2527355624319396e+18,23,108,4.695652173913044,3,6,23,0
1.25285762884226e+18,2,2,1.0,1,1,2,0
1.2528598417891256e+18,1,4,4.0,4,4,1,0
1.252869216994652e+18,8,70,8.75,7,10,1,7
1.2528739124435057e+18,1,4,4.0,4,4,1,0
1.252912175206179e+18,8,39,4.875,3,7,8,0
1.252927074116098e+18,17,162,9.529411764705882,5,11,1,16
1.2529487723542164e+18,1,3,3.0,3,3,1,0
1.252953970212705e+18,3,6,2.0,2,2,3,0
1.252973901246506e+18,17,171,10.058823529411764,8,12,0,17
1.2529933142551311e+18,4,21,5.25,4,6,4,0
1.2530151358664658e+18,8,54,6.75,6,8,6,2
1.2530292403382474e+18,5,9,1.8,1,3,5,0
1.2530655383147041e+18,9,14,1.5555555555555556,1,3,9,0
1.2533259827053601e+18,3,5,1.6666666666666667,1,3,3,0
1.2533443281860465e+18,1,1,1.0,1,1,1,0
1.2533511653665915e+18,1,4,4.0,4,4,1,0
1.2533551563695347e+18,1,1,1.0,1,1,1,0
1.253356120881015e+18,2,6,3.0,2,4,2,0
1.2533590737897848e+18,1,1,1.0,1,1,1,0
1.2533597873358646e+18,7,45,6.428571428571429,5,8,5,2
1.2533994029484022e+18,1,10,10.0,10,10,0,1
1.2534103444731873e+18,1,10,10.0,10,10,0,1
1.2534120565928484e+18,16,35,2.1875,1,4,16,0
1.2534196280014072e+18,20,66,3.3,1,6,20,0
1.2534363781476058e+18,5,37,7.4,6,8,2,3
1.2534412340083901e+18,2,10,5.0,4,6,2,0
1.2534456539133678e+18,9,21,2.3333333333333335,1,5,9,0
1.2534570518581379e+18,8,12,1.5,1,2,8,0
1.2534575050564877e+18,2,7,3.5,3,4,2,0
1.2534667670705477e+18,3,12,4.0,3,5,3,0
1.2534781468622715e+18,1,3,3.0,3,3,1,0
1.2534892693415304e+18,1,7,7.0,7,7,1,0
1.253506504237119e+18,3,8,2.6666666666666665,1,4,3,0
1.2535138086353152e+18,1,3,3.0,3,3,1,0
1.2535160309703729e+18,9,67,7.444444444444445,6,9,4,5
1.2535194243498312e+18,1,2,2.0,2,2,1,0
1.2535254208827996e+18,4,6,1.5,1,3,4,0
1.2535778435342607e+18,13,53,4.076923076923077,3,6,13,0
1.253642607837316e+18,21,30,1.4285714285714286,1,3,21,0
1.2536459904497723e+18,6,16,2.6666666666666665,1,4,6,0
1.253687890325954e+18,15,73,4.866666666666666,2,7,15,0
1.2537565619687347e+18,6,45,7.5,6,8,2,4
1.2537664054132513e+18,12,85,7.083333333333333,6,9,10,2
1.2538066759534344e+18,1,4,4.0,4,4,1,0
1.253826453446871e+18,6,41,6.833333333333333,5,8,4,2
1.2541068077171958e+18,3,10,3.3333333333333335,3,4,3,0
1.2541109626190925e+18,14,109,7.785714285714286,6,9,6,8
1.254116219917431e+18,1,4,4.0,4,4,1,0
1.2541268281398536e+18,1,3,3.0,3,3,1,0
1.2541386585027113e+18,19,31,1.631578947368421,1,4,19,0
1.254147532691796e+18,2,19,9.5,8,11,0,2
1.2541852764190444e+18,26,131,5.038461538461538,2,7,26,0
1.2541932599389809e+18,1,6,6.0,6,6,1,0
1.2542043235513674e+18,10,94,9.4,8,10,0,10
1.2542200143945933e+18,10,71,7.1,6,8,8,2
1.2542216214489805e+18,9,25,2.7777777777777777,1,5,9,0
1.2542580566505894e+18,4,6,1.5,1,2,4,0
1.2543068223446185e+18,3,22,7.333333333333333,6,8,1,2
1.2543194395309294e+18,24,50,2.0833333333333335,1,4,24,0
1.2543293046332065e+18,2,7,3.5,3,4,2,0
1.254332560340126e+18,31,45,1.4516129032258065,1,3,31,0
1.2543735944952028e+18,33,164,4.96969696969697,3,6,33,0
1.2544532864098463e+18,2,11,5.5,5,6,2,0
1.2545514782356155e+18,3,13,4.333333333333333,3,5,3,0
1.2546272269679898e+18,31,123,3.967741935483871,2,6,31,0
1.2546739140571622e+18,4,11,2.75,2,4,4,0
1.2547801630196913e+18,2,4,2.0,1,3,2,0
1.254788215752699e+18,2,12,6.0,2,10,1,1
1.254810304733255e+18,14,25,1.7857142857142858,1,3,14,0
1.2548792393073134e+18,1,7,7.0,7,7,1,0
1.2548896461385162e+18,2,18,9.0,9,9,0,2
1.2548925877685944e+18,10,60,6.0,4,8,9,1
1.2549235190174753e+18,8,15,1.875,1,3,8,0
1.2549299356677514e+18,14,33,2.357142857142857,1,4,14,0
1.2549299543042557e+18,1,4,4.0,4,4,1,0
1.2549545951058276e+18,1,9,9.0,9,9,0,1
1.2550162863625664e+18,11,76,6.909090909090909,4,8,7,4
1.255019559418852e+18,25,188,7.52,2,10,9,16
1.2550222621788664e+18,4,28,7.0,6,8,3,1
1.255024298615574e+18,4,7,1.75,1,3,4,0
1.2550253112607424e+18,5,14,2.8,1,4,5,0
1.255026920684474e+18,11,38,3.4545454545454546,1,5,11,0
1.2550300256936735e+18,9,27,3.0,2,5,9,0
1.2550546812377485e+18,19,77,4.052631578947368,2,6,19,0
1.2550565726643855e+18,11,99,9.0,8,11,0,11
1.2550634312784906e+18,1,4,4.0,4,4,1,0
1.2551184928083643e+18,8,17,2.125,1,4,8,0
1.2551234418937083e+18,8,26,3.25,2,5,8,0
1.2551861516945467e+18,35,53,1.5142857142857142,1,3,35,0
1.2553193864392366e+18,1,10,10.0,10,10,0,1
1.2554344003550725e+18,39,183,4.6923076923076925,3,7,39,0
1.2555877216021617e+18,3,26,8.666666666666666,8,9,0,3
1.2556027993570614e+18,16,82,5.125,3,7,16,0
1.2556248626805117e+18,15,73,4.866666666666666,3,6,15,0
1.255779196996315e+18,24,113,4.708333333333333,3,6,24,0
1.25582691344856e+18,1,9,9.0,9,9,0,1
1.2558572739866394e+18,11,52,4.7272727272727275,4,7,11,0
1.2563048383910495e+18,14,67,4.785714285714286,2,7,14,0
1.2563054590177418e+18,22,156,7.090909090909091,5,9,15,7
1.2563415658552082e+18,6,11,1.8333333333333333,1,3,6,0
1.2563588994568586e+18,1,4,4.0,4,4,1,0
1.2563727930410573e+18,1,1,1.0,1,1,1,0
1.2564019098561856e+18,23,115,5.0,3,7,23,0
1.2564497307649498e+18,5,27,5.4,4,7,5,0
1.256461530630217e+18,7,16,2.2857142857142856,1,3,7,0
1.2564843736203592e+18,10,64,6.4,3,8,8,2
1.256565889910608e+18,24,31,1.2916666666666667,1,4,24,0
1.2566523169604877e+18,13,59,4.538461538461538,3,6,13,0
1.2566610907197064e+18,2,7,3.5,3,4,2,0
1.2567074002875387e+18,27,265,9.814814814814815,3,12,1,26
1.256733130074025e+18,1,2,2.0,2,2,1,0
1.256764821797499e+18,1,9,9.0,9,9,0,1
1.257005236169898e+18,3,6,2.0,2,2,3,0
1.2570194890127017e+18,21,138,6.571428571428571,2,9,15,6
1.257057114501379e+18,22,44,2.0,1,4,22,0
1.2570726680567283e+18,1,9,9.0,9,9,0,1
1.2571105551221435e+18,1,11,11.0,11,11,0,1
1.2571454408774136e+18,12,18,1.5,1,3,12,0
1.2571525889281823e+18,3,7,2.3333333333333335,2,3,3,0
1.2571973849828209e+18,35,69,1.9714285714285715,1,5,35,0
1.257226215698265e+18,5,47,9.4,8,11,0,5
1.2572348044004357e+18,1,1,1.0,1,1,1,0
1.25724708780525e+18,9,84,9.333333333333334,2,11,1,8
1.2572851807882547e+18,11,31,2.8181818181818183,1,4,11,0
1.2572911125847818e+18,2,8,4.0,4,4,2,0
1.2572934200029658e+18,14,108,7.714285714285714,6,10,8,6
1.2573208352910203e+18,11,61,5.545454545454546,2,7,11,0
1.2573339210312238e+18,2,6,3.0,3,3,2,0
1.2577067022566528e+18,3,26,8.666666666666666,6,11,1,2
1.257779649044409e+18,5,11,2.2,1,4,5,0
1.2577845366289144e+18,15,127,8.466666666666667,7,10,3,12
1.2577862253704824e+18,10,50,5.0,2,6,10,0
1.2578165838258332e+18,11,42,3.8181818181818183,1,5,11,0
1.2578315124459418e+18,9,53,5.888888888888889,4,8,8,1
1.2578398812336842e+18,1,9,9.0,9,9,0,1
1.2578593950083779e+18,13,78,6.0,4,8,12,1
1.2578667538349153e+18,21,119,5.666666666666667,4,7,21,0
1.2578714047850202e+18,7,43,6.142857142857143,5,8,6,1
1.2578762887104015e+18,1,7,7.0,7,7,1,0
1.2578798194053555e+18,20,144,7.2,5,9,13,7
1.2578811234740352e+18,1,7,7.0,7,7,1,0
1.2579133159825231e+18,21,206,9.80952380952381,8,13,0,21
1.2579175339177636e+18,2,8,4.0,4,4,2,0
1.2579622320058112e+18,3,10,3.3333333333333335,2,4,3,0
1.257971349476425e+18,3,23,7.666666666666667,7,8,1,2
1.2579903519056888e+18,41,345,8.414634146341463,2,11,7,34
1.2580647264903596e+18,14,33,2.357142857142857,1,4,14,0
1.2581533454936525e+18,24,47,1.9583333333333333,1,4,24,0
1.258406105203097e+18,7,29,4.142857142857143,2,5,7,0
1.2584300805717486e+18,3,23,7.666666666666667,7,8,1,2
1.2584323360535222e+18,1,8,8.0,8,8,0,1
1.25844397722421e+18,1,7,7.0,7,7,1,0
1.2584462943350513e+18,1,9,9.0,9,9,0,1
1.2584542535665004e+18,10,49,4.9,3,6,10,0
1.25845765974093e+18,2,18,9.0,9,9,0,2
1.2584659984844813e+18,5,34,6.8,2,9,2,3
1.2584699112018627e+18,9,83,9.222222222222221,2,11,1,8
1.2584794155467448e+18,9,47,5.222222222222222,3,7,9,0
1.2584803502181294e+18,1,6,6.0,6,6,1,0
1.2584895175435154e+18,14,84,6.0,5,8,13,1
1.258528893388055e+18,3,3,1.0,1,1,3,0
1.2585342311747377e+18,1,2,2.0,2,2,1,0
1.2585727453057546e+18,32,63,1.96875,1,3,32,0
1.2586320038396444e+18,2,12,6.0,6,6,2,0
1.258659131092236e+18,1,2,2.0,2,2,1,0
1.2586734421610496e+18,3,5,1.6666666666666667,1,3,3,0
1.2586836493100961e+18,10,96,9.6,8,11,0,10
1.2586958282931996e+18,2,9,4.5,4,5,2,0
1.2587270611461688e+18,20,103,5.15,4,6,20,0
1.258727752296297e+18,3,16,5.333333333333333,5,6,3,0
1.2587374250415247e+18,18,62,3.4444444444444446,2,5,18,0
1.2587579830598141e+18,2,14,7.0,6,8,1,1
1.259111193497427e+18,3,17,5.666666666666667,5,7,3,0
1.2591675830525396e+18,3,22,7.333333333333333,7,8,2,1
1.2592121099411878e+18,6,27,4.5,3,6,6,0
1.2592233342335212e+18,3,22,7.333333333333333,7,8,2,1
1.2592974928027287e+18,9,58,6.444444444444445,5,7,9,0
1.2592979195126118e+18,13,124,9.538461538461538,6,12,1,12
1.2593406744857613e+18,22,154,7.0,5,9,14,8
1.2593470741723052e+18,7,25,3.5714285714285716,1,5,7,0
1.2593513618507443e+18,13,109,8.384615384615385,7,10,2,11
1.2593788447136622e+18,3,21,7.0,7,7,3,0
1.2593850658597258e+18,21,54,2.5714285714285716,1,4,21,0
1.2594233299800369e+18,12,91,7.583333333333333,4,9,5,7
1.2594299575892577e+18,15,76,5.066666666666666,4,6,15,0
1.259457009548155e+18,5,40,8.0,7,9,2,3
1.259459582075764e+18,7,35,5.0,3,6,7,0
1.2594668946189225e+18,16,107,6.6875,3,9,11,5
1.259479813612282e+18,4,4,1.0,1,1,4,0
1.259491986659096e+18,7,18,2.5714285714285716,1,3,7,0
1.2594963066341806e+18,6,16,2.6666666666666665,2,4,6,0
1.2595615551573693e+18,3,5,1.6666666666666667,1,2,3,0
1.2597363681408412e+18,4,12,3.0,1,5,4,0
1.2598610975459249e+18,1,5,5.0,5,5,1,0
1.2599163644456865e+18,15,41,2.7333333333333334,2,4,15,0
1.2599168918135619e+18,14,66,4.714285714285714,3,6,14,0
1.2599187163091095e+18,17,79,4.647058823529412,3,7,17,0
1.2599188804362621e+18,1,10,10.0,10,10,0,1
1.2599467609101734e+18,1,10,10.0,10,10,0,1
1.2599495683871828e+18,1,8,8.0,8,8,0,1
1.2599728505298762e+18,3,14,4.666666666666667,4,5,3,0
1.2600739682898604e+18,2,6,3.0,2,4,2,0
1.2601166808822784e+18,3,7,2.3333333333333335,1,3,3,0
1.2601745320576307e+18,7,63,9.0,7,11,1,6
1.260253592903406e+18,14,72,5.142857142857143,3,7,14,0
1.2606900459320248e+18,1,8,8.0,8,8,0,1
1.2607440386718559e+18,29,171,5.896551724137931,4,8,27,2
1.2607623418415626e+18,8,13,1.625,1,2,8,0
1.260764829316094e+18,13,23,1.7692307692307692,1,3,13,0
1.260854518214803e+18,16,87,5.4375,4,7,16,0
1.260876014216394e+18,4,13,3.25,2,5,4,0
1.260898569165769e+18,9,69,7.666666666666667,5,10,3,6
1.2610385732895972e+18,2,17,8.5,7,10,1,1
1.2613109568180447e+18,7,37,5.285714285714286,5,6,7,0
1.2614436488384387e+18,2,14,7.0,7,7,2,0
1.2614787526929556e+18,15,78,5.2,3,8,14,1
1.2614827627446203e+18,2,13,6.5,6,7,2,0
1.2615160290291725e+18,13,131,10.076923076923077,9,11,0,13
1.261517529364193e+18,3,9,3.0,2,4,3,0
1.261522446421399e+18,11,84,7.636363636363637,6,10,5,6
1.2615491764773824e+18,22,41,1.8636363636363635,1,5,22,0
1.2615753786693658e+18,7,58,8.285714285714286,8,9,0,7
1.261610677816238e+18,32,286,8.9375,2,13,6,26
1.2616443768415662e+18,6,13,2.1666666666666665,1,3,6,0
1.2616850434397724e+18,11,59,5.363636363636363,4,7,11,0
1.2616899762568852e+18,1,7,7.0,7,7,1,0
1.2616934534133816e+18,1,8,8.0,8,8,0,1
1.261700386050551e+18,1,1,1.0,1,1,1,0
1.262025672226528e+18,2,11,5.5,5,6,2,0
1.26205126558021e+18,5,23,4.6,4,5,5,0
1.2620753085138982e+18,6,42,7.0,6,8,4,2
1.2621155596208364e+18,13,61,4.6923076923076925,3,6,13,0
1.262117355502394e+18,11,56,5.090909090909091,3,6,11,0
1.262136969291037e+18,4,10,2.5,2,3,4,0
1.2621372011789816e+18,10,91,9.1,4,11,1,9
1.2621584861644877e+18,15,92,6.133333333333334,3,8,13,2
1.262162585861975e+18,3,32,10.666666666666666,10,11,0,3
1.262169021869564e+18,16,45,2.8125,1,5,16,0
1.262181720949169e+18,10,16,1.6,1,3,10,0
1.2621901379557294e+18,15,78,5.2,2,8,14,1
1.2621905485082168e+18,5,16,3.2,2,4,5,0
1.262222323859062e+18,10,20,2.0,1,3,10,0
1.262223548108882e+18,11,59,5.363636363636363,3,7,11,0
1.262246299608579e+18,3,17,5.666666666666667,4,7,3,0
1.262258460240349e+18,15,49,3.2666666666666666,1,6,15,0
1.2622635221876672e+18,2,13,6.5,5,8,1,1
1.2623344944356785e+18,2,11,5.5,5,6,2,0
1.2623439344931003e+18,2,16,8.0,7,9,1,1
1.26235338142917e+18,1,10,10.0,10,10,0,1
1.2623740083997184e+18,13,26,2.0,1,4,13,0
1.2624233852112568e+18,5,18,3.6,3,4,5,0
1.2624633262902572e+18,2,9,4.5,4,5,2,0
1.2624709201432177e+18,10,66,6.6,5,8,9,1
1.2627601187985472e+18,1,4,4.0,4,4,1,0
1.262763265847683e+18,11,54,4.909090909090909,3,6,11,0
1.2627698098761073e+18,1,8,8.0,8,8,0,1
1.2627807162683894e+18,88,184,2.090909090909091,1,5,88,0
1.2627882131938493e+18,1,3,3.0,3,3,1,0
1.2627916528925258e+18,13,27,2.076923076923077,1,4,13,0
1.2627990545991101e+18,5,18,3.6,3,4,5,0
1.2628050655176847e+18,1,3,3.0,3,3,1,0
1.2628666962634716e+18,12,61,5.083333333333333,4,7,12,0
1.2629013433503278e+18,1,3,3.0,3,3,1,0
1.262912585262157e+18,1,2,2.0,2,2,1,0
1.262969566892002e+18,18,29,1.6111111111111112,1,3,18,0
1.262969956367632e+18,7,13,1.8571428571428572,1,3,7,0
1.2629916072844173e+18,1,11,11.0,11,11,0,1
1.2630027969203814e+18,1,2,2.0,2,2,1,0
1.2630053515704087e+18,15,118,7.866666666666666,6,10,6,9
1.26301827952839e+18,7,16,2.2857142857142856,2,3,7,0
1.2630329883849152e+18,16,47,2.9375,1,4,16,0
1.2630543762290289e+18,5,36,7.2,3,9,2,3
1.2631300852918454e+18,13,99,7.615384615384615,6,10,7,6
1.2631431886077868e+18,25,102,4.08,3,6,25,0
1.263148868246099e+18,16,31,1.9375,1,3,16,0
1.2634141733849667e+18,2,8,4.0,3,5,2,0
1.2635708430705746e+18,3,5,1.6666666666666667,1,2,3,0
1.2635884553726792e+18,2,9,4.5,4,5,2,0
1.2636087354258936e+18,9,41,4.555555555555555,2,6,9,0
1.2636203143140795e+18,1,2,2.0,2,2,1,0
1.2636591423392466e+18,6,44,7.333333333333333,6,8,3,3
1.2636977120711276e+18,3,11,3.6666666666666665,3,4,3,0
1.26370119797161e+18,9,20,2.2222222222222223,1,4,9,0
1.2637182299920338e+18,26,175,6.730769230769231,3,9,19,7
1.2637365242586865e+18,7,49,7.0,6,9,6,1
1.263750693244864e+18,3,24,8.0,8,8,0,3
1.263809179498948e+18,8,14,1.75,1,3,8,0
1.263823599019916e+18,16,96,6.0,4,9,14,2
1.2638835363031565e+18,4,34,8.5,8,9,0,4
1.2638985440141478e+18,33,130,3.9393939393939394,2,6,33,0
1.2639064931963057e+18,1,3,3.0,3,3,1,0
1.2639076213018266e+18,2,12,6.0,5,7,2,0
1.2642153857265267e+18,2,2,1.0,1,1,2,0
1.2642791459705065e+18,11,69,6.2727272727272725,5,7,11,0
1.2642918180927363e+18,14,38,2.7142857142857144,1,4,14,0
1.2642942345045944e+18,4,27,6.75,5,8,3,1
1.2642970776654385e+18,2,13,6.5,6,7,2,0
1.264300220494636e+18,6,35,5.833333333333333,5,8,5,1
1.2643024228377405e+18,2,4,2.0,1,3,2,0
1.2643226165068232e+18,8,13,1.625,1,3,8,0
1.2643313074309683e+18,15,61,4.066666666666666,2,6,15,0
1.2643654286813366e+18,3,16,5.333333333333333,5,6,3,0
1.2643669999557486e+18,24,66,2.75,1,5,24,0
1.2643770182832538e+18,3,23,7.666666666666667,7,8,1,2
1.2643783212830966e+18,3,16,5.333333333333333,5,6,3,0
1.264388761312408e+18,2,12,6.0,5,7,2,0
1.2643989123840325e+18,22,59,2.6818181818181817,1,5,22,0
1.264417336695543e+18,5,14,2.8,2,5,5,0
1.2644202433830925e+18,25,47,1.88,1,3,25,0
1.2644235669363292e+18,4,33,8.25,7,9,1,3
1.2644571885218368e+18,1,7,7.0,7,7,1,0
1.2644824110437215e+18,1,5,5.0,5,5,1,0
1.2644998590434926e+18,1,2,2.0,2,2,1,0
1.2645121049380111e+18,7,56,8.0,7,10,2,5
1.2645813838386212e+18,5,48,9.6,8,12,0,5
1.264585336159672e+18,4,12,3.0,2,4,4,0
1.264595574456077e+18,16,119,7.4375,6,9,8,8
1.2646045227440594e+18,4,12,3.0,3,3,4,0
1.2646071426243773e+18,2,10,5.0,3,7,2,0
1.264663010360459e+18,18,161,8.944444444444445,6,10,3,15
1.2649106119322998e+18,8,21,2.625,1,4,8,0
1.2649402790908616e+18,1,9,9.0,9,9,0,1
1.264992745314996e+18,1,9,9.0,9,9,0,1
1.265003619966436e+18,1,8,8.0,8,8,0,1
1.2650130550311654e+18,1,4,4.0,4,4,1,0
1.2650146994020733e+18,1,3,3.0,3,3,1,0
1.2650233543888983e+18,3,8,2.6666666666666665,2,3,3,0
1.2650335895072376e+18,3,29,9.666666666666666,9,10,0,3
1.2650432438593482e+18,1,6,6.0,6,6,1,0
1.2650467996622996e+18,2,5,2.5,2,3,2,0
1.2650678590736146e+18,1,10,10.0,10,10,0,1
1.2650799704060375e+18,2,10,5.0,4,6,2,0
1.2651410185501284e+18,8,50,6.25,4,8,6,2
1.2651513260032338e+18,10,55,5.5,2,7,10,0
1.2651623918516247e+18,13,15,1.1538461538461537,1,2,13,0
1.2651670195470643e+18,8,11,1.375,1,3,8,0
1.2653013790778447e+18,1,7,7.0,7,7,1,0
1.2653363336302438e+18,1,8,8.0,8,8,0,1
1.265354999212597e+18,12,16,1.3333333333333333,1,2,12,0
1.2656964210363843e+18,2,17,8.5,8,9,0,2
1.265720225767653e+18,1,9,9.0,9,9,0,1
1.2657958112195866e+18,3,8,2.6666666666666665,1,4,3,0
1.2658401108809546e+18,12,22,1.8333333333333333,1,4,12,0
1.2658432530429844e+18,13,65,5.0,3,6,13,0
1.265885314532736e+18,1,10,10.0,10,10,0,1
1.265888107102495e+18,7,65,9.285714285714286,5,11,1,6
1.265938716712683e+18,1,3,3.0,3,3,1,0
1.2659445751626783e+18,6,8,1.3333333333333333,1,2,6,0
1.265971476922637e+18,10,71,7.1,5,10,6,4
1.266001916857208e+18,1,3,3.0,3,3,1,0
1.2660534655140652e+18,9,19,2.111111111111111,1,4,9,0
1.2661084532988475e+18,2,4,2.0,1,3,2,0
1.2664277873642762e+18,1,7,7.0,7,7,1,0
1.2664306966057738e+18,1,7,7.0,7,7,1,0
1.2665163452256893e+18,1,6,6.0,6,6,1,0
1.2665476093343173e+18,4,29,7.25,5,9,2,2
1.2665566283312146e+18,16,79,4.9375,3,7,16,0
1.2665844650046505e+18,5,16,3.2,2,4,5,0
1.266726077831349e+18,9,15,1.6666666666666667,1,3,9,0
1.266734361317547e+18,4,27,6.75,5,8,3,1
1.2667708236313132e+18,21,100,4.761904761904762,3,6,21,0
1.2667799600830083e+18,6,29,4.833333333333333,4,6,6,0
1.266792186415049e+18,7,61,8.714285714285714,7,10,1,6
1.266811517880089e+18,9,14,1.5555555555555556,1,3,9,0
1.2668200417290627e+18,6,16,2.6666666666666665,2,4,6,0
1.2668299773890373e+18,22,190,8.636363636363637,7,10,4,18
1.2668846279012372e+18,5,10,2.0,1,3,5,0
1.266913930354376e+18,5,6,1.2,1,2,5,0
1.267134916355392e+18,16,30,1.875,1,3,16,0
1.267148822379894e+18,4,14,3.5,2,5,4,0
1.267188407245254e+18,1,6,6.0,6,6,1,0
1.267197309971814e+18,1,7,7.0,7,7,1,0
1.267222506326686e+18,2,18,9.0,9,9,0,2
1.267231786325108e+18,1,2,2.0,2,2,1,0
1.2672431269547236e+18,14,47,3.357142857142857,1,5,14,0
1.2672616412954847e+18,6,9,1.5,1,2,6,0
1.2672868684490173e+18,3,22,7.333333333333333,7,8,2,1
1.2673006270828682e+18,10,64,6.4,5,7,10,0
1.2673119967637402e+18,1,7,7.0,7,7,1,0
1.267340966193587e+18,1,6,6.0,6,6,1,0
1.267341649383565e+18,1,7,7.0,7,7,1,0
1.2674122194835459e+18,21,80,3.8095238095238093,2,6,21,0
1.2674435100222845e+18,10,17,1.7,1,3,10,0
1.267486937386526e+18,8,14,1.75,1,3,8,0
1.2674935231983222e+18,1,6,6.0,6,6,1,0
1.2675401194533535e+18,8,48,6.0,3,9,7,1
1.2677682548379052e+18,5,36,7.2,6,8,3,2
1.2678192488670825e+18,1,4,4.0,4,4,1,0
1.2678222631495995e+18,1,9,9.0,9,9,0,1
1.2678536772644872e+18,3,6,2.0,1,4,3,0
1.2679130108581038e+18,12,24,2.0,1,4,12,0
1.2679315323762964e+18,4,33,8.25,6,9,1,3
1.267944685620235e+18,2,3,1.5,1,2,2,0
1.2679478063752128e+18,1,4,4.0,4,4,1,0
1.2679707258318554e+18,17,119,7.0,3,9,11,6
1.2679868525372099e+18,10,40,4.0,3,6,10,0
1.2679910373314895e+18,20,106,5.3,4,7,20,0
1.2680043830699994e+18,2,13,6.5,6,7,2,0
1.2680100244923256e+18,1,9,9.0,9,9,0,1
1.26802620412646e+18,10,31,3.1,1,4,10,0
1.2680358772005358e+18,6,11,1.8333333333333333,1,5,6,0
1.268062742838659e+18,1,2,2.0,2,2,1,0
1.26808333518484e+18,2,9,4.5,4,5,2,0
1.2680848712622083e+18,18,34,1.8888888888888888,1,4,18,0
1.268087772959484e+18,21,112,5.333333333333333,3,7,21,0
1.2680890502893788e+18,7,52,7.428571428571429,4,9,2,5
1.2681061559875581e+18,7,38,5.428571428571429,4,7,7,0
1.2681138213501432e+18,9,57,6.333333333333333,5,8,8,1
1.2682705310219912e+18,7,37,5.285714285714286,5,7,7,0
1.2683342273020995e+18,9,45,5.0,3,7,9,0
1.268549873160746e+18,11,104,9.454545454545455,3,12,1,10
1.2685702570859886e+18,2,18,9.0,9,9,0,2
1.2685754024379374e+18,2,4,2.0,2,2,2,0
1.2686077859702141e+18,2,4,2.0,1,3,2,0
1.268611809587873e+18,1,2,2.0,2,2,1,0
1.2686697760306634e+18,1,5,5.0,5,5,1,0
1.2686875897263276e+18,1,10,10.0,10,10,0,1
1.2687100344296458e+18,3,23,7.666666666666667,6,9,1,2
1.2687190747880535e+18,11,77,7.0,5,9,8,3
1.2687368883632998e+18,12,28,2.3333333333333335,1,5,12,0
1.2687876390378609e+18,6,10,1.6666666666666667,1,3,6,0
1.2688316409123026e+18,29,150,5.172413793103448,3,7,29,0
1.2688406094606308e+18,9,24,2.6666666666666665,1,4,9,0
1.2688419319118705e+18,7,57,8.142857142857142,6,9,2,5
1.2688663866631214e+18,16,75,4.6875,3,7,16,0
1.268902921652141e+18,4,9,2.25,1,3,4,0
1.2690007074971937e+18,21,62,2.9523809523809526,1,5,21,0
1.2691514469119393e+18,1,2,2.0,2,2,1,0
1.2693040630479805e+18,2,13,6.5,6,7,2,0
1.269306218873072e+18,5,11,2.2,2,3,5,0
1.2693274158330158e+18,2,4,2.0,2,2,2,0
1.2693360653405181e+18,1,7,7.0,7,7,1,0
1.2693479408256732e+18,1,7,7.0,7,7,1,0
1.269355989618112e+18,6,41,6.833333333333333,5,9,5,1
1.2693684771363016e+18,15,121,8.066666666666666,5,10,4,11
1.2694231104038193e+18,2,15,7.5,7,8,1,1
1.269425272122744e+18,2,15,7.5,7,8,1,1
1.2694256773265093e+18,4,7,1.75,1,3,4,0
1.269426978957143e+18,1,8,8.0,8,8,0,1
1.2694821961717066e+18,3,26,8.666666666666666,8,9,0,3
1.2694990954449428e+18,20,156,7.8,6,9,7,13
1.2695019306449738e+18,8,16,2.0,1,4,8,0
1.2695041887161672e+18,6,15,2.5,2,3,6,0
1.2695183720423913e+18,7,65,9.285714285714286,9,10,0,7
1.269527180766407e+18,2,7,3.5,3,4,2,0
1.2695369733757084e+18,5,16,3.2,2,5,5,0
1.269550977043447e+18,12,88,7.333333333333333,6,8,6,6
1.2695524177358154e+18,11,110,10.0,8,12,0,11
1.2695589615487278e+18,2,2,1.0,1,1,2,0
1.2695639989332337e+18,1,1,1.0,1,1,1,0
1.2695923116093647e+18,11,42,3.8181818181818183,2,6,11,0
1.2695934214013238e+18,2,7,3.5,3,4,2,0
1.269625865443786e+18,9,52,5.777777777777778,4,8,8,1
1.2696397022151808e+18,11,67,6.090909090909091,4,8,10,1
1.2696842357565256e+18,12,89,7.416666666666667,3,9,5,7
1.2696907254668462e+18,1,6,6.0,6,6,1,0
1.2697145849982822e+18,3,6,2.0,1,3,3,0
1.2698016394081554e+18,2,14,7.0,7,7,2,0
1.2700559580432394e+18,2,6,3.0,2,4,2,0
1.2701444721341724e+18,8,15,1.875,1,3,8,0
1.2701490377845368e+18,18,127,7.055555555555555,5,10,12,6
1.2701825435819164e+18,9,66,7.333333333333333,6,8,4,5
1.2701958028348516e+18,9,61,6.777777777777778,6,8,8,1
1.270195856146432e+18,4,9,2.25,1,4,4,0
1.270196804548775e+18,14,96,6.857142857142857,6,8,12,2
1.270197447157611e+18,13,95,7.3076923076923075,5,10,7,6
1.2701982667915817e+18,9,61,6.777777777777778,5,8,6,3
1.2702077337344264e+18,13,39,3.0,1,5,13,0
1.2702140089662656e+18,9,60,6.666666666666667,5,8,6,3
1.2702150026113615e+18,7,48,6.857142857142857,2,9,4,3
1.2702270817086807e+18,3,23,7.666666666666667,7,9,2,1
1.2702288032476772e+18,5,9,1.8,1,3,5,0
1.270233024829491e+18,6,11,1.8333333333333333,1,3,6,0
1.2702401576455012e+18,3,13,4.333333333333333,4,5,3,0
1.2702514980225859e+18,10,77,7.7,2,12,3,7
1.270260794529584e+18,10,20,2.0,1,3,10,0
1.2702986212294351e+18,12,20,1.6666666666666667,1,3,12,0
1.270313474178548e+18,3,21,7.0,4,9,1,2
1.2703159528052198e+18,2,16,8.0,8,8,0,2
1.2703323903867927e+18,30,200,6.666666666666667,3,9,22,8
1.27034246390872e+18,3,18,6.0,5,7,3,0
1.2703472983481603e+18,9,10,1.1111111111111112,1,2,9,0
1.2703755091895964e+18,14,101,7.214285714285714,6,9,10,4
1.2707672514133773e+18,1,2,2.0,2,2,1,0
1.270802026150266e+18,13,54,4.153846153846154,2,6,13,0
1.2708352630213197e+18,3,10,3.3333333333333335,3,4,3,0
1.2708396269778378e+18,13,42,3.230769230769231,1,5,13,0
1.2708756704004398e+18,19,194,10.210526315789474,9,12,0,19
1.2709235221334426e+18,1,4,4.0,4,4,1,0
1.2709408501495596e+18,4,32,8.0,6,9,1,3
1.2709479963918817e+18,2,15,7.5,7,8,1,1
1.27094997078905e+18,1,6,6.0,6,6,1,0
1.2710024206994076e+18,17,168,9.882352941176471,4,12,1,16
1.271018783667385e+18,1,1,1.0,1,1,1,0
1.2710495739752468e+18,4,30,7.5,7,8,2,2
1.2711190891368934e+18,4,20,5.0,2,7,4,0
1.2711251379895652e+18,5,14,2.8,2,3,5,0
1.2711436303599939e+18,6,55,9.166666666666666,2,11,1,5
1.271392073714416e+18,2,10,5.0,5,5,2,0
1.2715060456553528e+18,4,5,1.25,1,2,4,0
1.2715372557108247e+18,14,109,7.785714285714286,6,9,4,10
1.2715900386967647e+18,12,74,6.166666666666667,5,7,12,0
1.271629021474617e+18,15,83,5.533333333333333,2,7,15,0
1.271678735430023e+18,2,3,1.5,1,2,2,0
1.271684754782083e+18,2,19,9.5,8,11,0,2
1.2717116821610163e+18,1,7,7.0,7,7,1,0
1.2717717915443528e+18,14,37,2.642857142857143,1,4,14,0
1.271774559345506e+18,1,9,9.0,9,9,0,1
1.2717765171809964e+18,11,64,5.818181818181818,4,7,11,0
1.2718176321076736e+18,2,13,6.5,6,7,2,0
1.271870842067359e+18,4,7,1.75,1,3,4,0
1.2719485528691694e+18,1,2,2.0,2,2,1,0
1.2719622498348196e+18,1,5,5.0,5,5,1,0
1.2721652006476334e+18,5,37,7.4,6,9,3,2
1.2722132445303096e+18,2,6,3.0,2,4,2,0
1.2722163653461862e+18,1,4,4.0,4,4,1,0
1.272344475035235e+18,13,84,6.461538461538462,5,8,12,1
1.2723545899381412e+18,2,8,4.0,4,4,2,0
1.2723585918132844e+18,2,4,2.0,1,3,2,0
1.2723685239709235e+18,3,23,7.666666666666667,7,8,1,2
1.272379379035007e+18,8,54,6.75,3,8,6,2
1.272389007709797e+18,10,86,8.6,7,10,1,9
1.2724726915030262e+18,2,12,6.0,6,6,2,0
1.272473512004929e+18,31,79,2.5483870967741935,1,4,31,0
1.272476287842633e+18,6,17,2.8333333333333335,2,4,6,0
1.2724777376777126e+18,2,15,7.5,7,8,1,1
1.2724847284650657e+18,4,18,4.5,4,6,4,0
1.2725074331901064e+18,22,109,4.954545454545454,3,7,22,0
1.2725305751890255e+18,22,29,1.3181818181818181,1,2,22,0
1.2725766414912952e+18,13,94,7.230769230769231,4,9,6,7
1.2725806751543506e+18,10,31,3.1,1,6,10,0
1.2725857903823905e+18,11,58,5.2727272727272725,3,7,11,0
1.2726109418705334e+18,1,9,9.0,9,9,0,1
1.272616450844602e+18,1,7,7.0,7,7,1,0
1.2728776988858396e+18,2,7,3.5,3,4,2,0
1.2728877782255854e+18,15,28,1.8666666666666667,1,3,15,0
1.2728896078666404e+18,1,8,8.0,8,8,0,1
1.2729326469181187e+18,14,102,7.285714285714286,6,8,9,5
1.272950001313025e+18,6,18,3.0,2,4,6,0
1.2730067203630666e+18,10,92,9.2,8,11,0,10
1.273011553132979e+18,9,64,7.111111111111111,6,8,6,3
1.2730179237557123e+18,10,47,4.7,3,6,10,0
1.2730245995403018e+18,4,29,7.25,6,8,2,2
1.2730360008875113e+18,3,25,8.333333333333334,8,9,0,3
1.2730422094001687e+18,9,63,7.0,6,8,6,3
1.2730875859076337e+18,11,93,8.454545454545455,7,10,1,10
1.2730925325385592e+18,22,186,8.454545454545455,3,10,3,19
1.2730940684538703e+18,13,100,7.6923076923076925,2,10,4,9
1.2731030836045102e+18,1,8,8.0,8,8,0,1
1.273116616828107e+18,11,30,2.727272727272727,1,4,11,0
1.2731417538850657e+18,6,28,4.666666666666667,2,6,6,0
1.2731659573626092e+18,2,7,3.5,3,4,2,0
1.2731716718218476e+18,10,76,7.6,3,10,4,6
1.273183587354453e+18,3,21,7.0,7,7,3,0
1.273184174094291e+18,2,12,6.0,6,6,2,0
1.2731954425425336e+18,1,2,2.0,2,2,1,0
1.2733116313896668e+18,1,4,4.0,4,4,1,0
1.2733568278319212e+18,18,119,6.611111111111111,5,9,13,5
1.2733620499693617e+18,2,4,2.0,1,3,2,0
1.2733827992086083e+18,30,204,6.8,3,9,19,11
1.2736811955325555e+18,4,36,9.0,8,11,0,4
1.2736861857897068e+18,6,52,8.666666666666666,7,10,1,5
1.2737016772771858e+18,1,9,9.0,9,9,0,1
1.2737078665668623e+18,5,36,7.2,7,8,4,1
1.2737143570977219e+18,4,9,2.25,2,3,4,0
1.2737184403809567e+18,2,14,7.0,7,7,2,0
1.2737368942403277e+18,1,3,3.0,3,3,1,0
1.273744825685749e+18,16,109,6.8125,3,9,10,6
1.2737777231651e+18,2,13,6.5,6,7,2,0
1.2738059651614272e+18,14,100,7.142857142857143,4,10,9,5
1.273817025059671e+18,14,114,8.142857142857142,7,10,5,9
1.2738612666678743e+18,10,26,2.6,1,6,10,0
1.273868076675083e+18,9,61,6.777777777777778,4,9,6,3
1.2738862302171853e+18,8,18,2.25,1,4,8,0
1.2739676475630446e+18,2,6,3.0,2,4,2,0
1.2739725463408197e+18,19,54,2.8421052631578947,1,4,19,0
1.273998939653064e+18,7,44,6.285714285714286,2,8,6,1
1.2740101641259617e+18,11,87,7.909090909090909,5,9,3,8
1.2741000072115052e+18,11,26,2.3636363636363638,1,4,11,0
1.2741237854163584e+18,2,10,5.0,2,8,1,1
1.2742214147606277e+18,19,39,2.0526315789473686,1,4,19,0
1.274374047373548e+18,1,8,8.0,8,8,0,1
1.2744094721349435e+18,3,12,4.0,2,5,3,0
1.2744228330731804e+18,3,22,7.333333333333333,7,8,2,1
1.2744242301747185e+18,1,1,1.0,1,1,1,0
1.2744260679094208e+18,4,6,1.5,1,3,4,0
1.274471237753758e+18,14,31,2.2142857142857144,1,4,14,0
1.2744759533483208e+18,4,29,7.25,6,8,2,2
1.2744924071862548e+18,7,12,1.7142857142857142,1,3,7,0
1.2744952687845763e+18,5,50,10.0,8,12,0,5
1.2745543670775854e+18,4,8,2.0,1,3,4,0
1.2746082434769298e+18,3,30,10.0,9,11,0,3
1.2746117800041574e+18,1,1,1.0,1,1,1,0
1.274661880429486e+18,12,38,3.1666666666666665,2,5,12,0
1.274671904478021e+18,11,106,9.636363636363637,7,13,1,10
1.2748175420197842e+18,4,6,1.5,1,3,4,0
1.2749600915166246e+18,2,18,9.0,8,10,0,2
1.2751791527609917e+18,14,43,3.0714285714285716,1,5,14,0
1.275203626869098e+18,3,9,3.0,3,3,3,0
1.2752448203276564e+18,6,18,3.0,2,4,6,0
1.2752936740907497e+18,14,86,6.142857142857143,4,8,13,1
1.2753559649293056e+18,2,10,5.0,2,8,1,1
1.275435390114682e+18,2,3,1.5,1,2,2,0
1.2758959947464038e+18,16,55,3.4375,2,5,16,0
1.2760934892455852e+18,2,3,1.5,1,2,2,0
1.2761704776848479e+18,5,41,8.2,6,9,1,4
1.2762572291952717e+18,3,18,6.0,6,6,3,0
1.276345247573919e+18,1,3,3.0,3,3,1,0
1.2766373738506214e+18,11,58,5.2727272727272725,4,7,11,0
1.2766706850958285e+18,4,28,7.0,6,8,3,1
1.2767233837290307e+18,1,5,5.0,5,5,1,0
1.2767666205241605e+18,4,25,6.25,5,7,4,0
1.2768051673898906e+18,3,3,1.0,1,1,3,0
1.2768232770418913e+18,5,15,3.0,2,4,5,0
1.2768324894329528e+18,2,2,1.0,1,1,2,0
1.2768687912949612e+18,10,53,5.3,4,7,10,0
1.2768997783056512e+18,11,31,2.8181818181818183,1,5,11,0
1.2769062791676995e+18,2,14,7.0,6,8,1,1
1.2769070403959073e+18,6,47,7.833333333333333,6,9,2,4
1.2769078967794437e+18,8,58,7.25,6,9,5,3
1.277025926421924e+18,11,25,2.272727272727273,1,4,11,0
1.2770929666965512e+18,25,51,2.04,1,4,25,0
1.2772756479116326e+18,8,66,8.25,6,9,1,7
1.2772816390886623e+18,8,61,7.625,2,10,3,5
1.2772860061025912e+18,12,79,6.583333333333333,5,8,11,1
1.2772899512135084e+18,9,75,8.333333333333334,7,10,2,7
1.2773145523098857e+18,18,42,2.3333333333333335,1,4,18,0
1.2773304518983585e+18,1,1,1.0,1,1,1,0
1.2773305874404805e+18,2,3,1.5,1,2,2,0
1.27733064073883e+18,4,5,1.25,1,2,4,0
1.2773306871420047e+18,5,8,1.6,1,3,5,0
1.277330697389015e+18,2,5,2.5,2,3,2,0
1.277330706400427e+18,3,21,7.0,7,7,3,0
1.277330735450775e+18,6,6,1.0,1,1,6,0
1.2773661357167078e+18,12,55,4.583333333333333,3,6,12,0
1.277369517402169e+18,2,3,1.5,1,2,2,0
1.2773735451741164e+18,26,236,9.076923076923077,5,11,1,25
1.277394030562189e+18,7,25,3.5714285714285716,2,5,7,0
1.2774307952198697e+18,20,92,4.6,2,7,20,0
1.2774327047899118e+18,1,1,1.0,1,1,1,0
1.2774335181437059e+18,11,68,6.181818181818182,5,8,9,2
1.2774928240894464e+18,2,21,10.5,10,11,0,2
1.2775020453683894e+18,7,25,3.5714285714285716,2,5,7,0
1.2775062784319757e+18,4,40,10.0,9,11,0,4
1.277511288287654e+18,7,16,2.2857142857142856,1,3,7,0
1.2775315054231327e+18,3,5,1.6666666666666667,1,2,3,0
1.2775322852997972e+18,10,31,3.1,2,5,10,0
1.2775420415983764e+18,8,8,1.0,1,1,8,0
1.2775693133949036e+18,1,8,8.0,8,8,0,1
1.2776248254617464e+18,11,82,7.454545454545454,3,10,3,8
1.2776419403855644e+18,10,13,1.3,1,2,10,0
1.2776660473709504e+18,9,13,1.4444444444444444,1,3,9,0
1.277686205089752e+18,5,10,2.0,1,3,5,0
1.2779819422028316e+18,6,60,10.0,9,11,0,6
1.2781039300192458e+18,2,6,3.0,3,3,2,0
1.2781777883913009e+18,1,2,2.0,2,2,1,0
1.2781804359680742e+18,6,12,2.0,1,3,6,0
1.278214545548579e+18,10,50,5.0,3,7,10,0
1.278239293255143e+18,10,68,6.8,6,8,8,2
1.2782920019618506e+18,25,164,6.56,2,9,20,5
1.2783222996863327e+18,1,10,10.0,10,10,0,1
1.2783364379669084e+18,12,18,1.5,1,2,12,0
1.2783590360510712e+18,9,22,2.4444444444444446,2,3,9,0
1.2783853405979466e+18,1,4,4.0,4,4,1,0
1.2784632273308216e+18,2,7,3.5,3,4,2,0
1.2784871761521247e+18,2,17,8.5,8,9,0,2
1.2785141601504369e+18,10,33,3.3,2,5,10,0
1.2786905614398072e+18,2,16,8.0,7,9,1,1
1.278766217599583e+18,2,17,8.5,8,9,0,2
1.278810962455091e+18,1,9,9.0,9,9,0,1
1.2788208510961367e+18,3,15,5.0,4,6,3,0
1.278826266796335e+18,5,32,6.4,5,7,5,0
1.278826510054352e+18,8,52,6.5,5,9,7,1
1.2788505437959608e+18,3,6,2.0,1,3,3,0
1.2788628457330522e+18,1,8,8.0,8,8,0,1
1.2788664014437903e+18,14,75,5.357142857142857,2,7,14,0
1.2788873093842289e+18,18,158,8.777777777777779,3,12,3,15
1.2789294343460772e+18,2,4,2.0,1,3,2,0
1.2789333410251425e+18,24,155,6.458333333333333,2,8,21,3
1.27894678945085e+18,1,7,7.0,7,7,1,0
1.278973999887368e+18,13,75,5.769230769230769,4,7,13,0
1.2789862100434614e+18,37,221,5.972972972972973,3,9,35,2
1.2790480270739894e+18,2,15,7.5,7,8,1,1
1.2790885054998697e+18,2,9,4.5,4,5,2,0
1.2791457916949335e+18,3,15,5.0,4,6,3,0
1.2791486667881487e+18,7,43,6.142857142857143,5,8,6,1
1.2792621317435858e+18,1,1,1.0,1,1,1,0
1.2794894404253391e+18,4,24,6.0,4,8,3,1
1.2794910914934254e+18,10,19,1.9,1,3,10,0
1.279501213459366e+18,2,4,2.0,1,3,2,0
1.2795395927055012e+18,1,7,7.0,7,7,1,0
1.2795401959090258e+18,2,16,8.0,8,8,0,2
1.2795410092551148e+18,1,8,8.0,8,8,0,1
1.279542127851394e+18,3,9,3.0,2,4,3,0
1.279546866169405e+18,4,29,7.25,7,8,3,1
1.2795811324585085e+18,1,8,8.0,8,8,0,1
1.2795819987602068e+18,12,30,2.5,1,4,12,0
1.2796139537360538e+18,1,8,8.0,8,8,0,1
1.2796206094589343e+18,4,38,9.5,7,11,1,3
1.279664279612226e+18,8,66,8.25,6,10,1,7
1.279670071435636e+18,3,7,2.3333333333333335,1,4,3,0
1.2796996934247122e+18,25,119,4.76,2,6,25,0
1.279722037192402e+18,6,37,6.166666666666667,4,9,5,1
1.279729689484725e+18,1,6,6.0,6,6,1,0
1.279738286323021e+18,1,2,2.0,2,2,1,0
1.279802388327067e+18,1,8,8.0,8,8,0,1
1.2799184079301427e+18,1,1,1.0,1,1,1,0
1.2799592289618532e+18,3,22,7.333333333333333,7,8,2,1
1.2801580721092675e+18,8,36,4.5,3,6,8,0
1.2803601688956127e+18,1,9,9.0,9,9,0,1
1.2803742153071345e+18,6,16,2.6666666666666665,1,5,6,0
1.2803819724334828e+18,5,14,2.8,1,4,5,0
1.28038438404148e+18,2,5,2.5,2,3,2,0
1.2803852147136118e+18,4,13,3.25,2,4,4,0
1.2803887266753377e+18,3,18,6.0,3,8,2,1
1.2804181999361285e+18,6,41,6.833333333333333,6,8,4,2
1.280444459089493e+18,5,26,5.2,4,6,5,0
1.2804586871710006e+18,1,3,3.0,3,3,1,0
1.2804636109613038e+18,2,15,7.5,7,8,1,1
1.2805407751203968e+18,1,8,8.0,8,8,0,1
1.2805935741879488e+18,4,28,7.0,5,8,2,2
1.2806981726912586e+18,17,81,4.764705882352941,3,6,17,0
1.2807147163004572e+18,1,3,3.0,3,3,1,0
1.280978763624524e+18,2,5,2.5,2,3,2,0
1.2809843462456896e+18,1,6,6.0,6,6,1,0
1.2809997544414477e+18,5,8,1.6,1,2,5,0
1.2810714813882952e+18,13,118,9.076923076923077,7,11,1,12
1.2810968433641723e+18,27,193,7.148148148148148,6,9,17,10
1.2811522588383575e+18,1,4,4.0,4,4,1,0
1.2812253217097347e+18,6,39,6.5,2,10,4,2
1.2812326708632228e+18,24,122,5.083333333333333,2,7,24,0
1.2813733866476357e+18,2,13,6.5,6,7,2,0
1.2816739542948803e+18,3,27,9.0,8,10,0,3
1.2817150107193073e+18,14,92,6.571428571428571,2,8,10,4
1.2817860956726915e+18,3,20,6.666666666666667,6,7,3,0
1.2818324212560008e+18,4,7,1.75,1,2,4,0
1.2818508493921807e+18,2,17,8.5,8,9,0,2
1.2818591935001585e+18,2,15,7.5,7,8,1,1
1.2819198806825114e+18,11,103,9.363636363636363,8,11,0,11
1.2819243458294044e+18,7,60,8.571428571428571,3,11,2,5
1.281934330808292e+18,1,1,1.0,1,1,1,0
1.281940931145469e+18,6,19,3.1666666666666665,2,5,6,0
1.2819490791861396e+18,3,22,7.333333333333333,7,8,2,1
1.2819684583964037e+18,5,36,7.2,6,8,3,2
1.281986367262146e+18,19,95,5.0,3,7,19,0
1.2819877662204938e+18,2,14,7.0,7,7,2,0
1.2820103489399314e+18,14,17,1.2142857142857142,1,2,14,0
1.2820248794486472e+18,8,24,3.0,1,5,8,0
1.282034453212966e+18,3,27,9.0,8,10,0,3
1.2820745060859817e+18,2,14,7.0,7,7,2,0
1.282358156670329e+18,2,5,2.5,1,4,2,0
1.2824244296854935e+18,38,200,5.2631578947368425,2,8,37,1
1.2824353933334922e+18,3,22,7.333333333333333,7,8,2,1
1.2824358811773932e+18,1,4,4.0,4,4,1,0
1.2824527440652127e+18,1,8,8.0,8,8,0,1
1.282514140898242e+18,10,79,7.9,6,11,6,4
1.282533172706602e+18,2,14,7.0,7,7,2,0
1.2825388831987996e+18,23,220,9.565217391304348,3,12,2,21
1.2825601769215442e+18,13,42,3.230769230769231,2,5,13,0
1.282575803703959e+18,1,3,3.0,3,3,1,0
1.2825771617493e+18,3,23,7.666666666666667,6,9,1,2
1.282607962030574e+18,1,10,10.0,10,10,0,1
1.2826197782822746e+18,18,180,10.0,8,11,0,18
1.2826228665791724e+18,4,9,2.25,2,3,4,0
1.2826388846951793e+18,1,4,4.0,4,4,1,0
1.2826400808968668e+18,2,6,3.0,2,4,2,0
1.2826424373113994e+18,4,10,2.5,2,3,4,0
1.2826515407558671e+18,10,19,1.9,1,3,10,0
1.2827182677693187e+18,11,54,4.909090909090909,4,7,11,0
1.28275589078218e+18,3,21,7.0,6,8,2,1
1.2827606515957622e+18,3,17,5.666666666666667,5,7,3,0
1.2828669098351677e+18,9,53,5.888888888888889,5,7,9,0
1.2830434603717921e+18,43,359,8.348837209302326,2,11,7,36
1.2831161397624927e+18,5,36,7.2,2,10,2,3
1.2831344489120276e+18,2,18,9.0,8,10,0,2
1.2831488488225864e+18,1,3,3.0,3,3,1,0
1.2831557599825137e+18,1,2,2.0,2,2,1,0
1.2831672975283953e+18,10,62,6.2,5,7,10,0
1.2831709503392707e+18,1,4,4.0,4,4,1,0
1.2831715611758339e+18,3,24,8.0,7,9,1,2
1.2831941220420644e+18,11,20,1.8181818181818181,1,3,11,0
1.2832090154538678e+18,1,2,2.0,2,2,1,0
1.2832092886662984e+18,1,2,2.0,2,2,1,0
1.2832183732129723e+18,1,6,6.0,6,6,1,0
1.283225748819867e+18,23,192,8.347826086956522,6,10,6,17
1.2832642628233764e+18,1,2,2.0,2,2,1,0
1.283289963058975e+18,1,9,9.0,9,9,0,1
1.2833557595143813e+18,6,37,6.166666666666667,3,8,5,1
1.2833562472532585e+18,7,16,2.2857142857142856,1,3,7,0
1.2833614653209034e+18,3,18,6.0,5,7,3,0
1.283371420954157e+18,5,10,2.0,2,2,5,0
1.2833760688512904e+18,2,14,7.0,7,7,2,0
1.283387118667441e+18,1,8,8.0,8,8,0,1
1.2833939367402414e+18,11,69,6.2727272727272725,4,9,9,2
1.2834222530593329e+18,1,2,2.0,2,2,1,0
1.2834788695917793e+18,4,29,7.25,6,8,2,2
1.283494942333397e+18,4,11,2.75,2,4,4,0
1.2835184809652746e+18,1,1,1.0,1,1,1,0
1.2835330156072727e+18,1,8,8.0,8,8,0,1
1.2835545194088492e+18,1,4,4.0,4,4,1,0
1.283814266479789e+18,23,165,7.173913043478261,5,9,15,8
1.283902065604456e+18,22,201,9.136363636363637,2,11,2,20
1.2839356269255805e+18,2,13,6.5,6,7,2,0
1.2839379309485292e+18,18,128,7.111111111111111,6,9,12,6
1.2839484416338355e+18,1,8,8.0,8,8,0,1
1.2839499677439e+18,24,234,9.75,5,12,1,23
1.2839566180073592e+18,6,43,7.166666666666667,6,8,4,2
1.283960344657908e+18,1,1,1.0,1,1,1,0
1.283967958465824e+18,2,6,3.0,2,4,2,0
1.2839751993190013e+18,11,33,3.0,1,5,11,0
1.2839940575545326e+18,23,184,8.0,2,10,4,19
1.2840133428382863e+18,6,13,2.1666666666666665,2,3,6,0
1.284019881426561e+18,8,17,2.125,1,3,8,0
1.284029645774442e+18,4,11,2.75,2,4,4,0
1.2840411246483894e+18,10,69,6.9,6,8,7,3
1.2840411999400504e+18,5,16,3.2,2,4,5,0
1.2840543913652726e+18,23,187,8.130434782608695,6,10,5,18
1.2840653922341522e+18,7,11,1.5714285714285714,1,3,7,0
1.28407013026103e+18,1,7,7.0,7,7,1,0
1.2840992098223235e+18,10,22,2.2,1,4,10,0
1.2841284059641684e+18,9,26,2.888888888888889,1,5,9,0
1.2841337046476518e+18,16,108,6.75,3,8,10,6
1.2841745158481802e+18,2,21,10.5,10,11,0,2
1.2841833885497874e+18,27,261,9.666666666666666,4,12,2,25
1.2841896826295823e+18,10,69,6.9,4,9,8,2
1.284234326698583e+18,2,14,7.0,6,8,1,1
1.284255063930518e+18,1,4,4.0,4,4,1,0
1.284265628279742e+18,1,3,3.0,3,3,1,0
1.2844900412812956e+18,9,67,7.444444444444445,6,9,5,4
1.2845716975522806e+18,1,4,4.0,4,4,1,0
1.2846128760248148e+18,1,8,8.0,8,8,0,1
1.2846189059231027e+18,1,4,4.0,4,4,1,0
1.284637072280156e+18,3,23,7.666666666666667,7,8,1,2
1.2846374038765693e+18,10,75,7.5,6,9,4,6
1.284637693252463e+18,11,79,7.181818181818182,5,9,6,5
1.2846379760355707e+18,7,48,6.857142857142857,4,8,5,2
1.2846980849460808e+18,2,15,7.5,7,8,1,1
1.284711379562356e+18,3,25,8.333333333333334,8,9,0,3
1.2847150139868672e+18,13,67,5.153846153846154,3,7,13,0
1.2847155414291384e+18,3,24,8.0,6,9,1,2
1.284730884478953e+18,19,71,3.736842105263158,2,6,19,0
1.2847457551431951e+18,3,27,9.0,8,10,0,3
1.2847519290308104e+18,1,2,2.0,2,2,1,0
1.2847550504655857e+18,2,18,9.0,9,9,0,2
1.2847571091496458e+18,2,18,9.0,8,10,0,2
1.2847582331006653e+18,1,5,5.0,5,5,1,0
1.2847592796603213e+18,1,7,7.0,7,7,1,0
1.2847616288839416e+18,1,4,4.0,4,4,1,0
1.2847659565463347e+18,1,8,8.0,8,8,0,1
1.2847683667516099e+18,3,26,8.666666666666666,8,9,0,3
1.2847740773352676e+18,3,11,3.6666666666666665,3,4,3,0
1.2847764239225564e+18,1,8,8.0,8,8,0,1
1.2847784137439516e+18,1,6,6.0,6,6,1,0
1.2847918963606387e+18,9,14,1.5555555555555556,1,3,9,0
1.2848501017316818e+18,4,30,7.5,7,8,2,2
1.2848675225913672e+18,5,39,7.8,6,9,2,3
1.285004183365643e+18,25,38,1.52,1,3,25,0
1.2850145074402194e+18,10,54,5.4,4,7,10,0
1.2853002942287846e+18,4,26,6.5,5,8,3,1
1.2853078457298944e+18,2,11,5.5,2,9,1,1
1.2853141478113974e+18,1,10,10.0,10,10,0,1
1.2853233679545075e+18,1,8,8.0,8,8,0,1
1.2853348201555174e+18,1,7,7.0,7,7,1,0
1.2853474979936271e+18,3,21,7.0,6,8,2,1
1.285389989864028e+18,4,28,7.0,6,8,3,1
1.285458587631702e+18,6,13,2.1666666666666665,1,3,6,0
1.2854644511305782e+18,12,67,5.583333333333333,4,8,11,1
1.285464538933195e+18,3,5,1.6666666666666667,1,2,3,0
1.2854765106317128e+18,1,3,3.0,3,3,1,0
1.285509946479686e+18,16,35,2.1875,1,4,16,0
1.2855272156637875e+18,5,19,3.8,3,5,5,0
1.2855313799254495e+18,11,19,1.7272727272727273,1,3,11,0
1.2855350604581184e+18,4,37,9.25,8,10,0,4
1.285578776667802e+18,1,4,4.0,4,4,1,0
1.2856112102423122e+18,1,7,7.0,7,7,1,0
1.2856448515513649e+18,2,8,4.0,4,4,2,0
1.2857213454823744e+18,8,28,3.5,2,5,8,0
1.28574713645781e+18,8,27,3.375,1,5,8,0
1.2860055859267077e+18,14,47,3.357142857142857,2,5,14,0
1.2860878427105667e+18,1,8,8.0,8,8,0,1
1.2861099235956273e+18,11,80,7.2727272727272725,2,9,5,6
1.2861720838265121e+18,10,58,5.8,4,7,10,0
1.2862063783230595e+18,16,33,2.0625,1,3,16,0
1.2863280692146698e+18,10,45,4.5,3,6,10,0
1.2863485945223846e+18,7,39,5.571428571428571,4,8,5,2
1.2867096999777423e+18,6,30,5.0,4,6,6,0
1.2867297064300221e+18,2,13,6.5,6,7,2,0
1.286877590261328e+18,1,3,3.0,3,3,1,0
1.2868904889735337e+18,1,12,12.0,12,12,0,1
1.2869107289149204e+18,16,50,3.125,2,5,16,0
1.2869398853058499e+18,8,51,6.375,5,8,7,1
1.2869496063671877e+18,2,2,1.0,1,1,2,0
1.2869851853847168e+18,4,5,1.25,1,2,4,0
1.2870028803655575e+18,10,20,2.0,1,4,10,0
1.2870034399313802e+18,9,11,1.2222222222222223,1,2,9,0
1.2870519245929805e+18,1,9,9.0,9,9,0,1
1.2870580620855982e+18,7,53,7.571428571428571,3,10,3,4
1.2871006555268805e+18,2,16,8.0,7,9,1,1
1.2871074472423296e+18,2,2,1.0,1,1,2,0
1.2871416543928061e+18,11,16,1.4545454545454546,1,4,11,0
1.287155160565053e+18,4,25,6.25,5,7,4,0
1.2874547244161324e+18,2,14,7.0,7,7,2,0
1.2875325165030868e+18,1,9,9.0,9,9,0,1
1.2875338661599936e+18,8,53,6.625,5,8,6,2
1.2875353900200666e+18,5,34,6.8,5,8,4,1
1.2875759841407593e+18,5,50,10.0,9,11,0,5
1.2875902988046277e+18,9,19,2.111111111111111,1,4,9,0
1.2876263154402788e+18,7,25,3.5714285714285716,2,5,7,0
1.2876536786301335e+18,8,10,1.25,1,2,8,0
1.2876739073605998e+18,4,8,2.0,1,3,4,0
1.2877047112379067e+18,5,14,2.8,2,4,5,0
1.2877281065269e+18,2,15,7.5,7,8,1,1
1.2877469524241964e+18,5,8,1.6,1,2,5,0
1.2877841301222423e+18,5,7,1.4,1,2,5,0
1.2878079781774316e+18,3,7,2.3333333333333335,2,3,3,0
1.2878491792918984e+18,1,3,3.0,3,3,1,0
1.2879070056813855e+18,4,31,7.75,7,8,1,3
1.288240061490387e+18,3,5,1.6666666666666667,1,2,3,0
1.2882555459324782e+18,7,19,2.7142857142857144,2,4,7,0
1.2883110366051663e+18,1,9,9.0,9,9,0,1
1.2883250444983296e+18,3,19,6.333333333333333,6,7,3,0
1.288325970002154e+18,1,10,10.0,10,10,0,1
1.288328747541094e+18,1,9,9.0,9,9,0,1
1.2883309124791485e+18,1,2,2.0,2,2,1,0
1.2883438696569492e+18,2,7,3.5,3,4,2,0
1.288348486810767e+18,1,9,9.0,9,9,0,1
1.2883551921435937e+18,2,11,5.5,5,6,2,0
1.2883569754323858e+18,1,5,5.0,5,5,1,0
1.2883698389942968e+18,2,4,2.0,2,2,2,0
1.2884053937867543e+18,6,37,6.166666666666667,5,8,5,1
1.2884230550292774e+18,12,112,9.333333333333334,3,13,1,11
1.2884342874190252e+18,24,170,7.083333333333333,5,10,15,9
1.2884672326457234e+18,13,92,7.076923076923077,6,8,10,3
1.2885014170285745e+18,2,11,5.5,4,7,2,0
1.2885379104004618e+18,2,12,6.0,5,7,2,0
1.2885938248288084e+18,10,24,2.4,1,4,10,0
1.2888441570269806e+18,10,69,6.9,6,8,8,2
1.2888535744922191e+18,4,31,7.75,7,9,2,2
1.2888910100625802e+18,7,19,2.7142857142857144,2,4,7,0
1.288911073676583e+18,3,28,9.333333333333334,9,10,0,3
1.2889285482321078e+18,1,2,2.0,2,2,1,0
1.2889392023981445e+18,4,8,2.0,1,3,4,0
1.2889415366643354e+18,6,16,2.6666666666666665,1,5,6,0
1.2889427482898511e+18,1,3,3.0,3,3,1,0
1.2889752826430098e+18,1,9,9.0,9,9,0,1
1.2889757575479493e+18,15,38,2.533333333333333,1,5,15,0
1.2889818413961644e+18,8,51,6.375,5,8,7,1
1.2889897853559695e+18,4,21,5.25,4,6,4,0
1.288990048132905e+18,1,7,7.0,7,7,1,0
1.2889976536132698e+18,17,90,5.294117647058823,3,8,16,1
1.2890015321668278e+18,1,1,1.0,1,1,1,0
1.2890078173823775e+18,1,2,2.0,2,2,1,0
1.289008968542408e+18,7,15,2.142857142857143,1,3,7,0
1.289023103275649e+18,1,3,3.0,3,3,1,0
1.2890288320228173e+18,3,29,9.666666666666666,9,10,0,3
1.2890516014473293e+18,3,21,7.0,6,8,2,1
1.2890516062321254e+18,1,4,4.0,4,4,1,0
1.2890564939402593e+18,2,7,3.5,3,4,2,0
1.289066262478218e+18,2,14,7.0,6,8,1,1
1.2890855167769024e+18,1,5,5.0,5,5,1,0
1.2891895399002104e+18,14,106,7.571428571428571,5,9,6,8
1.2891942667903386e+18,4,33,8.25,7,10,1,3
1.2891983953059e+18,4,7,1.75,1,3,4,0
1.2891994545954688e+18,3,5,1.6666666666666667,1,2,3,0
1.2892134070400307e+18,1,7,7.0,7,7,1,0
1.2892781368685988e+18,11,33,3.0,1,4,11,0
1.2893570321968133e+18,4,8,2.0,1,3,4,0
1.2893773530229033e+18,10,75,7.5,6,9,6,4
1.2893886464925043e+18,12,35,2.9166666666666665,2,4,12,0
1.2894124191863043e+18,21,84,4.0,2,6,21,0
1.2895964349676828e+18,2,10,5.0,5,5,2,0
1.289634393593579e+18,1,3,3.0,3,3,1,0
1.289647381429654e+18,2,6,3.0,3,3,2,0
1.2896638862603118e+18,3,16,5.333333333333333,5,6,3,0
1.2896694022765596e+18,12,20,1.6666666666666667,1,3,12,0
1.2896730671045494e+18,2,2,1.0,1,1,2,0
1.289675077212587e+18,2,5,2.5,2,3,2,0
1.2896815822533606e+18,2,3,1.5,1,2,2,0
1.2896849673717445e+18,1,7,7.0,7,7,1,0
1.2896854461429494e+18,3,20,6.666666666666667,6,8,2,1
1.2896875522861484e+18,3,23,7.666666666666667,7,8,1,2
1.2896942682241677e+18,2,9,4.5,4,5,2,0
1.2896971385136259e+18,1,2,2.0,2,2,1,0
1.289711457265569e+18,5,44,8.8,8,10,0,5
1.2897474214194127e+18,2,11,5.5,4,7,2,0
1.2897843537446413e+18,1,4,4.0,4,4,1,0
1.2898484214601408e+18,3,8,2.6666666666666665,1,5,3,0
1.2898586369235965e+18,7,37,5.285714285714286,4,6,7,0
1.2899019633089375e+18,7,54,7.714285714285714,6,9,3,4
1.2899038703982103e+18,2,5,2.5,2,3,2,0
1.2899068754004928e+18,5,15,3.0,2,4,5,0
1.2899313039008118e+18,24,117,4.875,3,7,24,0
1.2899977907269212e+18,11,13,1.1818181818181819,1,3,11,0
1.2900010477863808e+18,6,14,2.3333333333333335,1,3,6,0
1.2900122678849774e+18,7,15,2.142857142857143,1,3,7,0
1.2903350699491366e+18,2,17,8.5,8,9,0,2
1.290477216134545e+18,10,55,5.5,4,7,10,0
1.2905023663162056e+18,9,70,7.777777777777778,6,9,3,6
1.2905277642707638e+18,6,49,8.166666666666666,8,9,0,6
1.2905429697853926e+18,4,9,2.25,1,3,4,0
1.29055884992138e+18,1,5,5.0,5,5,1,0
1.2905621400725855e+18,1,10,10.0,10,10,0,1
1.290595140345044e+18,1,1,1.0,1,1,1,0
1.2906220979626365e+18,2,6,3.0,2,4,2,0
1.2906401458811162e+18,21,181,8.619047619047619,6,10,2,19
1.2906557792774922e+18,6,42,7.0,5,9,3,3
1.2906986467819003e+18,6,12,2.0,1,3,6,0
1.2907080678662287e+18,1,8,8.0,8,8,0,1
1.2910291807116593e+18,1,6,6.0,6,6,1,0
1.2910797687650545e+18,1,9,9.0,9,9,0,1
1.2910891181023798e+18,3,19,6.333333333333333,6,7,3,0
1.291120612284223e+18,6,15,2.5,2,3,6,0
1.2911769920493496e+18,1,9,9.0,9,9,0,1
1.29124485331402e+18,8,64,8.0,6,9,1,7
1.2912598198768845e+18,5,21,4.2,3,5,5,0
1.2913472413808878e+18,8,23,2.875,1,4,8,0
1.2914022111527148e+18,4,39,9.75,9,10,0,4
1.2914162125826967e+18,4,7,1.75,1,4,4,0
1.2914350451748001e+18,4,38,9.5,6,12,1,3
1.2914519199569997e+18,2,8,4.0,3,5,2,0
1.2914779863058173e+18,11,30,2.727272727272727,1,4,11,0
1.291497876134637e+18,4,28,7.0,6,8,2,2
1.2915250876111014e+18,9,16,1.7777777777777777,1,3,9,0
1.2920716998637993e+18,1,2,2.0,2,2,1,0
1.2921035177988096e+18,1,8,8.0,8,8,0,1
1.2921567271748465e+18,7,43,6.142857142857143,5,7,7,0
1.2923055328439437e+18,5,10,2.0,1,3,5,0
1.2925275505234125e+18,5,27,5.4,4,6,5,0
1.2925417037782057e+18,1,10,10.0,10,10,0,1
1.2925698305758065e+18,2,5,2.5,2,3,2,0
1.2925990991586086e+18,6,41,6.833333333333333,4,8,3,3
1.292599351684402e+18,8,52,6.5,6,8,7,1
1.292610576754009e+18,11,35,3.1818181818181817,2,4,11,0
1.2926232416202378e+18,2,18,9.0,8,10,0,2
1.2926276570961782e+18,2,15,7.5,7,8,1,1
1.2926439961263432e+18,1,8,8.0,8,8,0,1
1.2926687196161664e+18,26,131,5.038461538461538,1,7,26,0
1.292669551325691e+18,1,5,5.0,5,5,1,0
1.2926928905684782e+18,1,8,8.0,8,8,0,1
1.292721170767783e+18,1,8,8.0,8,8,0,1
1.292732648143446e+18,25,239,9.56,3,13,1,24
1.292733186015123e+18,1,7,7.0,7,7,1,0
1.2927597929501235e+18,2,6,3.0,3,3,2,0
1.2927660855108055e+18,5,33,6.6,5,8,3,2
1.2927783150026516e+18,1,3,3.0,3,3,1,0
1.292778673562329e+18,2,6,3.0,3,3,2,0
1.2927909027800998e+18,2,12,6.0,6,6,2,0
1.2928478019264986e+18,3,21,7.0,6,8,2,1
1.2929665280119977e+18,10,23,2.3,1,4,10,0
1.2929894061205647e+18,9,14,1.5555555555555556,1,2,9,0
1.2932608216933184e+18,4,11,2.75,2,4,4,0
1.2932813432033677e+18,1,9,9.0,9,9,0,1
1.2933643292449764e+18,7,49,7.0,6,8,4,3
1.293382111919176e+18,2,4,2.0,2,2,2,0
1.2933863622487634e+18,5,43,8.6,8,9,0,5
1.2934062967442568e+18,4,28,7.0,6,8,3,1
1.2934405658826537e+18,2,6,3.0,3,3,2,0
1.2934406430444846e+18,7,14,2.0,1,3,7,0
1.2934423256251663e+18,17,99,5.823529411764706,5,7,17,0
1.2934426289545713e+18,1,9,9.0,9,9,0,1
1.2934437263680223e+18,1,3,3.0,3,3,1,0
1.293452309568485e+18,2,5,2.5,2,3,2,0
1.2934594622627686e+18,1,2,2.0,2,2,1,0
1.2934714331163753e+18,4,23,5.75,2,7,4,0
1.2934751410521408e+18,7,36,5.142857142857143,2,8,6,1
1.2934765565696233e+18,2,14,7.0,7,7,2,0
1.2934779024604854e+18,2,16,8.0,7,9,1,1
1.2935283924744963e+18,2,18,9.0,8,10,0,2
1.2935324176078495e+18,6,12,2.0,1,3,6,0
1.293541605284115e+18,5,38,7.6,6,9,2,3
1.293543166119693e+18,3,10,3.3333333333333335,3,4,3,0
1.2935526495843318e+18,5,15,3.0,3,3,5,0
1.2935685319126454e+18,4,8,2.0,1,3,4,0
1.2935696981557921e+18,11,37,3.3636363636363638,2,5,11,0
1.2935911123735455e+18,11,29,2.6363636363636362,1,5,11,0
1.2935986657940808e+18,7,24,3.4285714285714284,2,5,7,0
1.293606157700862e+18,6,13,2.1666666666666665,1,3,6,0
1.29363291053938e+18,3,19,6.333333333333333,5,7,3,0
1.2939943088828946e+18,5,33,6.6,6,7,5,0
1.2940360183794191e+18,6,45,7.5,7,9,4,2
1.2940481217253906e+18,8,66,8.25,6,10,2,6
1.294060952532563e+18,2,6,3.0,3,3,2,0
1.2940705465404672e+18,5,31,6.2,6,7,5,0
1.2940742848802499e+18,9,26,2.888888888888889,1,5,9,0
1.2941018511536648e+18,10,59,5.9,5,7,10,0
1.2941397033562831e+18,1,2,2.0,2,2,1,0
1.2942116035876536e+18,2,14,7.0,7,7,2,0
1.294211767697833e+18,1,9,9.0,9,9,0,1
1.2942253233552886e+18,5,10,2.0,1,3,5,0
1.2942257555737193e+18,13,22,1.6923076923076923,1,3,13,0
1.294240828025252e+18,9,12,1.3333333333333333,1,3,9,0
1.2942626105802437e+18,4,35,8.75,8,9,0,4
1.2943528739502047e+18,1,8,8.0,8,8,0,1
1.294368787560055e+18,14,120,8.571428571428571,5,10,2,12
1.2943940350074473e+18,3,15,5.0,4,6,3,0
1.2943970336063035e+18,10,29,2.9,2,5,10,0
1.2945359770093788e+18,1,3,3.0,3,3,1,0
1.2946322445925985e+18,1,5,5.0,5,5,1,0
1.2946884588726305e+18,3,22,7.333333333333333,7,8,2,1
1.2947120152416648e+18,7,27,3.857142857142857,2,5,7,0
1.2947619452194895e+18,2,6,3.0,1,5,2,0
1.2949608007678612e+18,4,24,6.0,5,7,4,0
1.295088372258066e+18,11,20,1.8181818181818181,1,3,11,0
1.2951436152202916e+18,1,3,3.0,3,3,1,0
1.2951472007790912e+18,7,14,2.0,1,3,7,0
1.2951741963592274e+18,1,6,6.0,6,6,1,0
1.295419753886706e+18,10,79,7.9,6,10,2,8
1.295440290017332e+18,1,1,1.0,1,1,1,0
1.2954553557127882e+18,11,107,9.727272727272727,8,11,0,11
1.2954604781271014e+18,5,17,3.4,2,4,5,0
1.295529039120724e+18,1,10,10.0,10,10,0,1
1.2955365309142449e+18,9,67,7.444444444444445,6,8,4,5
1.2955381016602045e+18,1,4,4.0,4,4,1,0
1.2955700642765896e+18,3,10,3.3333333333333335,3,4,3,0
1.295607717972529e+18,2,23,11.5,11,12,0,2
1.2956132772384986e+18,2,4,2.0,1,3,2,0
1.295613826821555e+18,4,12,3.0,3,3,4,0
1.29561446018758e+18,10,50,5.0,3,7,10,0
1.2956901503679375e+18,3,9,3.0,3,3,3,0
1.295704510064839e+18,1,2,2.0,2,2,1,0
1.295709499918531e+18,4,9,2.25,1,3,4,0
1.2957753728543025e+18,6,61,10.166666666666666,9,12,0,6
1.2957771140053294e+18,18,131,7.277777777777778,5,9,10,8
1.2958068127253473e+18,7,65,9.285714285714286,7,11,1,6
1.296210123399694e+18,1,3,3.0,3,3,1,0
1.296275648748377e+18,3,4,1.3333333333333333,1,2,3,0
1.2962809580851863e+18,4,39,9.75,9,11,0,4
1.2963186481984837e+18,15,115,7.666666666666667,2,9,5,10
1.2963219949126866e+18,7,17,2.4285714285714284,2,3,7,0
1.2964003149572357e+18,1,1,1.0,1,1,1,0
1.2964337863712927e+18,1,10,10.0,10,10,0,1
1.2964365867967506e+18,1,4,4.0,4,4,1,0
1.2965058367001103e+18,4,20,5.0,4,6,4,0
1.2965491624260782e+18,1,7,7.0,7,7,1,0
1.2965633267426762e+18,1,7,7.0,7,7,1,0
1.2968168195598984e+18,2,14,7.0,6,8,1,1
1.2968482488463388e+18,16,134,8.375,7,9,2,14
1.2969049377146765e+18,2,15,7.5,7,8,1,1
1.296933463988186e+18,24,27,1.125,1,2,24,0
1.2969879655752855e+18,1,3,3.0,3,3,1,0
1.2970255131151785e+18,31,175,5.645161290322581,2,9,28,3
1.2970620081404764e+18,25,157,6.28,4,8,20,5
1.2970959650923474e+18,3,21,7.0,6,8,2,1
1.297102348848494e+18,3,24,8.0,2,11,1,2
1.29713990369758e+18,1,8,8.0,8,8,0,1
1.297207772667482e+18,1,2,2.0,2,2,1,0
1.2972392313613056e+18,2,8,4.0,4,4,2,0
1.2972678383830615e+18,10,18,1.8,1,3,10,0
1.29769494574082e+18,4,11,2.75,2,3,4,0
1.297698478962759e+18,1,9,9.0,9,9,0,1
1.2976999261223844e+18,1,6,6.0,6,6,1,0
1.2977220135454525e+18,9,25,2.7777777777777777,2,4,9,0
1.297723056032616e+18,2,16,8.0,8,8,0,2
1.297787097404587e+18,2,10,5.0,4,6,2,0
1.2977905024046013e+18,9,44,4.888888888888889,2,6,9,0
1.2977939181886559e+18,10,52,5.2,4,7,10,0
1.2978239063116872e+18,6,42,7.0,5,8,3,3
1.297891902320343e+18,4,27,6.75,6,8,3,1
1.2978951747133112e+18,4,11,2.75,2,3,4,0
1.2978979840096788e+18,15,103,6.866666666666666,5,9,13,2
1.2979356132527462e+18,13,110,8.461538461538462,6,10,3,10
1.2979386322578657e+18,8,57,7.125,6,8,6,2
1.2979775979334764e+18,1,3,3.0,3,3,1,0
1.2979980551908982e+18,2,4,2.0,2,2,2,0
1.2980109877138135e+18,2,6,3.0,2,4,2,0
1.2982344455160338e+18,13,34,2.6153846153846154,1,5,13,0
1.2983497168693847e+18,17,23,1.3529411764705883,1,2,17,0
1.298400117630395e+18,5,10,2.0,1,3,5,0
1.298418918102728e+18,6,8,1.3333333333333333,1,2,6,0
1.2984192992409096e+18,8,12,1.5,1,2,8,0
1.2984198038634378e+18,1,5,5.0,5,5,1,0
1.298452703517444e+18,1,9,9.0,9,9,0,1
1.298468240022717e+18,12,20,1.6666666666666667,1,3,12,0
1.2984805429955039e+18,6,16,2.6666666666666665,2,4,6,0
1.298501087254514e+18,1,4,4.0,4,4,1,0
1.298502398387048e+18,12,20,1.6666666666666667,1,3,12,0
1.2985182258784046e+18,1,11,11.0,11,11,0,1
1.298523017099572e+18,1,8,8.0,8,8,0,1
1.2985285813771098e+18,5,9,1.8,1,3,5,0
1.298532054730429e+18,5,10,2.0,1,3,5,0
1.2985421356378668e+18,1,8,8.0,8,8,0,1
1.298557292918064e+18,9,14,1.5555555555555556,1,3,9,0
1.2985989022891215e+18,1,1,1.0,1,1,1,0
1.2986123456326508e+18,1,2,2.0,2,2,1,0
1.2986148959692964e+18,6,22,3.6666666666666665,3,4,6,0
1.2986211511483397e+18,2,7,3.5,2,5,2,0
1.2986454244662556e+18,4,30,7.5,6,8,1,3
1.2986540578831004e+18,11,73,6.636363636363637,4,9,8,3
1.2986561023766295e+18,3,22,7.333333333333333,6,9,2,1
1.298690943403281e+18,2,16,8.0,8,8,0,2
1.2987330024995346e+18,1,7,7.0,7,7,1,0
1.29874507863149e+18,1,4,4.0,4,4,1,0
1.2990678913162358e+18,2,15,7.5,7,8,1,1
1.299082697553213e+18,1,7,7.0,7,7,1,0
1.2990840169312105e+18,2,14,7.0,7,7,2,0
1.2990887278997924e+18,2,13,6.5,6,7,2,0
1.2990910759692854e+18,2,11,5.5,5,6,2,0
1.2991142528426079e+18,8,55,6.875,5,9,6,2
1.299115252952656e+18,7,12,1.7142857142857142,1,3,7,0
1.2991502321517192e+18,4,27,6.75,6,8,3,1
1.2991507546140124e+18,2,6,3.0,3,3,2,0
1.2991627689429962e+18,1,3,3.0,3,3,1,0
1.2991978420447826e+18,3,14,4.666666666666667,4,6,3,0
1.2992139836059768e+18,5,36,7.2,6,9,3,2
1.299223092951476e+18,5,12,2.4,2,3,5,0
1.299225725973837e+18,5,12,2.4,1,4,5,0
1.2992464719872433e+18,5,8,1.6,1,2,5,0
1.299273673040362e+18,6,44,7.333333333333333,6,9,3,3
1.2992989622518592e+18,1,1,1.0,1,1,1,0
1.2993025934673475e+18,14,95,6.785714285714286,5,9,10,4
1.2993055051516242e+18,1,1,1.0,1,1,1,0
1.2993143846134449e+18,7,32,4.571428571428571,3,6,7,0
1.2993148268765115e+18,2,10,5.0,5,5,2,0
1.2993220183310792e+18,2,6,3.0,3,3,2,0
1.2993289041901783e+18,9,26,2.888888888888889,2,4,9,0
1.2993301379538127e+18,3,24,8.0,8,8,0,3
1.2993342156364751e+18,3,31,10.333333333333334,10,11,0,3
1.2993961941700577e+18,5,36,7.2,6,8,3,2
1.2994338883312566e+18,1,7,7.0,7,7,1,0
1.2994416170336722e+18,17,135,7.9411764705882355,5,10,5,12
1.299451250518346e+18,18,120,6.666666666666667,4,9,15,3
1.299473484518842e+18,9,12,1.3333333333333333,1,2,9,0
1.2995028759779604e+18,16,126,7.875,5,10,5,11
1.2997717128617654e+18,2,6,3.0,3,3,2,0
1.2997721623714609e+18,3,10,3.3333333333333335,2,4,3,0
1.2997728501616013e+18,4,11,2.75,2,4,4,0
1.2997731123905562e+18,3,10,3.3333333333333335,2,5,3,0
1.299773401960443e+18,12,34,2.8333333333333335,1,4,12,0
1.2997801944806282e+18,6,14,2.3333333333333335,1,4,6,0
1.2998036190651133e+18,16,106,6.625,5,8,13,3
1.299879420081945e+18,3,26,8.666666666666666,8,9,0,3
1.2999015010334185e+18,5,14,2.8,2,3,5,0
1.2999293413261207e+18,2,5,2.5,2,3,2,0
1.2999976987356416e+18,4,18,4.5,4,5,4,0
1.299998002017447e+18,4,9,2.25,1,3,4,0
1.2999981489851041e+18,3,7,2.3333333333333335,1,3,3,0
1.299998366260538e+18,2,3,1.5,1,2,2,0
1.299998536153949e+18,14,42,3.0,1,5,14,0
1.299999093618215e+18,7,16,2.2857142857142856,1,4,7,0
1.299999632785661e+18,8,20,2.5,1,4,8,0
1.2999998251827392e+18,5,16,3.2,2,5,5,0
1.300000042997386e+18,5,15,3.0,2,4,5,0
1.3000145661041042e+18,9,16,1.7777777777777777,1,3,9,0
1.3000778177718643e+18,1,8,8.0,8,8,0,1
1.3001730695437087e+18,1,1,1.0,1,1,1,0
1.3002645234310257e+18,2,10,5.0,5,5,2,0
1.3003218540278392e+18,9,50,5.555555555555555,2,7,9,0
1.3005128166274179e+18,3,27,9.0,8,10,0,3
1.3005970531819858e+18,7,20,2.857142857142857,1,5,7,0
1.3006374041922547e+18,3,33,11.0,11,11,0,3
1.3006528762939256e+18,6,13,2.1666666666666665,1,3,6,0
1.3006661653031334e+18,6,15,2.5,1,4,6,0
1.3006813959692014e+18,12,23,1.9166666666666667,1,3,12,0
1.3007044912781696e+18,10,75,7.5,6,9,5,5
1.300716255152008e+18,3,28,9.333333333333334,9,10,0,3
1.3007460524060572e+18,4,22,5.5,4,7,4,0
1.3007560130579517e+18,6,33,5.5,4,7,6,0
1.3007582108110797e+18,9,49,5.444444444444445,2,7,9,0
1.300784015706894e+18,12,102,8.5,2,11,3,9
1.300824819614627e+18,7,38,5.428571428571429,2,7,7,0
1.3008503055051195e+18,2,6,3.0,2,4,2,0
1.3008843885003645e+18,1,1,1.0,1,1,1,0
1.3012470569141128e+18,1,4,4.0,4,4,1,0
1.3013795270001756e+18,11,72,6.545454545454546,4,10,9,2
1.3013907977738468e+18,1,3,3.0,3,3,1,0
1.3014195813309125e+18,1,1,1.0,1,1,1,0
1.3014901127309184e+18,3,25,8.333333333333334,7,9,1,2
1.3015346143421699e+18,4,8,2.0,2,2,4,0
1.3016035866402826e+18,3,25,8.333333333333334,8,9,0,3
1.3018338001707154e+18,15,103,6.866666666666666,5,8,11,4
1.3020150646725893e+18,2,17,8.5,7,10,1,1
1.3020355211770696e+18,10,80,8.0,7,9,3,7
1.3020754779991212e+18,15,50,3.3333333333333335,2,5,15,0
1.3020968194189417e+18,1,2,2.0,2,2,1,0
1.3021257868303939e+18,2,2,1.0,1,1,2,0
1.3021417517734085e+18,17,95,5.588235294117647,4,7,17,0
1.3022069964015555e+18,1,7,7.0,7,7,1,0
1.3022204321164567e+18,2,3,1.5,1,2,2,0
1.3022492133029647e+18,6,19,3.1666666666666665,2,4,6,0
1.3022806457271414e+18,10,53,5.3,4,7,10,0
1.3022936023058196e+18,1,10,10.0,10,10,0,1
1.3023021935422031e+18,4,7,1.75,1,3,4,0
1.302335921483521e+18,8,38,4.75,4,6,8,0
1.30233762836698e+18,9,16,1.7777777777777777,1,3,9,0
1.30239320284061e+18,13,104,8.0,3,10,2,11
1.3027028212233523e+18,1,2,2.0,2,2,1,0
1.3027332048735951e+18,1,4,4.0,4,4,1,0
1.3027438604196426e+18,6,16,2.6666666666666665,2,4,6,0
1.3028016123624532e+18,5,15,3.0,2,4,5,0
1.3028411219086318e+18,1,11,11.0,11,11,0,1
1.3028575651778542e+18,2,14,7.0,6,8,1,1
1.302902881734548e+18,16,108,6.75,4,9,11,5
1.30294206133964e+18,2,3,1.5,1,2,2,0
1.3029479528461837e+18,1,3,3.0,3,3,1,0
1.3029533297933169e+18,9,28,3.111111111111111,2,5,9,0
1.302953428719394e+18,1,3,3.0,3,3,1,0
1.3029715566198052e+18,2,4,2.0,2,2,2,0
1.3030120780261988e+18,15,99,6.6,3,9,11,4
1.3030167112127475e+18,19,82,4.315789473684211,2,6,19,0
1.3030349459539722e+18,3,19,6.333333333333333,5,8,2,1
1.3030456802047165e+18,1,1,1.0,1,1,1,0
1.3030695460778747e+18,8,36,4.5,2,6,8,0
1.3030753545937923e+18,5,44,8.8,8,9,0,5
1.3031009861719276e+18,2,15,7.5,7,8,1,1
1.3031434606831043e+18,4,33,8.25,7,9,1,3
1.303423506211799e+18,2,13,6.5,6,7,2,0
1.3034316587018048e+18,3,7,2.3333333333333335,1,4,3,0
1.3034842477123016e+18,12,81,6.75,4,8,10,2
1.303485440474065e+18,17,50,2.9411764705882355,1,4,17,0
1.3034856433873408e+18,9,28,3.111111111111111,1,5,9,0
1.3035247193520248e+18,1,9,9.0,9,9,0,1
1.3035269458318106e+18,1,8,8.0,8,8,0,1
1.303532591474674e+18,4,25,6.25,5,8,3,1
1.3035621485844728e+18,12,87,7.25,3,8,4,8
1.303594677217825e+18,2,4,2.0,1,3,2,0
1.30362580112535e+18,15,48,3.2,1,5,15,0
1.3036392166609802e+18,7,40,5.714285714285714,4,7,7,0
1.3036499740379397e+18,6,35,5.833333333333333,5,7,6,0
1.303663745904113e+18,6,35,5.833333333333333,4,8,5,1
1.3036736760106586e+18,7,9,1.2857142857142858,1,3,7,0
1.3037004056860285e+18,7,52,7.428571428571429,6,9,3,4
1.3037262160285596e+18,12,37,3.0833333333333335,1,5,12,0
1.303769236597143e+18,3,8,2.6666666666666665,1,4,3,0
1.3037882327886057e+18,2,6,3.0,3,3,2,0
1.3038092828436956e+18,2,6,3.0,2,4,2,0
1.3038328243898831e+18,11,43,3.909090909090909,2,5,11,0
1.3038398157456865e+18,6,37,6.166666666666667,4,7,6,0
1.3038732587000458e+18,8,42,5.25,4,6,8,0
1.3040892441108255e+18,3,22,7.333333333333333,7,8,2,1
1.304194719725877e+18,27,39,1.4444444444444444,1,3,27,0
1.304196110803804e+18,17,134,7.882352941176471,7,9,7,10
1.3042003624411195e+18,2,11,5.5,4,7,2,0
1.3042158322400323e+18,4,23,5.75,4,7,4,0
1.3042762691408146e+18,2,9,4.5,4,5,2,0
1.3043262129796032e+18,11,108,9.818181818181818,6,12,1,10
1.3043308419765765e+18,7,13,1.8571428571428572,1,3,7,0
1.3043775695241585e+18,6,31,5.166666666666667,4,6,6,0
1.3043794133296056e+18,1,2,2.0,2,2,1,0
1.304384619193538e+18,7,37,5.285714285714286,5,6,7,0
1.304390962005477e+18,8,48,6.0,4,8,6,2
1.3044003248279142e+18,3,6,2.0,1,3,3,0
1.3044047029217572e+18,6,41,6.833333333333333,5,8,5,1
1.3044120347484582e+18,1,7,7.0,7,7,1,0
1.3044172036644884e+18,1,3,3.0,3,3,1,0
1.3044178979390769e+18,10,58,5.8,4,7,10,0
1.3044229002955525e+18,4,28,7.0,7,7,4,0
1.3044637476325898e+18,5,6,1.2,1,2,5,0
1.3045618659923323e+18,26,173,6.653846153846154,2,9,16,10
1.3046123166074737e+18,7,41,5.857142857142857,4,7,7,0
1.3046551528975875e+18,41,280,6.829268292682927,4,9,31,10
1.3046854661877048e+18,41,282,6.878048780487805,2,10,28,13
1.3048888319471452e+18,11,91,8.272727272727273,6,9,1,10
1.3049462266284447e+18,3,20,6.666666666666667,5,8,2,1
1.304947868706495e+18,2,11,5.5,5,6,2,0
1.3049731334902364e+18,6,42,7.0,5,9,3,3
1.3049746706033065e+18,2,6,3.0,3,3,2,0
1.304983570950557e+18,2,4,2.0,2,2,2,0
1.304987692529153e+18,1,4,4.0,4,4,1,0
1.304994059838041e+18,4,10,2.5,1,4,4,0
1.3050061195863378e+18,5,33,6.6,2,9,3,2
1.3050119029828744e+18,4,11,2.75,2,3,4,0
1.305012299007729e+18,2,7,3.5,3,4,2,0
1.3050285206962337e+18,1,1,1.0,1,1,1,0
1.3050461201843402e+18,4,9,2.25,1,3,4,0
1.3050765647212703e+18,10,58,5.8,4,8,9,1
1.3050887573751014e+18,4,26,6.5,6,7,4,0
1.3050911313409969e+18,2,21,10.5,10,11,0,2
1.305096153295499e+18,7,43,6.142857142857143,5,7,7,0
1.3051010959508001e+18,7,12,1.7142857142857142,1,3,7,0
1.305105551816997e+18,7,40,5.714285714285714,5,7,7,0
1.3051079671843868e+18,10,91,9.1,5,12,1,9
1.305115776038042e+18,10,32,3.2,1,5,10,0
1.3051205262581297e+18,3,17,5.666666666666667,4,7,3,0
1.3051316333807124e+18,1,9,9.0,9,9,0,1
1.3051786856011387e+18,8,13,1.625,1,3,8,0
1.3051887709144164e+18,1,4,4.0,4,4,1,0
1.3052493069273367e+18,7,24,3.4285714285714284,2,5,7,0
1.3052523898125338e+18,1,3,3.0,3,3,1,0
1.3052900524379118e+18,14,27,1.9285714285714286,1,3,14,0
1.3054852319529088e+18,1,2,2.0,2,2,1,0
1.3056311578586575e+18,1,1,1.0,1,1,1,0
1.3056480813308964e+18,6,10,1.6666666666666667,1,3,6,0
1.3056987499542912e+18,4,34,8.5,7,10,1,3
1.3057183463760297e+18,3,7,2.3333333333333335,2,3,3,0
1.3057476865212628e+18,4,19,4.75,4,6,4,0
1.3057728365280806e+18,6,43,7.166666666666667,6,9,4,2
1.3057829223234547e+18,3,21,7.0,6,8,2,1
1.3057865342049124e+18,4,24,6.0,4,7,4,0
1.3057883186677804e+18,1,7,7.0,7,7,1,0
1.3057893713564787e+18,1,9,9.0,9,9,0,1
1.3057903563576563e+18,2,13,6.5,6,7,2,0
1.3057965425072148e+18,13,65,5.0,3,7,13,0
1.305799489581816e+18,2,2,1.0,1,1,2,0
1.3058003665533606e+18,6,16,2.6666666666666665,1,5,6,0
1.3058018438666678e+18,1,3,3.0,3,3,1,0
1.3058198086955162e+18,4,41,10.25,8,11,0,4
1.3058933969226985e+18,7,37,5.285714285714286,4,9,6,1
1.305960273629929e+18,11,34,3.090909090909091,1,5,11,0
1.305989102155501e+18,3,21,7.0,6,8,2,1
1.3061435795884577e+18,1,1,1.0,1,1,1,0
1.306349391537428e+18,8,9,1.125,1,2,8,0
1.3064166432750154e+18,2,14,7.0,6,8,1,1
1.3064212466293125e+18,3,10,3.3333333333333335,3,4,3,0
1.3065087390440594e+18,18,77,4.277777777777778,3,6,18,0
1.30660002498298e+18,8,74,9.25,7,11,1,7
1.3066222166908964e+18,4,31,7.75,7,9,2,2
1.3070377920619146e+18,2,16,8.0,7,9,1,1
1.307105572950388e+18,2,16,8.0,8,8,0,2
1.3072251790413484e+18,3,24,8.0,8,8,0,3
1.3072596698429338e+18,2,15,7.5,7,8,1,1
1.3072652909338225e+18,1,4,4.0,4,4,1,0
1.3073071548075246e+18,3,16,5.333333333333333,5,6,3,0
1.3073359443582866e+18,5,42,8.4,7,9,1,4
1.307336750225413e+18,1,2,2.0,2,2,1,0
1.3073888784021338e+18,8,48,6.0,5,8,7,1
1.3074113380077617e+18,1,7,7.0,7,7,1,0
1.3075007925599214e+18,25,36,1.44,1,3,25,0
1.3077047614515725e+18,5,31,6.2,5,7,5,0
1.30780748042055e+18,1,2,2.0,2,2,1,0
1.307843428901716e+18,1,2,2.0,2,2,1,0
1.307855002316048e+18,10,72,7.2,6,9,6,4
1.3079199388764293e+18,3,21,7.0,7,7,3,0
1.3079539120517274e+18,1,3,3.0,3,3,1,0
1.3079663037986488e+18,3,19,6.333333333333333,5,8,2,1
1.307970743845659e+18,1,3,3.0,3,3,1,0
1.3080168059968358e+18,1,2,2.0,2,2,1,0
1.3080232841984515e+18,4,29,7.25,5,9,2,2
1.3080375891843505e+18,10,67,6.7,5,8,7,3
1.3080454573442644e+18,8,76,9.5,8,11,0,8
1.3080664298732833e+18,1,1,1.0,1,1,1,0
1.3080928178733985e+18,1,2,2.0,2,2,1,0
1.3081029347720643e+18,12,84,7.0,5,8,8,4
1.3081216606193103e+18,2,2,1.0,1,1,2,0
1.30814046785454e+18,1,2,2.0,2,2,1,0
1.30815562300384e+18,13,112,8.615384615384615,7,10,1,12
1.3081990162734487e+18,17,144,8.470588235294118,2,10,2,15
1.3082542336726856e+18,5,31,6.2,5,8,4,1
1.308347931184041e+18,1,3,3.0,3,3,1,0
1.308525706039744e+18,3,7,2.3333333333333335,2,3,3,0
1.308526868901003e+18,3,8,2.6666666666666665,2,3,3,0
1.3085393136054065e+18,1,2,2.0,2,2,1,0
1.3085654800873736e+18,7,48,6.857142857142857,6,8,6,1
1.3085877601184573e+18,3,6,2.0,1,3,3,0
1.3086250063762033e+18,3,17,5.666666666666667,2,8,2,1
1.3086272449013187e+18,4,10,2.5,1,3,4,0
1.308663871265621e+18,14,106,7.571428571428571,5,10,6,8
1.3086707974860462e+18,2,2,1.0,1,1,2,0
1.3086809688483108e+18,1,1,1.0,1,1,1,0
1.308743991010525e+18,6,10,1.6666666666666667,1,3,6,0
1.3087484933674017e+18,3,5,1.6666666666666667,1,2,3,0
1.3087624893725693e+18,1,3,3.0,3,3,1,0
1.3087836515140598e+18,2,16,8.0,8,8,0,2
1.308791853020272e+18,27,55,2.037037037037037,1,4,27,0
1.3088166540871478e+18,1,1,1.0,1,1,1,0
1.3088394775055928e+18,2,14,7.0,7,7,2,0
1.3088427088193142e+18,3,7,2.3333333333333335,2,3,3,0
1.3089072885050278e+18,1,2,2.0,2,2,1,0
1.308924187811924e+18,2,3,1.5,1,2,2,0
1.3089406254094556e+18,2,4,2.0,1,3,2,0
1.3092208752844744e+18,2,16,8.0,8,8,0,2
1.3092482868508603e+18,3,23,7.666666666666667,7,8,1,2
1.309251755098158e+18,3,22,7.333333333333333,6,8,1,2
1.309254300289848e+18,1,6,6.0,6,6,1,0
1.309262086741642e+18,8,20,2.5,1,4,8,0
1.3092628640449536e+18,1,2,2.0,2,2,1,0
1.3092960621753408e+18,1,3,3.0,3,3,1,0
1.309333829193979e+18,18,39,2.1666666666666665,1,4,18,0
1.3093387817310802e+18,2,11,5.5,5,6,2,0
1.309353208727014e+18,5,10,2.0,1,3,5,0
1.309354929930089e+18,11,112,10.181818181818182,3,12,1,10
1.309355339141944e+18,1,7,7.0,7,7,1,0
1.3093885418899866e+18,1,3,3.0,3,3,1,0
1.309404112288864e+18,12,79,6.583333333333333,3,10,8,4
1.3094082091280479e+18,1,4,4.0,4,4,1,0
1.3094200483777925e+18,2,6,3.0,2,4,2,0
1.309420054934294e+18,3,18,6.0,5,7,3,0
1.3094253944931502e+18,1,6,6.0,6,6,1,0
1.3094279694018092e+18,4,26,6.5,4,9,2,2
1.309430249173356e+18,4,28,7.0,5,8,2,2
1.3094320681338314e+18,5,14,2.8,2,3,5,0
1.3094414617701e+18,2,3,1.5,1,2,2,0
1.3094742198728847e+18,3,11,3.6666666666666665,3,4,3,0
1.3099824760487841e+18,8,24,3.0,2,5,8,0
1.3100037111235446e+18,9,17,1.8888888888888888,1,3,9,0
1.3100406908823777e+18,1,9,9.0,9,9,0,1
1.3100459104580367e+18,1,2,2.0,2,2,1,0
1.3100727813125268e+18,8,57,7.125,5,9,5,3
1.3100752495332585e+18,3,9,3.0,3,3,3,0
1.3101156355705234e+18,1,3,3.0,3,3,1,0
1.3101210315284454e+18,6,19,3.1666666666666665,2,4,6,0
1.3101347402769946e+18,1,4,4.0,4,4,1,0
1.3101763231379679e+18,7,15,2.142857142857143,1,4,7,0
1.3101804012709453e+18,4,12,3.0,3,3,4,0
1.3101863973715686e+18,6,18,3.0,2,4,6,0
1.3101993430860895e+18,6,33,5.5,4,7,6,0
1.3102116034521882e+18,3,9,3.0,2,4,3,0
1.3102408991997558e+18,1,6,6.0,6,6,1,0
1.310258693187877e+18,1,4,4.0,4,4,1,0
1.3103005105865247e+18,12,41,3.4166666666666665,2,5,12,0
1.3103026448080788e+18,1,3,3.0,3,3,1,0
1.3103315007542625e+18,3,5,1.6666666666666667,1,2,3,0
1.3106078386129577e+18,1,2,2.0,2,2,1,0
1.3106227497516088e+18,2,16,8.0,6,10,1,1
1.310629123259692e+18,16,65,4.0625,3,7,16,0
1.31065583053432e+18,1,5,5.0,5,5,1,0
1.310678763304934e+18,1,7,7.0,7,7,1,0
1.3107122417331615e+18,1,10,10.0,10,10,0,1
1.3107221428558886e+18,6,59,9.833333333333334,9,12,0,6
1.31072545695442e+18,1,8,8.0,8,8,0,1
1.3107469510775027e+18,1,3,3.0,3,3,1,0
1.3107519218193224e+18,5,34,6.8,6,7,5,0
1.3107569559621292e+18,6,15,2.5,1,3,6,0
1.3107589983767834e+18,3,6,2.0,1,3,3,0
1.3107643072345764e+18,8,35,4.375,3,7,8,0
1.310769712202326e+18,2,2,1.0,1,1,2,0
1.3107844551879575e+18,2,13,6.5,6,7,2,0
1.310835146591958e+18,9,19,2.111111111111111,1,4,9,0
1.3108424304155645e+18,1,7,7.0,7,7,1,0
1.3108438338090486e+18,5,23,4.6,3,5,5,0
1.3108524066145787e+18,1,6,6.0,6,6,1,0
1.3108915153151222e+18,4,8,2.0,1,3,4,0
1.3109033267983017e+18,6,36,6.0,5,7,6,0
1.3109066966187064e+18,10,58,5.8,4,7,10,0
1.3109087288067203e+18,2,13,6.5,6,7,2,0
1.3109114612813312e+18,11,81,7.363636363636363,5,9,6,5
1.3109356430239334e+18,3,3,1.0,1,1,3,0
1.3109763992188462e+18,2,7,3.5,2,5,2,0
1.3110243673354511e+18,1,9,9.0,9,9,0,1
1.3110268556227062e+18,1,10,10.0,10,10,0,1
1.3110654938800888e+18,3,5,1.6666666666666667,1,2,3,0
1.3114675399932557e+18,1,7,7.0,7,7,1,0
1.3114991173506683e+18,1,7,7.0,7,7,1,0
1.311756341393318e+18,1,3,3.0,3,3,1,0
1.3124038841504978e+18,11,32,2.909090909090909,2,4,11,0
1.3124249030535414e+18,2,15,7.5,7,8,1,1
1.312452362099761e+18,5,43,8.6,7,10,1,4
1.3124582570561283e+18,3,26,8.666666666666666,8,10,0,3
1.312491801565748e+18,7,26,3.7142857142857144,2,5,7,0
1.3126197330051246e+18,13,94,7.230769230769231,3,9,6,7
1.3128755777825413e+18,2,5,2.5,2,3,2,0
1.3128778883113265e+18,6,39,6.5,5,8,5,1
1.312982891713834e+18,10,20,2.0,1,3,10,0
1.3129932907262664e+18,1,6,6.0,6,6,1,0
1.3129933153366787e+18,2,15,7.5,7,8,1,1
1.3130334553682522e+18,16,121,7.5625,6,10,10,6
1.313049699727232e+18,8,53,6.625,4,8,5,3
1.3130803047390062e+18,1,9,9.0,9,9,0,1
1.3131142158202893e+18,11,42,3.8181818181818183,2,7,11,0
1.3131160390151578e+18,4,33,8.25,7,9,1,3
1.3131216249529219e+18,2,14,7.0,7,7,2,0
1.3131240782585108e+18,2,13,6.5,6,7,2,0
1.3131247955001428e+18,15,47,3.1333333333333333,1,4,15,0
1.3131853224279107e+18,1,9,9.0,9,9,0,1
1.3135648902026076e+18,15,25,1.6666666666666667,1,3,15,0
1.3135955762949734e+18,3,30,10.0,9,11,0,3
1.3136010629574195e+18,9,61,6.777777777777778,5,9,7,2
1.3136223038176364e+18,1,2,2.0,2,2,1,0
1.3136235097457784e+18,1,4,4.0,4,4,1,0
1.313687583949626e+18,5,31,6.2,5,8,4,1
1.3136992547365926e+18,4,11,2.75,2,3,4,0
1.3137770052602916e+18,4,21,5.25,2,7,4,0
1.313780230875438e+18,1,1,1.0,1,1,1,0
1.313783207116912e+18,1,3,3.0,3,3,1,0
1.313797353600894e+18,3,19,6.333333333333333,5,8,2,1
1.3138031524992852e+18,1,3,3.0,3,3,1,0
1.3138169177721206e+18,1,3,3.0,3,3,1,0
1.3138719417777398e+18,7,41,5.857142857142857,5,7,7,0
1.313889561908269e+18,3,22,7.333333333333333,7,8,2,1
1.3139036807088548e+18,7,41,5.857142857142857,5,7,7,0
1.3139397412387615e+18,10,55,5.5,4,6,10,0
1.313949614065685e+18,7,43,6.142857142857143,5,7,7,0
1.3139620508295767e+18,1,1,1.0,1,1,1,0
1.313981263459801e+18,5,29,5.8,4,7,5,0
1.3139998361209405e+18,8,31,3.875,2,5,8,0
1.3140429051712504e+18,2,5,2.5,2,3,2,0
1.3142873870625966e+18,2,4,2.0,1,3,2,0
1.3143090059440494e+18,3,9,3.0,2,4,3,0
1.3143718430142152e+18,1,3,3.0,3,3,1,0
1.314394745433707e+18,10,27,2.7,1,4,10,0
1.314401739158803e+18,3,30,10.0,10,10,0,3
1.314408269221256e+18,1,5,5.0,5,5,1,0
1.31443817619112e+18,3,4,1.3333333333333333,1,2,3,0
1.3144844286499256e+18,1,6,6.0,6,6,1,0
1.314530865276152e+18,5,32,6.4,5,7,5,0
1.3147360441570906e+18,2,4,2.0,1,3,2,0
1.3149344027514422e+18,6,14,2.3333333333333335,1,4,6,0
1.3150674966414477e+18,4,33,8.25,8,9,0,4
1.3150867516378045e+18,6,11,1.8333333333333333,1,3,6,0
1.315125606547799e+18,3,24,8.0,7,9,1,2
1.3151286089544084e+18,1,10,10.0,10,10,0,1
1.3151707308546793e+18,10,33,3.3,2,5,10,0
1.3152097761495816e+18,13,28,2.1538461538461537,1,3,13,0
1.315228014007104e+18,25,58,2.32,1,5,25,0
1.3152374672761518e+18,1,1,1.0,1,1,1,0
1.3152397180261988e+18,8,59,7.375,6,9,4,4
1.3153101043963236e+18,8,22,2.75,1,4,8,0
1.3153522721594542e+18,2,4,2.0,2,2,2,0
1.315358578419405e+18,4,10,2.5,1,4,4,0
1.3153717533413043e+18,10,64,6.4,5,8,9,1
1.315469896741672e+18,2,9,4.5,4,5,2,0
1.3154793085874808e+18,6,36,6.0,4,7,6,0
1.3157140634219814e+18,2,11,5.5,5,6,2,0
1.315810233543603e+18,3,19,6.333333333333333,6,7,3,0
1.3158509768558344e+18,3,7,2.3333333333333335,1,3,3,0
1.3159271698588575e+18,3,12,4.0,4,4,3,0
1.315934294744571e+18,1,7,7.0,7,7,1,0
1.3159633245032545e+18,6,9,1.5,1,3,6,0
1.3159859971917084e+18,6,22,3.6666666666666665,2,5,6,0
1.3161197212780037e+18,1,8,8.0,8,8,0,1
1.3161297126747392e+18,8,59,7.375,6,9,5,3
1.3162169360469678e+18,2,4,2.0,2,2,2,0
1.3166138991569298e+18,2,5,2.5,1,4,2,0
1.316713534170873e+18,8,63,7.875,7,9,3,5
1.316723048477303e+18,1,1,1.0,1,1,1,0
1.3168121288354834e+18,1,2,2.0,2,2,1,0
1.3168622802384038e+18,29,167,5.758620689655173,4,8,27,2
1.3173531711120658e+18,2,11,5.5,4,7,2,0
1.3173675592106598e+18,10,14,1.4,1,3,10,0
1.3174129398527314e+18,1,2,2.0,2,2,1,0
1.3174286992000128e+18,2,13,6.5,4,9,1,1
1.31742983751826e+18,1,3,3.0,3,3,1,0
1.3174895396062738e+18,4,4,1.0,1,1,4,0
1.317551351036306e+18,3,8,2.6666666666666665,2,4,3,0
1.3175813516492534e+18,5,19,3.8,2,5,5,0
1.3176109151719176e+18,13,91,7.0,5,9,9,4
1.3179623169254244e+18,4,15,3.75,3,5,4,0
1.3179746037966318e+18,2,9,4.5,4,5,2,0
1.3180076215640274e+18,2,18,9.0,8,10,0,2
1.318011463795227e+18,2,5,2.5,2,3,2,0
1.318087017300628e+18,6,40,6.666666666666667,5,8,5,1
1.318098054881139e+18,9,26,2.888888888888889,2,5,9,0
1.3181311836915082e+18,2,15,7.5,7,8,1,1
1.3181341512532657e+18,13,29,2.230769230769231,1,4,13,0
1.3182533020248225e+18,11,101,9.181818181818182,7,11,1,10
1.318262918220016e+18,2,12,6.0,5,7,2,0
1.3184045573941627e+18,2,11,5.5,5,6,2,0
1.3184445952661862e+18,2,11,5.5,5,6,2,0
1.3185823312783421e+18,1,1,1.0,1,1,1,0
1.3186955949703747e+18,2,8,4.0,4,4,2,0
1.3186967790530232e+18,1,3,3.0,3,3,1,0
1.31872323884694e+18,4,6,1.5,1,3,4,0
1.318739446648063e+18,1,6,6.0,6,6,1,0
1.3187452050082952e+18,1,3,3.0,3,3,1,0
1.3187658709368364e+18,2,16,8.0,7,9,1,1
1.318825420906953e+18,1,1,1.0,1,1,1,0
1.3188445787324255e+18,5,8,1.6,1,2,5,0
1.3188871898923745e+18,10,19,1.9,1,3,10,0
1.3195139597465907e+18,12,30,2.5,1,5,12,0
1.3195167063286694e+18,2,18,9.0,9,9,0,2
1.3195668246352873e+18,6,35,5.833333333333333,4,7,6,0
1.3195714956890947e+18,6,7,1.1666666666666667,1,2,6,0
1.319572956037639e+18,4,24,6.0,5,7,4,0
1.3195751399124403e+18,14,30,2.142857142857143,1,4,14,0
1.3197232838004383e+18,9,51,5.666666666666667,4,8,8,1
1.3197232843635305e+18,11,63,5.7272727272727275,2,8,10,1
1.3197267441230746e+18,7,20,2.857142857142857,2,4,7,0
1.3197521714421504e+18,1,4,4.0,4,4,1,0
1.3197915389559388e+18,3,5,1.6666666666666667,1,2,3,0
1.3201358355062216e+18,7,43,6.142857142857143,4,8,5,2
1.3201858281566636e+18,3,18,6.0,5,7,3,0
1.3201868009918275e+18,3,6,2.0,2,2,3,0
1.320338021925682e+18,9,11,1.2222222222222223,1,3,9,0
1.3203465780210952e+18,1,3,3.0,3,3,1,0
1.320363228015608e+18,9,33,3.6666666666666665,3,5,9,0
1.3203653448816694e+18,6,12,2.0,1,3,6,0
1.32038442033746e+18,13,22,1.6923076923076923,1,3,13,0
1.320387090920675e+18,1,2,2.0,2,2,1,0
1.3204007047588972e+18,8,13,1.625,1,3,8,0
1.3204279137272174e+18,5,6,1.2,1,2,5,0
1.3204441373995594e+18,1,6,6.0,6,6,1,0
1.3204703874886705e+18,1,3,3.0,3,3,1,0
1.3205000602183654e+18,19,78,4.105263157894737,2,6,19,0
1.3205153969372682e+18,7,31,4.428571428571429,3,6,7,0
1.3206312542341745e+18,12,44,3.6666666666666665,2,5,12,0
1.3206425291053978e+18,11,41,3.727272727272727,3,5,11,0
1.3206905357795072e+18,1,7,7.0,7,7,1,0
1.3207890064205647e+18,2,3,1.5,1,2,2,0
1.3208393161660375e+18,3,19,6.333333333333333,6,7,3,0
1.320931437942966e+18,3,9,3.0,3,3,3,0
1.3209700712545329e+18,6,37,6.166666666666667,5,8,5,1
1.3210099831842998e+18,7,22,3.142857142857143,2,4,7,0
1.3210206750661294e+18,13,25,1.9230769230769231,1,3,13,0
1.3210250886214426e+18,5,8,1.6,1,3,5,0
1.3211183636407747e+18,2,11,5.5,5,6,2,0
1.321180520663614e+18,4,5,1.25,1,2,4,0
1.3212144345450593e+18,3,21,7.0,6,8,2,1
1.3215050989399368e+18,4,15,3.75,3,5,4,0
1.3215516254988956e+18,2,3,1.5,1,2,2,0
1.3216063109133652e+18,4,6,1.5,1,2,4,0
1.3216141275584049e+18,5,12,2.4,2,3,5,0
1.3216519851626934e+18,5,9,1.8,1,3,5,0
1.321717882970336e+18,11,77,7.0,6,8,7,4
1.3217857624946982e+18,1,10,10.0,10,10,0,1
1.321793225986456e+18,2,6,3.0,2,4,2,0
1.3218062774961178e+18,2,5,2.5,2,3,2,0
1.3218383921350408e+18,1,5,5.0,5,5,1,0
1.321953390768913e+18,1,2,2.0,2,2,1,0
1.3221374973592579e+18,3,16,5.333333333333333,5,6,3,0
1.3223397429465784e+18,2,5,2.5,2,3,2,0
1.322437943803938e+18,2,8,4.0,4,4,2,0
1.322474023507292e+18,10,63,6.3,5,7,10,0
1.3224804309060588e+18,5,30,6.0,5,7,5,0
1.3224911859142077e+18,3,20,6.666666666666667,6,7,3,0
1.3225672648006228e+18,19,28,1.4736842105263157,1,5,19,0
1.3230386954713196e+18,1,3,3.0,3,3,1,0
1.3231576992489014e+18,2,13,6.5,6,7,2,0
1.3232675784311084e+18,4,23,5.75,5,7,4,0
1.3232677164630326e+18,5,9,1.8,1,3,5,0
1.3232701451958781e+18,6,38,6.333333333333333,4,8,5,1
1.3233353845662536e+18,5,38,7.6,4,9,1,4
1.3233850451003543e+18,4,6,1.5,1,2,4,0
1.323690543118007e+18,4,8,2.0,1,3,4,0
1.3238193167249185e+18,2,16,8.0,6,10,1,1
1.323829437520484e+18,1,4,4.0,4,4,1,0
1.3238557180550712e+18,6,42,7.0,6,9,4,2
1.3239313388636132e+18,2,17,8.5,8,9,0,2
1.3239454676545357e+18,2,13,6.5,6,7,2,0
1.3239643852453647e+18,2,8,4.0,3,5,2,0
1.3241847702765586e+18,2,15,7.5,7,8,1,1
1.3245122890559432e+18,2,6,3.0,3,3,2,0
1.3246556232013076e+18,1,9,9.0,9,9,0,1
1.3246573635590385e+18,3,24,8.0,7,9,1,2
1.324694231202764e+18,1,6,6.0,6,6,1,0
1.3247043925063447e+18,1,1,1.0,1,1,1,0
1.3247196604078003e+18,3,21,7.0,6,8,2,1
1.3247825211474662e+18,8,17,2.125,1,3,8,0
1.3248195285333033e+18,3,17,5.666666666666667,5,6,3,0
1.3248503560909908e+18,4,10,2.5,2,3,4,0
1.3249729042345385e+18,1,6,6.0,6,6,1,0
1.3249824281372383e+18,2,16,8.0,7,9,1,1
1.3249835978354621e+18,1,7,7.0,7,7,1,0
1.325224327867385e+18,4,27,6.75,5,8,3,1
1.325248688399777e+18,3,21,7.0,6,8,2,1
1.3252701730265372e+18,7,53,7.571428571428571,7,9,4,3
1.3254025634667402e+18,1,6,6.0,6,6,1,0
1.325467773810336e+18,1,2,2.0,2,2,1,0
1.325485311072406e+18,2,3,1.5,1,2,2,0
1.3256028791327703e+18,23,113,4.913043478260869,3,7,23,0
1.3256284354280092e+18,6,60,10.0,4,12,1,5
1.325904601875846e+18,4,8,2.0,1,3,4,0
1.3259334335840466e+18,2,14,7.0,6,8,1,1
1.3259483708809157e+18,3,19,6.333333333333333,6,7,3,0
1.3259948453159936e+18,3,20,6.666666666666667,6,7,3,0
1.3259969699783086e+18,5,19,3.8,3,5,5,0
1.3260299918291896e+18,1,4,4.0,4,4,1,0
1.3260839337042028e+18,6,34,5.666666666666667,4,6,6,0
1.3260917797629204e+18,4,23,5.75,5,7,4,0
1.3260974294176438e+18,8,49,6.125,3,7,8,0
1.3261009302196936e+18,8,47,5.875,4,7,8,0
1.3261075879748183e+18,8,45,5.625,3,8,7,1
1.326119399989677e+18,5,27,5.4,3,7,5,0
1.3261225755058844e+18,4,9,2.25,1,3,4,0
1.3261237120034726e+18,8,47,5.875,2,8,7,1
1.3261420511560712e+18,2,4,2.0,2,2,2,0
1.3261752095386345e+18,9,60,6.666666666666667,4,9,7,2
1.3262211751615695e+18,4,8,2.0,1,3,4,0
1.326468288566074e+18,1,2,2.0,2,2,1,0
1.326475293454219e+18,7,52,7.428571428571429,6,9,4,3
1.3268091329866555e+18,11,23,2.090909090909091,1,4,11,0
1.326847855935085e+18,4,13,3.25,2,5,4,0
1.3268853479125494e+18,1,1,1.0,1,1,1,0
1.3269602326448852e+18,2,2,1.0,1,1,2,0
1.3269874410452595e+18,8,41,5.125,3,7,8,0
1.3270183129469222e+18,2,6,3.0,1,5,2,0
1.3270591218160404e+18,39,50,1.2820512820512822,1,3,39,0
1.3276200927924032e+18,2,13,6.5,6,7,2,0
1.327655891552234e+18,23,153,6.6521739130434785,5,9,18,5
1.3276581114477548e+18,1,2,2.0,2,2,1,0
1.3276682490751913e+18,2,21,10.5,10,11,0,2
1.3276804744395482e+18,2,17,8.5,8,9,0,2
1.3277582136740175e+18,3,22,7.333333333333333,7,8,2,1
1.3279779576292237e+18,14,83,5.928571428571429,4,8,13,1
1.3281217540738038e+18,3,24,8.0,8,8,0,3
1.3282185943810248e+18,7,44,6.285714285714286,5,8,6,1
1.328224430533263e+18,3,22,7.333333333333333,7,8,2,1
1.3282971063679875e+18,5,34,6.8,6,8,4,1
1.3283502572441859e+18,5,40,8.0,8,8,0,5
1.3283779959286036e+18,1,1,1.0,1,1,1,0
1.328388898733455e+18,5,6,1.2,1,2,5,0
1.3284188627503974e+18,11,23,2.090909090909091,1,3,11,0
1.328480265417579e+18,1,2,2.0,2,2,1,0
1.3284945364749868e+18,12,72,6.0,4,8,10,2
1.3285568563628457e+18,1,7,7.0,7,7,1,0
1.3288207573075087e+18,1,1,1.0,1,1,1,0
1.328824607761862e+18,1,1,1.0,1,1,1,0
1.3288476427439447e+18,1,6,6.0,6,6,1,0
1.3288506887874883e+18,1,10,10.0,10,10,0,1
1.3288507513587814e+18,1,8,8.0,8,8,0,1
1.3288507753579203e+18,2,3,1.5,1,2,2,0
1.3288509065699702e+18,2,3,1.5,1,2,2,0
1.328850932170611e+18,2,3,1.5,1,2,2,0
1.3288509350168817e+18,1,2,2.0,2,2,1,0
1.3288587553316447e+18,4,26,6.5,5,8,3,1
1.3288591226683005e+18,4,26,6.5,5,9,3,1
1.3288613010609495e+18,2,13,6.5,6,7,2,0
1.3289279020080783e+18,7,61,8.714285714285714,8,10,0,7
1.3289711314973404e+18,4,5,1.25,1,2,4,0
1.329023136658361e+18,1,5,5.0,5,5,1,0
1.3290482454901545e+18,10,25,2.5,1,4,10,0
1.3290490721441362e+18,5,20,4.0,3,5,5,0
1.3290676581912364e+18,3,18,6.0,5,8,2,1
1.3291135302776202e+18,1,5,5.0,5,5,1,0
1.3291635677467779e+18,1,2,2.0,2,2,1,0
1.3294957434762084e+18,3,4,1.3333333333333333,1,2,3,0
1.3295306140079432e+18,8,52,6.5,6,7,8,0
1.3295626257502556e+18,3,17,5.666666666666667,5,6,3,0
1.3295655630980925e+18,5,10,2.0,1,3,5,0
1.3295982776801864e+18,1,2,2.0,2,2,1,0
1.3296659725108905e+18,1,5,5.0,5,5,1,0
1.3297087939356493e+18,1,3,3.0,3,3,1,0
1.3297457361113075e+18,4,12,3.0,1,4,4,0
1.3297548074222436e+18,1,4,4.0,4,4,1,0
1.3297588778483412e+18,1,6,6.0,6,6,1,0
1.3298438046909284e+18,9,45,5.0,4,6,9,0
1.3298874007794452e+18,2,16,8.0,7,9,1,1
1.329889401265686e+18,1,3,3.0,3,3,1,0
1.32990827792129e+18,8,27,3.375,1,5,8,0
1.3299234042486323e+18,5,36,7.2,5,10,3,2
1.3301907638920916e+18,2,9,4.5,2,7,2,0
1.3302112408026194e+18,3,21,7.0,5,9,2,1
1.330267039534122e+18,1,2,2.0,2,2,1,0
1.3302676483237484e+18,2,2,1.0,1,1,2,0
1.330292392975849e+18,2,17,8.5,8,9,0,2
1.3303209120393124e+18,4,8,2.0,1,3,4,0
1.3303746660776584e+18,4,29,7.25,6,8,2,2
1.33044080576182e+18,2,6,3.0,3,3,2,0
1.330449186101047e+18,7,18,2.5714285714285716,1,4,7,0
1.3304814486903514e+18,3,12,4.0,4,4,3,0
1.330530414857157e+18,4,8,2.0,2,2,4,0
1.3305488260787643e+18,9,68,7.555555555555555,6,9,4,5
1.3307305746202514e+18,2,3,1.5,1,2,2,0
1.3309860806561016e+18,3,19,6.333333333333333,6,7,3,0
1.331021426553473e+18,1,8,8.0,8,8,0,1
1.331119675944586e+18,3,21,7.0,6,8,2,1
1.3311249093899615e+18,4,27,6.75,5,8,2,2
1.3311729134089567e+18,6,16,2.6666666666666665,1,4,6,0
1.3311860884214781e+18,2,2,1.0,1,1,2,0
1.331225647738021e+18,4,32,8.0,7,9,2,2
1.3317032341815613e+18,3,22,7.333333333333333,6,8,1,2
1.3317402906601428e+18,1,9,9.0,9,9,0,1
1.3317782535770634e+18,9,50,5.555555555555555,4,7,9,0
1.3317838792424284e+18,5,33,6.6,6,7,5,0
1.3317931593482793e+18,8,45,5.625,4,7,8,0
1.331798992825828e+18,11,71,6.454545454545454,5,7,11,0
1.3318030582914755e+18,11,79,7.181818181818182,2,10,5,6
1.3318578195804483e+18,1,3,3.0,3,3,1,0
1.3319667979010483e+18,1,10,10.0,10,10,0,1
1.3319823178129157e+18,1,6,6.0,6,6,1,0
1.3324356934418906e+18,1,3,3.0,3,3,1,0
1.3326081362832026e+18,8,10,1.25,1,2,8,0
1.332638402673999e+18,2,13,6.5,6,7,2,0
1.3326407720458007e+18,5,27,5.4,2,8,4,1
1.3326550401911224e+18,4,7,1.75,1,3,4,0
1.33267263394036e+18,2,3,1.5,1,2,2,0
1.33269837643837e+18,2,14,7.0,7,7,2,0
1.3327665926272353e+18,3,4,1.3333333333333333,1,2,3,0
1.3331036251224847e+18,2,14,7.0,7,7,2,0
1.3331428665043922e+18,1,8,8.0,8,8,0,1
1.3331813959673196e+18,2,12,6.0,6,6,2,0
1.3332773497934308e+18,1,5,5.0,5,5,1,0
1.3332798683280154e+18,6,49,8.166666666666666,7,9,1,5
1.3333116865371348e+18,2,6,3.0,3,3,2,0
1.3333297972220992e+18,5,8,1.6,1,3,5,0
1.3333511575781092e+18,1,1,1.0,1,1,1,0
1.3333638470690301e+18,1,1,1.0,1,1,1,0
1.333392096233826e+18,6,14,2.3333333333333335,1,3,6,0
1.3334047346230984e+18,4,12,3.0,1,4,4,0
1.3334151723824548e+18,8,52,6.5,6,8,7,1
1.3334315827372675e+18,5,36,7.2,6,8,3,2
1.3334316809728233e+18,4,6,1.5,1,2,4,0
1.3334362846011323e+18,6,32,5.333333333333333,4,6,6,0
1.333498561647466e+18,3,18,6.0,5,7,3,0
1.3336196041075036e+18,10,16,1.6,1,3,10,0
1.333874669865728e+18,2,16,8.0,8,8,0,2
1.3338920046374564e+18,3,9,3.0,2,4,3,0
1.3338923904012012e+18,1,2,2.0,2,2,1,0
1.333915135242648e+18,1,7,7.0,7,7,1,0
1.3339158628678436e+18,5,38,7.6,6,9,2,3
1.33391880412736e+18,4,6,1.5,1,3,4,0
1.33394485925952e+18,2,6,3.0,3,3,2,0
1.3339504205497357e+18,1,3,3.0,3,3,1,0
1.333982078919809e+18,5,34,6.8,6,8,3,2
1.3339990422102188e+18,2,15,7.5,7,8,1,1
1.3340049313584164e+18,9,13,1.4444444444444444,1,2,9,0
1.3340133474512704e+18,2,3,1.5,1,2,2,0
1.3340142972128832e+18,1,7,7.0,7,7,1,0
1.3340480072323766e+18,14,80,5.714285714285714,4,7,14,0
1.3340521925447928e+18,17,98,5.764705882352941,4,7,17,0
1.3340753962235223e+18,1,2,2.0,2,2,1,0
1.334103617562362e+18,12,18,1.5,1,3,12,0
1.3341221941196283e+18,1,4,4.0,4,4,1,0
1.334132727028866e+18,8,56,7.0,4,9,4,4
1.33461966929661e+18,4,26,6.5,5,7,4,0
1.3346481186608072e+18,2,15,7.5,7,8,1,1
1.3346500421428045e+18,2,7,3.5,3,4,2,0
1.334663636495904e+18,1,7,7.0,7,7,1,0
1.3346702063442578e+18,2,12,6.0,5,7,2,0
1.3347322443586074e+18,11,90,8.181818181818182,6,10,2,9
1.3347714661310717e+18,16,39,2.4375,1,4,16,0
1.3347810263351201e+18,2,10,5.0,5,5,2,0
1.3347918716855299e+18,3,4,1.3333333333333333,1,2,3,0
1.334884495710565e+18,1,7,7.0,7,7,1,0
1.3349362097860193e+18,4,29,7.25,6,9,3,1
1.3349791635063506e+18,1,1,1.0,1,1,1,0
1.3349830674648407e+18,1,7,7.0,7,7,1,0
1.335049581718337e+18,18,120,6.666666666666667,2,8,13,5
1.3350498915517606e+18,6,65,10.833333333333334,9,12,0,6
1.3352983868177592e+18,4,29,7.25,6,9,3,1
1.335304363359451e+18,3,7,2.3333333333333335,1,3,3,0
1.3353621193978483e+18,8,19,2.375,1,3,8,0
1.3353886088339082e+18,1,9,9.0,9,9,0,1
1.3353914893581476e+18,1,1,1.0,1,1,1,0
1.335407490073019e+18,8,31,3.875,2,5,8,0
1.3354740767704842e+18,1,3,3.0,3,3,1,0
1.3355075116985052e+18,2,7,3.5,3,4,2,0
1.3355345479323064e+18,5,23,4.6,3,6,5,0
1.3355511603610632e+18,9,51,5.666666666666667,3,8,8,1
1.3357048831457193e+18,5,37,7.4,6,8,2,3
1.3357085198046733e+18,4,24,6.0,4,7,4,0
1.33573093840225e+18,3,18,6.0,5,7,3,0
1.3360007231526364e+18,9,18,2.0,1,3,9,0
1.336065229936546e+18,1,8,8.0,8,8,0,1
1.3360748253601428e+18,2,13,6.5,5,8,1,1
1.3360891047791235e+18,4,6,1.5,1,2,4,0
1.3361292621682222e+18,6,18,3.0,1,4,6,0
1.3361930005667763e+18,2,4,2.0,2,2,2,0
1.336200559809356e+18,2,2,1.0,1,1,2,0
1.3362143886127864e+18,5,20,4.0,3,5,5,0
1.3362233284762176e+18,8,54,6.75,5,9,5,3
1.336264268490591e+18,5,36,7.2,6,8,3,2
1.3362811184933555e+18,2,2,1.0,1,1,2,0
1.3363336452507446e+18,6,44,7.333333333333333,6,8,3,3
1.3363411140205512e+18,4,26,6.5,6,7,4,0
1.3364187793799542e+18,5,34,6.8,6,8,4,1
1.3368167761289352e+18,2,19,9.5,9,10,0,2
1.3368168860168346e+18,3,4,1.3333333333333333,1,2,3,0
1.3368846025831347e+18,1,7,7.0,7,7,1,0
1.3370651782932654e+18,10,72,7.2,3,10,4,6
1.3370897286465795e+18,7,10,1.4285714285714286,1,2,7,0
1.3371539368353372e+18,2,16,8.0,7,9,1,1
1.3373993325802166e+18,2,11,5.5,3,8,1,1
1.337481587607441e+18,1,2,2.0,2,2,1,0
1.3374848293085594e+18,3,23,7.666666666666667,7,8,1,2
1.3375742646798426e+18,1,4,4.0,4,4,1,0
1.3376010980630607e+18,6,51,8.5,6,10,1,5
1.3376229555862482e+18,1,3,3.0,3,3,1,0
1.3377226037558991e+18,6,14,2.3333333333333335,1,4,6,0
1.3377887379852692e+18,4,27,6.75,5,8,3,1
1.3378140014926943e+18,2,14,7.0,7,7,2,0
1.3380467936527337e+18,6,34,5.666666666666667,3,7,6,0
1.3381993610979633e+18,11,12,1.0909090909090908,1,2,11,0
1.3382164631303718e+18,5,41,8.2,4,10,1,4
1.3382448898171901e+18,9,59,6.555555555555555,2,9,4,5
1.3383557350130847e+18,4,4,1.0,1,1,4,0
1.3384019027674647e+18,2,17,8.5,7,10,1,1
1.3384266161535951e+18,10,70,7.0,4,10,7,3
1.3384708633958167e+18,8,64,8.0,7,9,3,5
1.3385478590440888e+18,1,2,2.0,2,2,1,0
1.338804529524132e+18,3,19,6.333333333333333,6,7,3,0
1.3389074159207268e+18,5,33,6.6,4,9,4,1
1.3389513813980385e+18,1,2,2.0,2,2,1,0
1.3389514197397732e+18,6,38,6.333333333333333,2,8,4,2
1.3389515000548541e+18,4,24,6.0,4,7,4,0
1.3389576949090127e+18,1,9,9.0,9,9,0,1
1.3389690559382753e+18,1,3,3.0,3,3,1,0
1.338973125565744e+18,40,40,1.0,1,1,40,0
1.3390197304171195e+18,3,6,2.0,1,3,3,0
1.3390319717242414e+18,1,9,9.0,9,9,0,1
1.3390346175737618e+18,1,9,9.0,9,9,0,1
1.339039891839918e+18,1,1,1.0,1,1,1,0
1.339042852190741e+18,3,4,1.3333333333333333,1,2,3,0
1.3390909880238733e+18,2,7,3.5,3,4,2,0
1.3391051836716964e+18,2,6,3.0,1,5,2,0
1.3391317212825144e+18,1,5,5.0,5,5,1,0
1.3391338019333535e+18,1,8,8.0,8,8,0,1
1.3391462748437094e+18,2,2,1.0,1,1,2,0
1.3391571988758356e+18,1,3,3.0,3,3,1,0
1.3391626073087892e+18,10,74,7.4,6,9,5,5
1.3392257359211098e+18,3,17,5.666666666666667,3,8,2,1
1.3392657287255045e+18,4,15,3.75,3,5,4,0
1.3393835631080292e+18,1,8,8.0,8,8,0,1
1.339624970520134e+18,1,6,6.0,6,6,1,0
1.3396853978697728e+18,2,3,1.5,1,2,2,0
1.3397795430312102e+18,7,19,2.7142857142857144,2,4,7,0
1.3398055135558897e+18,12,23,1.9166666666666667,1,3,12,0
1.3398314337316424e+18,1,6,6.0,6,6,1,0
1.339864056322322e+18,1,9,9.0,9,9,0,1
1.339958571679176e+18,1,3,3.0,3,3,1,0
1.3399768494853386e+18,1,2,2.0,2,2,1,0
1.3403350287752133e+18,1,6,6.0,6,6,1,0
1.3404069567832302e+18,1,3,3.0,3,3,1,0
1.3404652837934313e+18,3,5,1.6666666666666667,1,2,3,0
1.3404891328226831e+18,1,8,8.0,8,8,0,1
1.3404976407535631e+18,3,24,8.0,8,8,0,3
1.340524282840886e+18,3,6,2.0,1,3,3,0
1.3405594444803228e+18,3,15,5.0,3,7,3,0
1.3405835362567995e+18,1,10,10.0,10,10,0,1
1.340584904786346e+18,7,59,8.428571428571429,3,12,1,6
1.3405941742893025e+18,6,16,2.6666666666666665,2,4,6,0
1.3406621477861107e+18,2,3,1.5,1,2,2,0
1.340692854544762e+18,2,18,9.0,8,10,0,2
1.3410750619623455e+18,1,7,7.0,7,7,1,0
1.3411537969137009e+18,6,43,7.166666666666667,7,8,5,1
1.34118329236768e+18,7,29,4.142857142857143,3,5,7,0
1.341318198848336e+18,2,3,1.5,1,2,2,0
1.3414187132180431e+18,3,11,3.6666666666666665,3,4,3,0
1.3414385525721334e+18,1,10,10.0,10,10,0,1
1.3414977917064156e+18,2,12,6.0,5,7,2,0
1.3415149891556723e+18,1,2,2.0,2,2,1,0
1.3415912266480768e+18,1,9,9.0,9,9,0,1
1.3419262429156096e+18,1,4,4.0,4,4,1,0
1.342066825391373e+18,1,1,1.0,1,1,1,0
1.34213741393307e+18,1,7,7.0,7,7,1,0
1.3422053958273073e+18,4,19,4.75,4,5,4,0
1.3422258815217055e+18,1,2,2.0,2,2,1,0
1.3422592882999862e+18,2,7,3.5,3,4,2,0
1.3423322302475172e+18,1,10,10.0,10,10,0,1
1.3426075797998162e+18,1,3,3.0,3,3,1,0
1.3427954635431734e+18,5,10,2.0,1,4,5,0
1.3430632105814577e+18,1,1,1.0,1,1,1,0
1.3431792893530104e+18,1,1,1.0,1,1,1,0
1.3433571751829379e+18,3,21,7.0,7,7,3,0
1.3433614615164933e+18,3,21,7.0,6,9,2,1
1.3434330193389942e+18,3,10,3.3333333333333335,3,4,3,0
1.3435336640317274e+18,2,8,4.0,4,4,2,0
1.3435349820469307e+18,6,27,4.5,1,6,6,0
1.3435670883402358e+18,3,19,6.333333333333333,5,7,3,0
1.3435775370131835e+18,3,10,3.3333333333333335,2,5,3,0
1.3440091179155377e+18,2,5,2.5,1,4,2,0
1.3440157203595313e+18,1,2,2.0,2,2,1,0
1.3440633948159478e+18,7,65,9.285714285714286,6,11,1,6
1.34412870659044e+18,3,6,2.0,1,3,3,0
1.3441511782211297e+18,2,3,1.5,1,2,2,0
1.3441679299807744e+18,1,2,2.0,2,2,1,0
1.344171156667233e+18,1,3,3.0,3,3,1,0
1.3442756496032643e+18,1,1,1.0,1,1,1,0
1.344350538347259e+18,2,2,1.0,1,1,2,0
1.3443737201973256e+18,3,7,2.3333333333333335,1,4,3,0
1.3443849891746373e+18,2,5,2.5,2,3,2,0
1.3446878539302525e+18,2,4,2.0,2,2,2,0
1.3447487305757225e+18,1,9,9.0,9,9,0,1
1.3447926638211008e+18,1,4,4.0,4,4,1,0
1.3448242248148529e+18,1,3,3.0,3,3,1,0
1.344829548470178e+18,4,32,8.0,7,9,1,3
1.3448692815580652e+18,3,22,7.333333333333333,6,9,2,1
1.3448971988716723e+18,5,35,7.0,2,9,2,3
1.34490713202334e+18,1,7,7.0,7,7,1,0
1.3449446645088684e+18,3,19,6.333333333333333,2,9,1,2
1.3449686016661658e+18,1,8,8.0,8,8,0,1
1.3450000993199183e+18,1,8,8.0,8,8,0,1
1.3451305210148838e+18,4,10,2.5,2,3,4,0
1.3452517024652132e+18,2,11,5.5,5,6,2,0
1.34537850695053e+18,1,2,2.0,2,2,1,0
1.345436157053992e+18,2,4,2.0,1,3,2,0
1.3454696279335908e+18,3,9,3.0,2,4,3,0
1.3455261289755415e+18,1,9,9.0,9,9,0,1
1.3455357274396183e+18,1,8,8.0,8,8,0,1
1.3455901100746212e+18,1,1,1.0,1,1,1,0
1.3456043056354476e+18,2,17,8.5,8,9,0,2
1.3456683339132416e+18,1,4,4.0,4,4,1,0
1.3457455470188165e+18,1,5,5.0,5,5,1,0
1.3457489558615475e+18,2,13,6.5,6,7,2,0
1.3457677211432914e+18,1,6,6.0,6,6,1,0
1.345793481111716e+18,3,17,5.666666666666667,5,7,3,0
1.3458810917443784e+18,3,17,5.666666666666667,4,7,3,0
1.3461671059762245e+18,1,2,2.0,2,2,1,0
1.3462227581768755e+18,1,1,1.0,1,1,1,0
1.3463133046933412e+18,4,10,2.5,2,4,4,0
1.3463505626650022e+18,1,8,8.0,8,8,0,1
1.3463525868657656e+18,1,3,3.0,3,3,1,0
1.3469535359595046e+18,1,6,6.0,6,6,1,0
1.3470726452496548e+18,2,11,5.5,5,6,2,0
1.3471601464894339e+18,5,41,8.2,7,9,2,3
1.3472383531257198e+18,6,47,7.833333333333333,6,10,3,3
1.3472838204365455e+18,4,11,2.75,2,3,4,0
1.3472841396575299e+18,2,7,3.5,3,4,2,0
1.3473612865845376e+18,2,4,2.0,1,3,2,0
1.3477531260699471e+18,1,7,7.0,7,7,1,0
1.3478523360966292e+18,2,5,2.5,2,3,2,0
1.3478765840028703e+18,2,6,3.0,3,3,2,0
1.347889339182463e+18,7,58,8.285714285714286,7,11,4,3
1.3479026538215345e+18,6,43,7.166666666666667,6,8,4,2
1.3479109489123615e+18,1,3,3.0,3,3,1,0
1.3479241262702525e+18,1,4,4.0,4,4,1,0
1.347959836091252e+18,3,15,5.0,2,8,2,1
1.348314530065434e+18,1,2,2.0,2,2,1,0
1.348397592761402e+18,1,3,3.0,3,3,1,0
1.3484071140436342e+18,2,6,3.0,1,5,2,0
1.3484484431209134e+18,5,13,2.6,2,4,5,0
1.3485385056032952e+18,1,2,2.0,2,2,1,0
1.3485411011142659e+18,4,24,6.0,5,7,4,0
1.3485671501355164e+18,2,6,3.0,3,3,2,0
1.3485719601534275e+18,1,3,3.0,3,3,1,0
1.348578613005387e+18,1,2,2.0,2,2,1,0
1.348641845170628e+18,2,5,2.5,1,4,2,0
1.348696815501681e+18,3,24,8.0,7,9,1,2
1.3487047756049592e+18,3,22,7.333333333333333,6,8,1,2
1.3487153588502843e+18,7,33,4.714285714285714,2,6,7,0
1.3487309444731272e+18,1,6,6.0,6,6,1,0
1.3489599281008712e+18,8,67,8.375,7,9,1,7
1.3490736573451082e+18,4,34,8.5,7,10,1,3
1.3491347532563628e+18,1,9,9.0,9,9,0,1
1.349153728273709e+18,1,6,6.0,6,6,1,0
1.3491589271784422e+18,4,13,3.25,2,4,4,0
1.349180677722474e+18,2,16,8.0,8,8,0,2
1.3491939196187886e+18,1,3,3.0,3,3,1,0
1.3491942992407424e+18,1,7,7.0,7,7,1,0
1.349194719734178e+18,2,12,6.0,5,7,2,0
1.3491952129772938e+18,3,20,6.666666666666667,6,7,3,0
1.3491961061225393e+18,1,8,8.0,8,8,0,1
1.349196535909439e+18,3,23,7.666666666666667,7,8,1,2
1.3491969062744814e+18,5,29,5.8,4,7,5,0
1.3492053140461563e+18,1,6,6.0,6,6,1,0
1.3492194336272517e+18,5,30,6.0,2,8,3,2
1.3492408118325222e+18,1,2,2.0,2,2,1,0
1.3492456671776118e+18,2,18,9.0,8,10,0,2
1.3492731002157893e+18,2,5,2.5,2,3,2,0
1.349277002927275e+18,2,6,3.0,3,3,2,0
1.349286127130154e+18,1,8,8.0,8,8,0,1
1.3493157870563712e+18,2,6,3.0,3,3,2,0
1.3494013444624886e+18,5,44,8.8,8,10,0,5
1.3498186578568888e+18,2,18,9.0,9,9,0,2
1.349866928472719e+18,2,18,9.0,9,9,0,2
1.3498960887467748e+18,1,1,1.0,1,1,1,0
1.3499713309675459e+18,7,45,6.428571428571429,5,8,6,1
1.3500324535520858e+18,1,7,7.0,7,7,1,0
1.3500739952200712e+18,1,3,3.0,3,3,1,0
1.3501700608938657e+18,1,3,3.0,3,3,1,0
1.3501860118958546e+18,1,7,7.0,7,7,1,0
1.3504682693030664e+18,2,5,2.5,2,3,2,0
1.350476686789172e+18,4,7,1.75,1,2,4,0
1.3505191530608886e+18,1,1,1.0,1,1,1,0
1.35052702740466e+18,1,6,6.0,6,6,1,0
1.3505373068889792e+18,7,42,6.0,5,7,7,0
1.3505442751303977e+18,1,2,2.0,2,2,1,0
1.3505580260631693e+18,8,56,7.0,6,9,7,1
1.3506238682054075e+18,2,9,4.5,4,5,2,0
1.3506358617165432e+18,3,10,3.3333333333333335,2,4,3,0
1.3506375394031708e+18,3,7,2.3333333333333335,1,3,3,0
1.3506376522254252e+18,3,20,6.666666666666667,5,8,2,1
1.350638941572461e+18,1,3,3.0,3,3,1,0
1.3506399355076099e+18,1,2,2.0,2,2,1,0
1.3506424162550666e+18,1,2,2.0,2,2,1,0
1.3506506091828408e+18,2,12,6.0,6,6,2,0
1.3506596543484777e+18,1,6,6.0,6,6,1,0
1.3506845979283156e+18,1,4,4.0,4,4,1,0
1.3507168810648056e+18,1,1,1.0,1,1,1,0
1.3507308308451277e+18,1,5,5.0,5,5,1,0
1.3507589603622715e+18,2,8,4.0,4,4,2,0
1.3507836196661453e+18,3,21,7.0,6,8,2,1
1.350854512218613e+18,1,9,9.0,9,9,0,1
1.351254316846632e+18,2,3,1.5,1,2,2,0
1.35127537840649e+18,7,50,7.142857142857143,4,9,4,3
1.3513336593299197e+18,2,14,7.0,6,8,1,1
1.351361963751795e+18,7,36,5.142857142857143,4,6,7,0
1.3513720243674301e+18,1,3,3.0,3,3,1,0
1.351384051984856e+18,8,47,5.875,5,7,8,0
1.3513895795279327e+18,6,43,7.166666666666667,6,9,4,2
1.3513987707031178e+18,5,30,6.0,5,8,4,1
1.351401975186522e+18,2,2,1.0,1,1,2,0
1.3514025461653158e+18,1,3,3.0,3,3,1,0
1.3514032667445453e+18,1,3,3.0,3,3,1,0
1.3514041223647567e+18,2,6,3.0,2,4,2,0
1.3514051216408694e+18,1,2,2.0,2,2,1,0
1.351405702365829e+18,1,2,2.0,2,2,1,0
1.351456298342463e+18,2,11,5.5,5,6,2,0
1.3514735552926034e+18,1,7,7.0,7,7,1,0
1.3514846189923412e+18,1,9,9.0,9,9,0,1
1.351569336165247e+18,9,67,7.444444444444445,4,10,3,6
1.3521006228330373e+18,1,9,9.0,9,9,0,1
1.3521098416087657e+18,4,11,2.75,1,4,4,0
1.3523021878455475e+18,1,5,5.0,5,5,1,0
1.3527506981387185e+18,1,8,8.0,8,8,0,1
1.3527708625658652e+18,2,13,6.5,5,8,1,1
1.35297433911424e+18,1,7,7.0,7,7,1,0
1.3530410644527706e+18,2,12,6.0,6,6,2,0
1.3530535430236493e+18,4,6,1.5,1,3,4,0
1.3530562154917043e+18,2,12,6.0,5,7,2,0
1.3530732620048773e+18,2,11,5.5,5,6,2,0
1.3530898518311462e+18,2,2,1.0,1,1,2,0
1.3530937220960438e+18,2,10,5.0,5,5,2,0
1.3534561078557348e+18,2,6,3.0,3,3,2,0
1.353459727335329e+18,3,4,1.3333333333333333,1,2,3,0
1.3534790087728305e+18,1,1,1.0,1,1,1,0
1.3535316625534636e+18,1,5,5.0,5,5,1,0
1.353545357164652e+18,2,4,2.0,2,2,2,0
1.3535488939464998e+18,1,8,8.0,8,8,0,1
1.3535859219690294e+18,2,3,1.5,1,2,2,0
1.3536030442465247e+18,3,4,1.3333333333333333,1,2,3,0
1.3536107672726075e+18,4,9,2.25,1,3,4,0
1.3536241318488799e+18,2,9,4.5,4,5,2,0
1.3536247447257224e+18,2,6,3.0,2,4,2,0
1.353625288528014e+18,2,5,2.5,2,3,2,0
1.3536268163552297e+18,1,7,7.0,7,7,1,0
1.3536275458719982e+18,1,5,5.0,5,5,1,0
1.353628120243769e+18,1,1,1.0,1,1,1,0
1.353629304536857e+18,1,3,3.0,3,3,1,0
1.3537557115833923e+18,1,3,3.0,3,3,1,0
1.3538109965443484e+18,3,20,6.666666666666667,6,7,3,0
1.3539053690301596e+18,1,2,2.0,2,2,1,0
1.354157045494638e+18,2,8,4.0,3,5,2,0
1.354194465663087e+18,1,4,4.0,4,4,1,0
1.3542466492527444e+18,1,2,2.0,2,2,1,0
1.3542518618039695e+18,1,1,1.0,1,1,1,0
1.3542520584373983e+18,1,7,7.0,7,7,1,0
1.354327638106083e+18,2,16,8.0,7,9,1,1
1.354375089595126e+18,2,4,2.0,2,2,2,0
1.35437544216342e+18,5,10,2.0,1,3,5,0
1.3543953926914637e+18,1,2,2.0,2,2,1,0
1.354412404758933e+18,4,8,2.0,2,2,4,0
1.3545087713271265e+18,1,4,4.0,4,4,1,0
1.3545135847503575e+18,1,2,2.0,2,2,1,0
1.35455606819794e+18,1,4,4.0,4,4,1,0
1.3545845861109194e+18,2,9,4.5,4,5,2,0
1.3548342010992847e+18,2,12,6.0,6,6,2,0
1.3549415312454705e+18,4,28,7.0,6,8,3,1
1.3549721575485407e+18,1,8,8.0,8,8,0,1
1.3549750353992893e+18,3,10,3.3333333333333335,3,4,3,0
1.3549830851395436e+18,1,5,5.0,5,5,1,0
1.3551191922155218e+18,1,9,9.0,9,9,0,1
1.3552341441096765e+18,1,9,9.0,9,9,0,1
1.3552412230356739e+18,3,25,8.333333333333334,8,9,0,3
1.355256529484934e+18,1,4,4.0,4,4,1,0
1.3553237887571633e+18,2,15,7.5,7,8,1,1
1.3556165036487767e+18,1,5,5.0,5,5,1,0
1.3556471876109478e+18,1,5,5.0,5,5,1,0
1.3556594359010365e+18,3,28,9.333333333333334,9,10,0,3
1.355679811599375e+18,1,3,3.0,3,3,1,0
1.3556858753666468e+18,2,8,4.0,4,4,2,0
1.3557009891384576e+18,1,4,4.0,4,4,1,0
1.3558561486510228e+18,2,5,2.5,2,3,2,0
1.3558946777582628e+18,2,18,9.0,9,9,0,2
1.355931635274343e+18,2,4,2.0,2,2,2,0
1.3563001613687235e+18,1,7,7.0,7,7,1,0
1.3563042327557645e+18,1,3,3.0,3,3,1,0
1.3564010972547653e+18,1,3,3.0,3,3,1,0
1.3564051683377871e+18,2,9,4.5,4,5,2,0
1.356416283799636e+18,1,5,5.0,5,5,1,0
1.356417839349836e+18,2,5,2.5,2,3,2,0
1.3565453355421486e+18,1,2,2.0,2,2,1,0
1.3570850726283041e+18,1,7,7.0,7,7,1,0
1.3571829824575887e+18,2,5,2.5,2,3,2,0
1.3571972760349727e+18,1,2,2.0,2,2,1,0
1.357330360700413e+18,2,13,6.5,6,7,2,0
1.3573327009824328e+18,2,3,1.5,1,2,2,0
1.3573724083108654e+18,1,9,9.0,9,9,0,1
1.357399478898988e+18,4,4,1.0,1,1,4,0
1.3574137206751898e+18,3,6,2.0,1,3,3,0
1.357477953481569e+18,6,27,4.5,4,6,6,0
1.3579791225034304e+18,1,4,4.0,4,4,1,0
1.3581065603988516e+18,2,5,2.5,2,3,2,0
1.358125382861914e+18,1,8,8.0,8,8,0,1
1.3581595765084378e+18,1,3,3.0,3,3,1,0
1.3581734798600755e+18,1,1,1.0,1,1,1,0
1.3581821080479299e+18,2,4,2.0,2,2,2,0
1.3586491293659732e+18,1,4,4.0,4,4,1,0
1.3586505933054748e+18,1,1,1.0,1,1,1,0
1.3586634552405281e+18,1,7,7.0,7,7,1,0
1.3588604950459005e+18,1,3,3.0,3,3,1,0
1.3588758123514865e+18,2,10,5.0,2,8,1,1
1.3588808883103506e+18,3,22,7.333333333333333,6,8,1,2
1.358946873152058e+18,2,13,6.5,6,7,2,0
1.3592933488883144e+18,2,5,2.5,2,3,2,0
1.359295656372259e+18,1,2,2.0,2,2,1,0
1.3593400781719473e+18,1,8,8.0,8,8,0,1
1.3594401831144049e+18,1,7,7.0,7,7,1,0
1.3600210399734454e+18,1,10,10.0,10,10,0,1
1.360101264409121e+18,1,9,9.0,9,9,0,1
1.3601502583942938e+18,1,3,3.0,3,3,1,0
1.36021617295114e+18,1,6,6.0,6,6,1,0
1.360283669957519e+18,1,6,6.0,6,6,1,0
1.3603110066388644e+18,1,3,3.0,3,3,1,0
1.3606872330371087e+18,1,3,3.0,3,3,1,0
1.3607818322193303e+18,1,4,4.0,4,4,1,0
1.3609221088514404e+18,1,7,7.0,7,7,1,0
1.360940296660547e+18,1,1,1.0,1,1,1,0
1.3614331316622467e+18,4,21,5.25,4,7,4,0
1.3617012717357914e+18,1,6,6.0,6,6,1,0
1.361822629181071e+18,1,6,6.0,6,6,1,0
1.3621465797343073e+18,5,34,6.8,5,8,4,1
1.3622695168026744e+18,1,3,3.0,3,3,1,0
1.3622942494734057e+18,1,5,5.0,5,5,1,0
1.3631089434418081e+18,1,3,3.0,3,3,1,0
1.363864322767227e+18,1,3,3.0,3,3,1,0
1.3642822350004045e+18,3,14,4.666666666666667,4,5,3,0
1.364308596516606e+18,2,17,8.5,8,9,0,2
1.3645242534464594e+18,2,7,3.5,2,5,2,0
1.3646167595031094e+18,1,7,7.0,7,7,1,0
1.3650078876578486e+18,2,15,7.5,7,8,1,1
1.3656353573602388e+18,1,6,6.0,6,6,1,0
1.366534590465862e+18,1,1,1.0,1,1,1,0
1.366853173044268e+18,1,1,1.0,1,1,1,0
1.3683043772901233e+18,1,7,7.0,7,7,1,0
1.3689592975230525e+18,1,2,2.0,2,2,1,0
